collate1,collate2_1,collate2_2,collate3,collate4,collate5,collate6
Jensen_Eisai_groupA,4,8,ts-global_detected_seizures,1,42348,42347
Jensen_Eisai_groupA,1,5,ts-global_detected_seizures,691,2050,1359
Jensen_Eisai_groupA,2,6,ts-global_detected_seizures,1634,1680,46
Jensen_Eisai_groupA,2,6,ts-global_detected_seizures,1681,1741,60
Jensen_Eisai_groupA,2,6,ts-global_detected_seizures,1742,1774,32
Jensen_Eisai_groupA,2,6,ts-global_detected_seizures,1796,1971,175
Jensen_Eisai_groupA,2,6,ts-global_detected_seizures,1972,2026,54
Jensen_Eisai_groupA,2,6,ts-global_detected_seizures,2027,2079,52
Jensen_Eisai_groupA,1,5,ts-global_detected_seizures,2051,3892,1841
Jensen_Eisai_groupA,2,6,ts-global_detected_seizures,2097,2242,145
Jensen_Eisai_groupA,2,6,ts-global_detected_seizures,2243,2755,512
Jensen_Eisai_groupA,2,6,ts-global_detected_seizures,2756,2782,26
Jensen_Eisai_groupA,2,6,ts-global_detected_seizures,2787,2835,48
Jensen_Eisai_groupA,2,6,ts-global_detected_seizures,2837,2896,59
Jensen_Eisai_groupA,2,6,ts-global_detected_seizures,2897,2981,84
Jensen_Eisai_groupA,2,6,ts-global_detected_seizures,3006,3091,85
Jensen_Eisai_groupA,2,6,ts-global_detected_seizures,3092,3125,33
Jensen_Eisai_groupA,2,6,ts-global_detected_seizures,3127,3206,79
Jensen_Eisai_groupA,2,6,ts-global_detected_seizures,3207,3471,264
Jensen_Eisai_groupA,2,6,ts-global_detected_seizures,3485,3534,49
Jensen_Eisai_groupA,2,6,ts-global_detected_seizures,3537,3577,40
Jensen_Eisai_groupA,2,6,ts-global_detected_seizures,3578,3631,53
Jensen_Eisai_groupA,2,6,ts-global_detected_seizures,3632,3655,23
Jensen_Eisai_groupA,2,6,ts-global_detected_seizures,3660,3726,66
Jensen_Eisai_groupA,2,6,ts-global_detected_seizures,3732,3754,22
Jensen_Eisai_groupA,2,6,ts-global_detected_seizures,3799,3894,95
Jensen_Eisai_groupA,1,5,ts-global_detected_seizures,3893,4007,114
Jensen_Eisai_groupA,2,6,ts-global_detected_seizures,3919,3969,50
Jensen_Eisai_groupA,2,6,ts-global_detected_seizures,3971,4027,56
Jensen_Eisai_groupA,2,6,ts-global_detected_seizures,4028,4056,28
Jensen_Eisai_groupA,2,6,ts-global_detected_seizures,4066,4149,83
Jensen_Eisai_groupA,1,5,ts-global_detected_seizures,4104,4128,24
Jensen_Eisai_groupA,1,5,ts-global_detected_seizures,4154,4189,35
Jensen_Eisai_groupA,2,6,ts-global_detected_seizures,4163,4188,25
Jensen_Eisai_groupA,2,6,ts-global_detected_seizures,4189,4219,30
Jensen_Eisai_groupA,2,6,ts-global_detected_seizures,4235,4276,41
Jensen_Eisai_groupA,1,5,ts-global_detected_seizures,4297,4343,46
Jensen_Eisai_groupA,2,6,ts-global_detected_seizures,4299,4321,22
Jensen_Eisai_groupA,2,6,ts-global_detected_seizures,4324,4407,83
Jensen_Eisai_groupA,1,5,ts-global_detected_seizures,4383,4405,22
Jensen_Eisai_groupA,2,6,ts-global_detected_seizures,4418,4623,205
Jensen_Eisai_groupA,1,5,ts-global_detected_seizures,4544,4578,34
Jensen_Eisai_groupA,1,5,ts-global_detected_seizures,4579,4627,48
Jensen_Eisai_groupA,2,6,ts-global_detected_seizures,4625,4663,38
Jensen_Eisai_groupA,1,5,ts-global_detected_seizures,4643,4686,43
Jensen_Eisai_groupA,2,6,ts-global_detected_seizures,4664,4690,26
Jensen_Eisai_groupA,1,5,ts-global_detected_seizures,4688,4713,25
Jensen_Eisai_groupA,2,6,ts-global_detected_seizures,4691,4719,28
Jensen_Eisai_groupA,2,6,ts-global_detected_seizures,4720,4753,33
Jensen_Eisai_groupA,1,5,ts-global_detected_seizures,4729,4755,26
Jensen_Eisai_groupA,2,6,ts-global_detected_seizures,4760,4798,38
Jensen_Eisai_groupA,2,6,ts-global_detected_seizures,4805,4840,35
Jensen_Eisai_groupA,1,5,ts-global_detected_seizures,4823,4850,27
Jensen_Eisai_groupA,2,6,ts-global_detected_seizures,4854,4898,44
Jensen_Eisai_groupA,1,5,ts-global_detected_seizures,4886,4908,22
Jensen_Eisai_groupA,2,6,ts-global_detected_seizures,4925,5037,112
Jensen_Eisai_groupA,1,5,ts-global_detected_seizures,4960,4988,28
Jensen_Eisai_groupA,1,5,ts-global_detected_seizures,5020,5050,30
Jensen_Eisai_groupA,2,6,ts-global_detected_seizures,5039,5066,27
Jensen_Eisai_groupA,2,6,ts-global_detected_seizures,5083,5113,30
Jensen_Eisai_groupA,1,5,ts-global_detected_seizures,5097,5124,27
Jensen_Eisai_groupA,2,6,ts-global_detected_seizures,5114,5139,25
Jensen_Eisai_groupA,2,6,ts-global_detected_seizures,5145,5206,61
Jensen_Eisai_groupA,2,6,ts-global_detected_seizures,5214,5239,25
Jensen_Eisai_groupA,1,5,ts-global_detected_seizures,5247,5270,23
Jensen_Eisai_groupA,1,5,ts-global_detected_seizures,5330,5356,26
Jensen_Eisai_groupA,2,6,ts-global_detected_seizures,5335,5383,48
Jensen_Eisai_groupA,2,6,ts-global_detected_seizures,5384,5427,43
Jensen_Eisai_groupA,1,5,ts-global_detected_seizures,5418,5491,73
Jensen_Eisai_groupA,2,6,ts-global_detected_seizures,5451,5473,22
Jensen_Eisai_groupA,2,6,ts-global_detected_seizures,5487,5514,27
Jensen_Eisai_groupA,1,5,ts-global_detected_seizures,5492,5547,55
Jensen_Eisai_groupA,2,6,ts-global_detected_seizures,5521,5559,38
Jensen_Eisai_groupA,2,6,ts-global_detected_seizures,5594,5630,36
Jensen_Eisai_groupA,1,5,ts-global_detected_seizures,5602,5652,50
Jensen_Eisai_groupA,1,5,ts-global_detected_seizures,5662,5797,135
Jensen_Eisai_groupA,2,6,ts-global_detected_seizures,5664,5728,64
Jensen_Eisai_groupA,2,6,ts-global_detected_seizures,5664,5728,64
Jensen_Eisai_groupA,2,6,ts-global_detected_seizures,5729,5755,26
Jensen_Eisai_groupA,2,6,ts-global_detected_seizures,5780,5856,76
Jensen_Eisai_groupA,1,5,ts-global_detected_seizures,5799,5996,197
Jensen_Eisai_groupA,2,6,ts-global_detected_seizures,5913,5949,36
Jensen_Eisai_groupA,2,6,ts-global_detected_seizures,5970,6035,65
Jensen_Eisai_groupA,1,5,ts-global_detected_seizures,6013,6068,55
Jensen_Eisai_groupA,2,6,ts-global_detected_seizures,6043,6071,28
Jensen_Eisai_groupA,2,6,ts-global_detected_seizures,6085,6390,305
Jensen_Eisai_groupA,1,5,ts-global_detected_seizures,6184,6243,59
Jensen_Eisai_groupA,1,5,ts-global_detected_seizures,6246,6326,80
Jensen_Eisai_groupA,1,5,ts-global_detected_seizures,6342,6399,57
Jensen_Eisai_groupA,2,6,ts-global_detected_seizures,6391,6469,78
Jensen_Eisai_groupA,2,6,ts-global_detected_seizures,6471,6494,23
Jensen_Eisai_groupA,2,6,ts-global_detected_seizures,6496,6557,61
Jensen_Eisai_groupA,1,5,ts-global_detected_seizures,6539,6563,24
Jensen_Eisai_groupA,2,6,ts-global_detected_seizures,6602,6628,26
Jensen_Eisai_groupA,1,5,ts-global_detected_seizures,6627,6821,194
Jensen_Eisai_groupA,2,6,ts-global_detected_seizures,6630,6679,49
Jensen_Eisai_groupA,2,6,ts-global_detected_seizures,6680,6702,22
Jensen_Eisai_groupA,2,6,ts-global_detected_seizures,6801,6841,40
Jensen_Eisai_groupA,1,5,ts-global_detected_seizures,6835,6857,22
Jensen_Eisai_groupA,2,6,ts-global_detected_seizures,6853,6880,27
Jensen_Eisai_groupA,2,6,ts-global_detected_seizures,6903,6946,43
Jensen_Eisai_groupA,1,5,ts-global_detected_seizures,6916,6939,23
Jensen_Eisai_groupA,1,5,ts-global_detected_seizures,6940,6976,36
Jensen_Eisai_groupA,2,6,ts-global_detected_seizures,6970,7008,38
Jensen_Eisai_groupA,1,5,ts-global_detected_seizures,6986,7042,56
Jensen_Eisai_groupA,2,6,ts-global_detected_seizures,7022,7053,31
Jensen_Eisai_groupA,1,5,ts-global_detected_seizures,7053,7116,63
Jensen_Eisai_groupA,2,6,ts-global_detected_seizures,7070,7114,44
Jensen_Eisai_groupA,1,5,ts-global_detected_seizures,7148,7180,32
Jensen_Eisai_groupA,2,6,ts-global_detected_seizures,7150,7177,27
Jensen_Eisai_groupA,1,5,ts-global_detected_seizures,7182,7220,38
Jensen_Eisai_groupA,2,6,ts-global_detected_seizures,7215,7271,56
Jensen_Eisai_groupA,1,5,ts-global_detected_seizures,7309,7363,54
Jensen_Eisai_groupA,2,6,ts-global_detected_seizures,7366,7534,168
Jensen_Eisai_groupA,1,5,ts-global_detected_seizures,7377,7404,27
Jensen_Eisai_groupA,1,5,ts-global_detected_seizures,7416,7477,61
Jensen_Eisai_groupA,1,5,ts-global_detected_seizures,7478,7503,25
Jensen_Eisai_groupA,2,6,ts-global_detected_seizures,7536,7584,48
Jensen_Eisai_groupA,2,6,ts-global_detected_seizures,7598,7626,28
Jensen_Eisai_groupA,2,6,ts-global_detected_seizures,7628,7651,23
Jensen_Eisai_groupA,1,5,ts-global_detected_seizures,7646,7926,280
Jensen_Eisai_groupA,2,6,ts-global_detected_seizures,7687,7727,40
Jensen_Eisai_groupA,2,6,ts-global_detected_seizures,7731,7756,25
Jensen_Eisai_groupA,2,6,ts-global_detected_seizures,7761,7808,47
Jensen_Eisai_groupA,2,6,ts-global_detected_seizures,7821,7846,25
Jensen_Eisai_groupA,2,6,ts-global_detected_seizures,7853,7883,30
Jensen_Eisai_groupA,2,6,ts-global_detected_seizures,7910,7939,29
Jensen_Eisai_groupA,1,5,ts-global_detected_seizures,7927,8031,104
Jensen_Eisai_groupA,2,6,ts-global_detected_seizures,7943,7992,49
Jensen_Eisai_groupA,2,6,ts-global_detected_seizures,8008,8043,35
Jensen_Eisai_groupA,1,5,ts-global_detected_seizures,8036,8225,189
Jensen_Eisai_groupA,2,6,ts-global_detected_seizures,8101,8172,71
Jensen_Eisai_groupA,2,6,ts-global_detected_seizures,8187,8221,34
Jensen_Eisai_groupA,1,5,ts-global_detected_seizures,8259,8289,30
Jensen_Eisai_groupA,2,6,ts-global_detected_seizures,8268,8298,30
Jensen_Eisai_groupA,1,5,ts-global_detected_seizures,8330,8367,37
Jensen_Eisai_groupA,2,6,ts-global_detected_seizures,8334,8369,35
Jensen_Eisai_groupA,1,5,ts-global_detected_seizures,8389,8430,41
Jensen_Eisai_groupA,2,6,ts-global_detected_seizures,8395,8451,56
Jensen_Eisai_groupA,1,5,ts-global_detected_seizures,8434,8482,48
Jensen_Eisai_groupA,2,6,ts-global_detected_seizures,8470,8492,22
Jensen_Eisai_groupA,2,6,ts-global_detected_seizures,8518,8574,56
Jensen_Eisai_groupA,1,5,ts-global_detected_seizures,8524,8576,52
Jensen_Eisai_groupA,1,5,ts-global_detected_seizures,8639,8786,147
Jensen_Eisai_groupA,2,6,ts-global_detected_seizures,8656,8695,39
Jensen_Eisai_groupA,2,6,ts-global_detected_seizures,8730,8764,34
Jensen_Eisai_groupA,2,6,ts-global_detected_seizures,8770,8803,33
Jensen_Eisai_groupA,1,5,ts-global_detected_seizures,8787,8832,45
Jensen_Eisai_groupA,2,6,ts-global_detected_seizures,8820,8862,42
Jensen_Eisai_groupA,2,6,ts-global_detected_seizures,8870,8904,34
Jensen_Eisai_groupA,1,5,ts-global_detected_seizures,8886,8986,100
Jensen_Eisai_groupA,2,6,ts-global_detected_seizures,8958,9000,42
Jensen_Eisai_groupA,1,5,ts-global_detected_seizures,8988,12486,3498
Jensen_Eisai_groupA,2,6,ts-global_detected_seizures,9002,9026,24
Jensen_Eisai_groupA,2,6,ts-global_detected_seizures,9045,9067,22
Jensen_Eisai_groupA,2,6,ts-global_detected_seizures,9082,9110,28
Jensen_Eisai_groupA,2,6,ts-global_detected_seizures,9164,9257,93
Jensen_Eisai_groupA,2,6,ts-global_detected_seizures,9258,9288,30
Jensen_Eisai_groupA,2,6,ts-global_detected_seizures,9322,9376,54
Jensen_Eisai_groupA,2,6,ts-global_detected_seizures,9405,9617,212
Jensen_Eisai_groupA,2,6,ts-global_detected_seizures,9618,9679,61
Jensen_Eisai_groupA,2,6,ts-global_detected_seizures,9685,9733,48
Jensen_Eisai_groupA,2,6,ts-global_detected_seizures,9735,9800,65
Jensen_Eisai_groupA,2,6,ts-global_detected_seizures,9811,9837,26
Jensen_Eisai_groupA,2,6,ts-global_detected_seizures,9851,9883,32
Jensen_Eisai_groupA,2,6,ts-global_detected_seizures,9906,9943,37
Jensen_Eisai_groupA,2,6,ts-global_detected_seizures,9960,10016,56
Jensen_Eisai_groupA,2,6,ts-global_detected_seizures,10043,10261,218
Jensen_Eisai_groupA,2,6,ts-global_detected_seizures,10263,10311,48
Jensen_Eisai_groupA,2,6,ts-global_detected_seizures,10343,10376,33
Jensen_Eisai_groupA,2,6,ts-global_detected_seizures,10414,10460,46
Jensen_Eisai_groupA,2,6,ts-global_detected_seizures,10516,10554,38
Jensen_Eisai_groupA,2,6,ts-global_detected_seizures,10584,10622,38
Jensen_Eisai_groupA,2,6,ts-global_detected_seizures,10672,10774,102
Jensen_Eisai_groupA,2,6,ts-global_detected_seizures,10802,10833,31
Jensen_Eisai_groupA,2,6,ts-global_detected_seizures,10843,10879,36
Jensen_Eisai_groupA,2,6,ts-global_detected_seizures,10965,11004,39
Jensen_Eisai_groupA,2,6,ts-global_detected_seizures,11052,11099,47
Jensen_Eisai_groupA,2,6,ts-global_detected_seizures,11125,11147,22
Jensen_Eisai_groupA,2,6,ts-global_detected_seizures,11169,11213,44
Jensen_Eisai_groupA,2,6,ts-global_detected_seizures,11296,11331,35
Jensen_Eisai_groupA,2,6,ts-global_detected_seizures,11354,11376,22
Jensen_Eisai_groupA,2,6,ts-global_detected_seizures,11379,11406,27
Jensen_Eisai_groupA,2,6,ts-global_detected_seizures,11441,11533,92
Jensen_Eisai_groupA,2,6,ts-global_detected_seizures,11583,11614,31
Jensen_Eisai_groupA,2,6,ts-global_detected_seizures,11706,11744,38
Jensen_Eisai_groupA,2,6,ts-global_detected_seizures,11787,11821,34
Jensen_Eisai_groupA,2,6,ts-global_detected_seizures,11852,11878,26
Jensen_Eisai_groupA,2,6,ts-global_detected_seizures,11935,11994,59
Jensen_Eisai_groupA,2,6,ts-global_detected_seizures,12025,12050,25
Jensen_Eisai_groupA,2,6,ts-global_detected_seizures,12055,12084,29
Jensen_Eisai_groupA,2,6,ts-global_detected_seizures,12151,12193,42
Jensen_Eisai_groupA,2,6,ts-global_detected_seizures,12200,12229,29
Jensen_Eisai_groupA,2,6,ts-global_detected_seizures,12265,12326,61
Jensen_Eisai_groupA,2,6,ts-global_detected_seizures,12397,12425,28
Jensen_Eisai_groupA,2,6,ts-global_detected_seizures,12426,12461,35
Jensen_Eisai_groupA,2,6,ts-global_detected_seizures,12462,12490,28
Jensen_Eisai_groupA,1,5,ts-global_detected_seizures,12487,12701,214
Jensen_Eisai_groupA,2,6,ts-global_detected_seizures,12491,12545,54
Jensen_Eisai_groupA,2,6,ts-global_detected_seizures,12547,12575,28
Jensen_Eisai_groupA,2,6,ts-global_detected_seizures,12597,12630,33
Jensen_Eisai_groupA,1,5,ts-global_detected_seizures,12702,12728,26
Jensen_Eisai_groupA,2,6,ts-global_detected_seizures,12707,12740,33
Jensen_Eisai_groupA,1,5,ts-global_detected_seizures,12746,12784,38
Jensen_Eisai_groupA,2,6,ts-global_detected_seizures,12756,12808,52
Jensen_Eisai_groupA,2,6,ts-global_detected_seizures,12821,12872,51
Jensen_Eisai_groupA,1,5,ts-global_detected_seizures,12826,12903,77
Jensen_Eisai_groupA,2,6,ts-global_detected_seizures,12906,12934,28
Jensen_Eisai_groupA,2,6,ts-global_detected_seizures,12959,13030,71
Jensen_Eisai_groupA,1,5,ts-global_detected_seizures,12973,13003,30
Jensen_Eisai_groupA,2,6,ts-global_detected_seizures,13035,13058,23
Jensen_Eisai_groupA,1,5,ts-global_detected_seizures,13064,13086,22
Jensen_Eisai_groupA,2,6,ts-global_detected_seizures,13076,13118,42
Jensen_Eisai_groupA,1,5,ts-global_detected_seizures,13132,13155,23
Jensen_Eisai_groupA,2,6,ts-global_detected_seizures,13165,14425,1260
Jensen_Eisai_groupA,1,5,ts-global_detected_seizures,13198,13231,33
Jensen_Eisai_groupA,1,5,ts-global_detected_seizures,13382,13421,39
Jensen_Eisai_groupA,1,5,ts-global_detected_seizures,13505,13571,66
Jensen_Eisai_groupA,1,5,ts-global_detected_seizures,13586,13608,22
Jensen_Eisai_groupA,1,5,ts-global_detected_seizures,13609,13634,25
Jensen_Eisai_groupA,1,5,ts-global_detected_seizures,13635,13657,22
Jensen_Eisai_groupA,1,5,ts-global_detected_seizures,13681,13726,45
Jensen_Eisai_groupA,1,5,ts-global_detected_seizures,13780,13888,108
Jensen_Eisai_groupA,1,5,ts-global_detected_seizures,13889,13927,38
Jensen_Eisai_groupA,1,5,ts-global_detected_seizures,13936,13968,32
Jensen_Eisai_groupA,1,5,ts-global_detected_seizures,14035,14074,39
Jensen_Eisai_groupA,1,5,ts-global_detected_seizures,14113,14232,119
Jensen_Eisai_groupA,1,5,ts-global_detected_seizures,14233,14255,22
Jensen_Eisai_groupA,1,5,ts-global_detected_seizures,14256,14284,28
Jensen_Eisai_groupA,1,5,ts-global_detected_seizures,14286,14315,29
Jensen_Eisai_groupA,1,5,ts-global_detected_seizures,14316,14391,75
Jensen_Eisai_groupA,1,5,ts-global_detected_seizures,14398,14420,22
Jensen_Eisai_groupA,1,5,ts-global_detected_seizures,14421,14462,41
Jensen_Eisai_groupA,2,6,ts-global_detected_seizures,14439,14496,57
Jensen_Eisai_groupA,1,5,ts-global_detected_seizures,14465,14498,33
Jensen_Eisai_groupA,2,6,ts-global_detected_seizures,14502,14536,34
Jensen_Eisai_groupA,2,6,ts-global_detected_seizures,14543,14590,47
Jensen_Eisai_groupA,1,5,ts-global_detected_seizures,14565,14603,38
Jensen_Eisai_groupA,2,6,ts-global_detected_seizures,14629,14665,36
Jensen_Eisai_groupA,1,5,ts-global_detected_seizures,14653,14690,37
Jensen_Eisai_groupA,1,5,ts-global_detected_seizures,14718,14743,25
Jensen_Eisai_groupA,1,5,ts-global_detected_seizures,14754,14781,27
Jensen_Eisai_groupA,1,5,ts-global_detected_seizures,14792,14815,23
Jensen_Eisai_groupA,2,6,ts-global_detected_seizures,14793,14820,27
Jensen_Eisai_groupA,2,6,ts-global_detected_seizures,14844,14875,31
Jensen_Eisai_groupA,1,5,ts-global_detected_seizures,14856,14981,125
Jensen_Eisai_groupA,2,6,ts-global_detected_seizures,14905,14929,24
Jensen_Eisai_groupA,2,6,ts-global_detected_seizures,14969,14992,23
Jensen_Eisai_groupA,1,5,ts-global_detected_seizures,14986,15025,39
Jensen_Eisai_groupA,2,6,ts-global_detected_seizures,15021,15055,34
Jensen_Eisai_groupA,1,5,ts-global_detected_seizures,15048,15099,51
Jensen_Eisai_groupA,2,6,ts-global_detected_seizures,15108,15132,24
Jensen_Eisai_groupA,1,5,ts-global_detected_seizures,15120,15148,28
Jensen_Eisai_groupA,2,6,ts-global_detected_seizures,15162,15194,32
Jensen_Eisai_groupA,1,5,ts-global_detected_seizures,15163,15244,81
Jensen_Eisai_groupA,2,6,ts-global_detected_seizures,15236,15263,27
Jensen_Eisai_groupA,1,5,ts-global_detected_seizures,15250,15331,81
Jensen_Eisai_groupA,2,6,ts-global_detected_seizures,15268,15299,31
Jensen_Eisai_groupA,1,5,ts-global_detected_seizures,15373,15417,44
Jensen_Eisai_groupA,2,6,ts-global_detected_seizures,15377,15425,48
Jensen_Eisai_groupA,1,5,ts-global_detected_seizures,15435,15472,37
Jensen_Eisai_groupA,2,6,ts-global_detected_seizures,15470,15494,24
Jensen_Eisai_groupA,1,5,ts-global_detected_seizures,15473,15512,39
Jensen_Eisai_groupA,2,6,ts-global_detected_seizures,15495,15531,36
Jensen_Eisai_groupA,1,5,ts-global_detected_seizures,15513,15547,34
Jensen_Eisai_groupA,2,6,ts-global_detected_seizures,15532,15569,37
Jensen_Eisai_groupA,1,5,ts-global_detected_seizures,15594,15781,187
Jensen_Eisai_groupA,2,6,ts-global_detected_seizures,15623,15648,25
Jensen_Eisai_groupA,2,6,ts-global_detected_seizures,15677,15708,31
Jensen_Eisai_groupA,2,6,ts-global_detected_seizures,15719,15746,27
Jensen_Eisai_groupA,1,5,ts-global_detected_seizures,15782,15837,55
Jensen_Eisai_groupA,2,6,ts-global_detected_seizures,15794,15843,49
Jensen_Eisai_groupA,1,5,ts-global_detected_seizures,15854,15964,110
Jensen_Eisai_groupA,2,6,ts-global_detected_seizures,15881,15906,25
Jensen_Eisai_groupA,2,6,ts-global_detected_seizures,15917,15941,24
Jensen_Eisai_groupA,2,6,ts-global_detected_seizures,15968,16003,35
Jensen_Eisai_groupA,1,5,ts-global_detected_seizures,15969,16084,115
Jensen_Eisai_groupA,2,6,ts-global_detected_seizures,16043,16164,121
Jensen_Eisai_groupA,1,5,ts-global_detected_seizures,16086,16135,49
Jensen_Eisai_groupA,1,5,ts-global_detected_seizures,16155,16184,29
Jensen_Eisai_groupA,1,5,ts-global_detected_seizures,16198,16235,37
Jensen_Eisai_groupA,1,5,ts-global_detected_seizures,16245,16283,38
Jensen_Eisai_groupA,2,6,ts-global_detected_seizures,16250,16272,22
Jensen_Eisai_groupA,1,5,ts-global_detected_seizures,16302,16335,33
Jensen_Eisai_groupA,2,6,ts-global_detected_seizures,16306,16351,45
Jensen_Eisai_groupA,1,5,ts-global_detected_seizures,16353,16421,68
Jensen_Eisai_groupA,1,5,ts-global_detected_seizures,16422,16462,40
Jensen_Eisai_groupA,2,6,ts-global_detected_seizures,16450,16500,50
Jensen_Eisai_groupA,1,5,ts-global_detected_seizures,16477,16518,41
Jensen_Eisai_groupA,1,5,ts-global_detected_seizures,16521,16558,37
Jensen_Eisai_groupA,2,6,ts-global_detected_seizures,16557,16643,86
Jensen_Eisai_groupA,1,5,ts-global_detected_seizures,16598,16667,69
Jensen_Eisai_groupA,2,6,ts-global_detected_seizures,16659,16685,26
Jensen_Eisai_groupA,1,5,ts-global_detected_seizures,16681,16722,41
Jensen_Eisai_groupA,2,6,ts-global_detected_seizures,16695,16723,28
Jensen_Eisai_groupA,1,5,ts-global_detected_seizures,16723,16793,70
Jensen_Eisai_groupA,2,6,ts-global_detected_seizures,16726,16775,49
Jensen_Eisai_groupA,1,5,ts-global_detected_seizures,16809,16916,107
Jensen_Eisai_groupA,2,6,ts-global_detected_seizures,16846,16877,31
Jensen_Eisai_groupA,2,6,ts-global_detected_seizures,16910,16941,31
Jensen_Eisai_groupA,1,5,ts-global_detected_seizures,16928,16956,28
Jensen_Eisai_groupA,2,6,ts-global_detected_seizures,16947,16971,24
Jensen_Eisai_groupA,1,5,ts-global_detected_seizures,16966,17011,45
Jensen_Eisai_groupA,2,6,ts-global_detected_seizures,16988,17036,48
Jensen_Eisai_groupA,1,5,ts-global_detected_seizures,17040,18419,1379
Jensen_Eisai_groupA,2,6,ts-global_detected_seizures,17102,17147,45
Jensen_Eisai_groupA,2,6,ts-global_detected_seizures,17184,17227,43
Jensen_Eisai_groupA,2,6,ts-global_detected_seizures,17252,17275,23
Jensen_Eisai_groupA,2,6,ts-global_detected_seizures,17315,17354,39
Jensen_Eisai_groupA,2,6,ts-global_detected_seizures,17357,17380,23
Jensen_Eisai_groupA,2,6,ts-global_detected_seizures,17402,17427,25
Jensen_Eisai_groupA,2,6,ts-global_detected_seizures,17428,17455,27
Jensen_Eisai_groupA,2,6,ts-global_detected_seizures,17485,17596,111
Jensen_Eisai_groupA,2,6,ts-global_detected_seizures,17597,17651,54
Jensen_Eisai_groupA,2,6,ts-global_detected_seizures,17652,17674,22
Jensen_Eisai_groupA,2,6,ts-global_detected_seizures,17687,17709,22
Jensen_Eisai_groupA,2,6,ts-global_detected_seizures,17713,17769,56
Jensen_Eisai_groupA,2,6,ts-global_detected_seizures,17800,17824,24
Jensen_Eisai_groupA,2,6,ts-global_detected_seizures,17830,17884,54
Jensen_Eisai_groupA,2,6,ts-global_detected_seizures,17907,17934,27
Jensen_Eisai_groupA,2,6,ts-global_detected_seizures,17994,18058,64
Jensen_Eisai_groupA,2,6,ts-global_detected_seizures,18112,18163,51
Jensen_Eisai_groupA,2,6,ts-global_detected_seizures,18174,18207,33
Jensen_Eisai_groupA,2,6,ts-global_detected_seizures,18246,18277,31
Jensen_Eisai_groupA,2,6,ts-global_detected_seizures,18319,18348,29
Jensen_Eisai_groupA,2,6,ts-global_detected_seizures,18398,18425,27
Jensen_Eisai_groupA,1,5,ts-global_detected_seizures,18420,20441,2021
Jensen_Eisai_groupA,2,6,ts-global_detected_seizures,18467,18632,165
Jensen_Eisai_groupA,2,6,ts-global_detected_seizures,18644,18688,44
Jensen_Eisai_groupA,2,6,ts-global_detected_seizures,18704,18732,28
Jensen_Eisai_groupA,2,6,ts-global_detected_seizures,18792,18818,26
Jensen_Eisai_groupA,2,6,ts-global_detected_seizures,18862,18897,35
Jensen_Eisai_groupA,2,6,ts-global_detected_seizures,18898,18955,57
Jensen_Eisai_groupA,2,6,ts-global_detected_seizures,19006,19044,38
Jensen_Eisai_groupA,2,6,ts-global_detected_seizures,19049,19111,62
Jensen_Eisai_groupA,2,6,ts-global_detected_seizures,19112,19216,104
Jensen_Eisai_groupA,2,6,ts-global_detected_seizures,19279,19303,24
Jensen_Eisai_groupA,2,6,ts-global_detected_seizures,19330,19362,32
Jensen_Eisai_groupA,2,6,ts-global_detected_seizures,19394,19643,249
Jensen_Eisai_groupA,2,6,ts-global_detected_seizures,19644,19773,129
Jensen_Eisai_groupA,2,6,ts-global_detected_seizures,19824,19874,50
Jensen_Eisai_groupA,2,6,ts-global_detected_seizures,19893,19943,50
Jensen_Eisai_groupA,2,6,ts-global_detected_seizures,19987,20023,36
Jensen_Eisai_groupA,2,6,ts-global_detected_seizures,20060,20087,27
Jensen_Eisai_groupA,2,6,ts-global_detected_seizures,20149,20176,27
Jensen_Eisai_groupA,2,6,ts-global_detected_seizures,20224,20477,253
Jensen_Eisai_groupA,1,5,ts-global_detected_seizures,20442,20488,46
Jensen_Eisai_groupA,2,6,ts-global_detected_seizures,20478,20512,34
Jensen_Eisai_groupA,1,5,ts-global_detected_seizures,20499,20553,54
Jensen_Eisai_groupA,2,6,ts-global_detected_seizures,20532,20565,33
Jensen_Eisai_groupA,1,5,ts-global_detected_seizures,20554,20584,30
Jensen_Eisai_groupA,2,6,ts-global_detected_seizures,20576,20605,29
Jensen_Eisai_groupA,2,6,ts-global_detected_seizures,20606,20629,23
Jensen_Eisai_groupA,1,5,ts-global_detected_seizures,20607,20664,57
Jensen_Eisai_groupA,2,6,ts-global_detected_seizures,20636,20667,31
Jensen_Eisai_groupA,1,5,ts-global_detected_seizures,20705,20907,202
Jensen_Eisai_groupA,2,6,ts-global_detected_seizures,20725,20772,47
Jensen_Eisai_groupA,2,6,ts-global_detected_seizures,20819,20848,29
Jensen_Eisai_groupA,2,6,ts-global_detected_seizures,20849,20880,31
Jensen_Eisai_groupA,2,6,ts-global_detected_seizures,20909,20943,34
Jensen_Eisai_groupA,1,5,ts-global_detected_seizures,20928,20951,23
Jensen_Eisai_groupA,2,6,ts-global_detected_seizures,20957,21008,51
Jensen_Eisai_groupA,1,5,ts-global_detected_seizures,21020,21063,43
Jensen_Eisai_groupA,2,6,ts-global_detected_seizures,21078,21201,123
Jensen_Eisai_groupA,1,5,ts-global_detected_seizures,21096,21177,81
Jensen_Eisai_groupA,1,5,ts-global_detected_seizures,21194,21224,30
Jensen_Eisai_groupA,2,6,ts-global_detected_seizures,21216,21284,68
Jensen_Eisai_groupA,1,5,ts-global_detected_seizures,21254,21308,54
Jensen_Eisai_groupA,1,5,ts-global_detected_seizures,21310,21332,22
Jensen_Eisai_groupA,2,6,ts-global_detected_seizures,21337,21379,42
Jensen_Eisai_groupA,1,5,ts-global_detected_seizures,21342,21401,59
Jensen_Eisai_groupA,2,6,ts-global_detected_seizures,21405,21442,37
Jensen_Eisai_groupA,1,5,ts-global_detected_seizures,21408,21442,34
Jensen_Eisai_groupA,1,5,ts-global_detected_seizures,21444,21479,35
Jensen_Eisai_groupA,2,6,ts-global_detected_seizures,21476,21502,26
Jensen_Eisai_groupA,1,5,ts-global_detected_seizures,21498,21536,38
Jensen_Eisai_groupA,2,6,ts-global_detected_seizures,21503,21531,28
Jensen_Eisai_groupA,2,6,ts-global_detected_seizures,21553,21583,30
Jensen_Eisai_groupA,2,6,ts-global_detected_seizures,21584,21612,28
Jensen_Eisai_groupA,1,5,ts-global_detected_seizures,21590,21671,81
Jensen_Eisai_groupA,2,6,ts-global_detected_seizures,21644,21697,53
Jensen_Eisai_groupA,1,5,ts-global_detected_seizures,21673,21725,52
Jensen_Eisai_groupA,2,6,ts-global_detected_seizures,21725,21822,97
Jensen_Eisai_groupA,1,5,ts-global_detected_seizures,21740,21774,34
Jensen_Eisai_groupA,1,5,ts-global_detected_seizures,21776,21921,145
Jensen_Eisai_groupA,2,6,ts-global_detected_seizures,21839,21864,25
Jensen_Eisai_groupA,2,6,ts-global_detected_seizures,21865,21933,68
Jensen_Eisai_groupA,1,5,ts-global_detected_seizures,21922,21973,51
Jensen_Eisai_groupA,2,6,ts-global_detected_seizures,21938,21963,25
Jensen_Eisai_groupA,2,6,ts-global_detected_seizures,21971,22024,53
Jensen_Eisai_groupA,1,5,ts-global_detected_seizures,21975,22032,57
Jensen_Eisai_groupA,2,6,ts-global_detected_seizures,22035,22070,35
Jensen_Eisai_groupA,2,6,ts-global_detected_seizures,22073,22115,42
Jensen_Eisai_groupA,2,6,ts-global_detected_seizures,22131,22183,52
Jensen_Eisai_groupA,1,5,ts-global_detected_seizures,22156,22403,247
Jensen_Eisai_groupA,2,6,ts-global_detected_seizures,22184,22231,47
Jensen_Eisai_groupA,2,6,ts-global_detected_seizures,22258,22313,55
Jensen_Eisai_groupA,2,6,ts-global_detected_seizures,22333,22357,24
Jensen_Eisai_groupA,2,6,ts-global_detected_seizures,22372,22432,60
Jensen_Eisai_groupA,1,5,ts-global_detected_seizures,22404,22667,263
Jensen_Eisai_groupA,2,6,ts-global_detected_seizures,22453,22500,47
Jensen_Eisai_groupA,2,6,ts-global_detected_seizures,22516,22546,30
Jensen_Eisai_groupA,2,6,ts-global_detected_seizures,22576,22647,71
Jensen_Eisai_groupA,1,5,ts-global_detected_seizures,22670,22742,72
Jensen_Eisai_groupA,2,6,ts-global_detected_seizures,22671,22721,50
Jensen_Eisai_groupA,1,5,ts-global_detected_seizures,22782,22811,29
Jensen_Eisai_groupA,2,6,ts-global_detected_seizures,22801,22988,187
Jensen_Eisai_groupA,1,5,ts-global_detected_seizures,22870,23036,166
Jensen_Eisai_groupA,2,6,ts-global_detected_seizures,23001,23027,26
Jensen_Eisai_groupA,2,6,ts-global_detected_seizures,23037,23067,30
Jensen_Eisai_groupA,2,6,ts-global_detected_seizures,23082,23110,28
Jensen_Eisai_groupA,2,6,ts-global_detected_seizures,23124,23171,47
Jensen_Eisai_groupA,2,6,ts-global_detected_seizures,23172,23195,23
Jensen_Eisai_groupA,1,5,ts-global_detected_seizures,23197,23228,31
Jensen_Eisai_groupA,2,6,ts-global_detected_seizures,23230,23279,49
Jensen_Eisai_groupA,1,5,ts-global_detected_seizures,23233,23259,26
Jensen_Eisai_groupA,1,5,ts-global_detected_seizures,23265,23303,38
Jensen_Eisai_groupA,1,5,ts-global_detected_seizures,23304,23349,45
Jensen_Eisai_groupA,2,6,ts-global_detected_seizures,23311,23340,29
Jensen_Eisai_groupA,2,6,ts-global_detected_seizures,23351,23381,30
Jensen_Eisai_groupA,1,5,ts-global_detected_seizures,23370,23393,23
Jensen_Eisai_groupA,2,6,ts-global_detected_seizures,23382,23412,30
Jensen_Eisai_groupA,1,5,ts-global_detected_seizures,23425,23475,50
Jensen_Eisai_groupA,2,6,ts-global_detected_seizures,23431,23471,40
Jensen_Eisai_groupA,1,5,ts-global_detected_seizures,23476,23579,103
Jensen_Eisai_groupA,2,6,ts-global_detected_seizures,23491,23524,33
Jensen_Eisai_groupA,2,6,ts-global_detected_seizures,23574,23615,41
Jensen_Eisai_groupA,1,5,ts-global_detected_seizures,23586,23626,40
Jensen_Eisai_groupA,2,6,ts-global_detected_seizures,23625,23654,29
Jensen_Eisai_groupA,1,5,ts-global_detected_seizures,23629,23651,22
Jensen_Eisai_groupA,1,5,ts-global_detected_seizures,23666,23764,98
Jensen_Eisai_groupA,2,6,ts-global_detected_seizures,23743,23780,37
Jensen_Eisai_groupA,1,5,ts-global_detected_seizures,23784,23808,24
Jensen_Eisai_groupA,1,5,ts-global_detected_seizures,23825,23954,129
Jensen_Eisai_groupA,2,6,ts-global_detected_seizures,23833,23882,49
Jensen_Eisai_groupA,2,6,ts-global_detected_seizures,23896,23938,42
Jensen_Eisai_groupA,1,5,ts-global_detected_seizures,23955,24076,121
Jensen_Eisai_groupA,2,6,ts-global_detected_seizures,23991,24031,40
Jensen_Eisai_groupA,2,6,ts-global_detected_seizures,24040,24087,47
Jensen_Eisai_groupA,1,5,ts-global_detected_seizures,24078,24108,30
Jensen_Eisai_groupA,1,5,ts-global_detected_seizures,24109,24181,72
Jensen_Eisai_groupA,2,6,ts-global_detected_seizures,24123,24152,29
Jensen_Eisai_groupA,1,5,ts-global_detected_seizures,24185,24257,72
Jensen_Eisai_groupA,2,6,ts-global_detected_seizures,24214,25144,930
Jensen_Eisai_groupA,1,5,ts-global_detected_seizures,24258,24560,302
Jensen_Eisai_groupA,1,5,ts-global_detected_seizures,24600,24631,31
Jensen_Eisai_groupA,1,5,ts-global_detected_seizures,24705,24745,40
Jensen_Eisai_groupA,1,5,ts-global_detected_seizures,24795,24902,107
Jensen_Eisai_groupA,1,5,ts-global_detected_seizures,24910,27002,2092
Jensen_Eisai_groupA,2,6,ts-global_detected_seizures,25145,25178,33
Jensen_Eisai_groupA,2,6,ts-global_detected_seizures,25179,25201,22
Jensen_Eisai_groupA,2,6,ts-global_detected_seizures,25217,25284,67
Jensen_Eisai_groupA,2,6,ts-global_detected_seizures,25286,25338,52
Jensen_Eisai_groupA,2,6,ts-global_detected_seizures,25345,25452,107
Jensen_Eisai_groupA,2,6,ts-global_detected_seizures,25505,25534,29
Jensen_Eisai_groupA,2,6,ts-global_detected_seizures,25559,25594,35
Jensen_Eisai_groupA,2,6,ts-global_detected_seizures,25638,25708,70
Jensen_Eisai_groupA,2,6,ts-global_detected_seizures,25823,25860,37
Jensen_Eisai_groupA,2,6,ts-global_detected_seizures,25941,26000,59
Jensen_Eisai_groupA,2,6,ts-global_detected_seizures,26014,26055,41
Jensen_Eisai_groupA,2,6,ts-global_detected_seizures,26114,26154,40
Jensen_Eisai_groupA,2,6,ts-global_detected_seizures,26155,26187,32
Jensen_Eisai_groupA,2,6,ts-global_detected_seizures,26212,26248,36
Jensen_Eisai_groupA,2,6,ts-global_detected_seizures,26260,26325,65
Jensen_Eisai_groupA,2,6,ts-global_detected_seizures,26351,26378,27
Jensen_Eisai_groupA,2,6,ts-global_detected_seizures,26396,26436,40
Jensen_Eisai_groupA,2,6,ts-global_detected_seizures,26501,26530,29
Jensen_Eisai_groupA,2,6,ts-global_detected_seizures,26572,26597,25
Jensen_Eisai_groupA,2,6,ts-global_detected_seizures,26611,26649,38
Jensen_Eisai_groupA,2,6,ts-global_detected_seizures,26684,26711,27
Jensen_Eisai_groupA,2,6,ts-global_detected_seizures,26744,26794,50
Jensen_Eisai_groupA,2,6,ts-global_detected_seizures,26820,26848,28
Jensen_Eisai_groupA,2,6,ts-global_detected_seizures,26906,27004,98
Jensen_Eisai_groupA,1,5,ts-global_detected_seizures,27003,27071,68
Jensen_Eisai_groupA,2,6,ts-global_detected_seizures,27005,27050,45
Jensen_Eisai_groupA,1,5,ts-global_detected_seizures,27076,27104,28
Jensen_Eisai_groupA,2,6,ts-global_detected_seizures,27105,27131,26
Jensen_Eisai_groupA,1,5,ts-global_detected_seizures,27111,27141,30
Jensen_Eisai_groupA,2,6,ts-global_detected_seizures,27146,27176,30
Jensen_Eisai_groupA,1,5,ts-global_detected_seizures,27167,27189,22
Jensen_Eisai_groupA,2,6,ts-global_detected_seizures,27214,27241,27
Jensen_Eisai_groupA,1,5,ts-global_detected_seizures,27241,27272,31
Jensen_Eisai_groupA,2,6,ts-global_detected_seizures,27268,27294,26
Jensen_Eisai_groupA,1,5,ts-global_detected_seizures,27275,27298,23
Jensen_Eisai_groupA,1,5,ts-global_detected_seizures,27299,27323,24
Jensen_Eisai_groupA,2,6,ts-global_detected_seizures,27341,28188,847
Jensen_Eisai_groupA,1,5,ts-global_detected_seizures,27470,27499,29
Jensen_Eisai_groupA,1,5,ts-global_detected_seizures,27517,27554,37
Jensen_Eisai_groupA,1,5,ts-global_detected_seizures,27690,27799,109
Jensen_Eisai_groupA,1,5,ts-global_detected_seizures,27853,27929,76
Jensen_Eisai_groupA,1,5,ts-global_detected_seizures,27930,27952,22
Jensen_Eisai_groupA,1,5,ts-global_detected_seizures,27956,27995,39
Jensen_Eisai_groupA,1,5,ts-global_detected_seizures,28014,28036,22
Jensen_Eisai_groupA,1,5,ts-global_detected_seizures,28135,28318,183
Jensen_Eisai_groupA,2,6,ts-global_detected_seizures,28189,28214,25
Jensen_Eisai_groupA,2,6,ts-global_detected_seizures,28216,28250,34
Jensen_Eisai_groupA,2,6,ts-global_detected_seizures,28264,28286,22
Jensen_Eisai_groupA,2,6,ts-global_detected_seizures,28297,28325,28
Jensen_Eisai_groupA,1,5,ts-global_detected_seizures,28322,28459,137
Jensen_Eisai_groupA,2,6,ts-global_detected_seizures,28404,28432,28
Jensen_Eisai_groupA,2,6,ts-global_detected_seizures,28445,28471,26
Jensen_Eisai_groupA,1,5,ts-global_detected_seizures,28460,28483,23
Jensen_Eisai_groupA,1,5,ts-global_detected_seizures,28489,28519,30
Jensen_Eisai_groupA,2,6,ts-global_detected_seizures,28507,28535,28
Jensen_Eisai_groupA,1,5,ts-global_detected_seizures,28547,28572,25
Jensen_Eisai_groupA,2,6,ts-global_detected_seizures,28605,28634,29
Jensen_Eisai_groupA,2,6,ts-global_detected_seizures,28651,28675,24
Jensen_Eisai_groupA,1,5,ts-global_detected_seizures,28668,28721,53
Jensen_Eisai_groupA,2,6,ts-global_detected_seizures,28699,28728,29
Jensen_Eisai_groupA,2,6,ts-global_detected_seizures,28775,28828,53
Jensen_Eisai_groupA,1,5,ts-global_detected_seizures,28782,28880,98
Jensen_Eisai_groupA,2,6,ts-global_detected_seizures,28833,28856,23
Jensen_Eisai_groupA,1,5,ts-global_detected_seizures,28882,28920,38
Jensen_Eisai_groupA,2,6,ts-global_detected_seizures,28963,28989,26
Jensen_Eisai_groupA,2,6,ts-global_detected_seizures,29012,29038,26
Jensen_Eisai_groupA,1,5,ts-global_detected_seizures,29013,29198,185
Jensen_Eisai_groupA,2,6,ts-global_detected_seizures,29039,29073,34
Jensen_Eisai_groupA,2,6,ts-global_detected_seizures,29102,29130,28
Jensen_Eisai_groupA,2,6,ts-global_detected_seizures,29166,29194,28
Jensen_Eisai_groupA,2,6,ts-global_detected_seizures,29195,29319,124
Jensen_Eisai_groupA,1,5,ts-global_detected_seizures,29200,29237,37
Jensen_Eisai_groupA,1,5,ts-global_detected_seizures,29245,29285,40
Jensen_Eisai_groupA,1,5,ts-global_detected_seizures,29293,29330,37
Jensen_Eisai_groupA,1,5,ts-global_detected_seizures,29331,29369,38
Jensen_Eisai_groupA,2,6,ts-global_detected_seizures,29338,29362,24
Jensen_Eisai_groupA,1,5,ts-global_detected_seizures,29376,29408,32
Jensen_Eisai_groupA,2,6,ts-global_detected_seizures,29407,29453,46
Jensen_Eisai_groupA,1,5,ts-global_detected_seizures,29505,29570,65
Jensen_Eisai_groupA,2,6,ts-global_detected_seizures,29542,29573,31
Jensen_Eisai_groupA,1,5,ts-global_detected_seizures,29578,29609,31
Jensen_Eisai_groupA,2,6,ts-global_detected_seizures,29605,29639,34
Jensen_Eisai_groupA,1,5,ts-global_detected_seizures,29610,29633,23
Jensen_Eisai_groupA,1,5,ts-global_detected_seizures,29634,29657,23
Jensen_Eisai_groupA,1,5,ts-global_detected_seizures,29666,29715,49
Jensen_Eisai_groupA,1,5,ts-global_detected_seizures,29757,29869,112
Jensen_Eisai_groupA,2,6,ts-global_detected_seizures,29773,29862,89
Jensen_Eisai_groupA,1,5,ts-global_detected_seizures,29873,29922,49
Jensen_Eisai_groupA,2,6,ts-global_detected_seizures,29924,29969,45
Jensen_Eisai_groupA,1,5,ts-global_detected_seizures,29930,29954,24
Jensen_Eisai_groupA,1,5,ts-global_detected_seizures,29966,30009,43
Jensen_Eisai_groupA,2,6,ts-global_detected_seizures,29972,30004,32
Jensen_Eisai_groupA,1,5,ts-global_detected_seizures,30043,30089,46
Jensen_Eisai_groupA,2,6,ts-global_detected_seizures,30044,30068,24
Jensen_Eisai_groupA,2,6,ts-global_detected_seizures,30079,30116,37
Jensen_Eisai_groupA,1,5,ts-global_detected_seizures,30095,30156,61
Jensen_Eisai_groupA,2,6,ts-global_detected_seizures,30172,30204,32
Jensen_Eisai_groupA,1,5,ts-global_detected_seizures,30197,30238,41
Jensen_Eisai_groupA,2,6,ts-global_detected_seizures,30211,30245,34
Jensen_Eisai_groupA,2,6,ts-global_detected_seizures,30258,30286,28
Jensen_Eisai_groupA,1,5,ts-global_detected_seizures,30272,30311,39
Jensen_Eisai_groupA,2,6,ts-global_detected_seizures,30299,30348,49
Jensen_Eisai_groupA,1,5,ts-global_detected_seizures,30363,30395,32
Jensen_Eisai_groupA,2,6,ts-global_detected_seizures,30465,30491,26
Jensen_Eisai_groupA,1,5,ts-global_detected_seizures,30466,30591,125
Jensen_Eisai_groupA,2,6,ts-global_detected_seizures,30492,30521,29
Jensen_Eisai_groupA,2,6,ts-global_detected_seizures,30523,30640,117
Jensen_Eisai_groupA,1,5,ts-global_detected_seizures,30630,30653,23
Jensen_Eisai_groupA,1,5,ts-global_detected_seizures,30674,30727,53
Jensen_Eisai_groupA,2,6,ts-global_detected_seizures,30716,30749,33
Jensen_Eisai_groupA,1,5,ts-global_detected_seizures,30743,32871,2128
Jensen_Eisai_groupA,2,6,ts-global_detected_seizures,30782,30810,28
Jensen_Eisai_groupA,2,6,ts-global_detected_seizures,30847,31100,253
Jensen_Eisai_groupA,2,6,ts-global_detected_seizures,31185,31221,36
Jensen_Eisai_groupA,2,6,ts-global_detected_seizures,31302,31335,33
Jensen_Eisai_groupA,2,6,ts-global_detected_seizures,31391,31421,30
Jensen_Eisai_groupA,2,6,ts-global_detected_seizures,31422,31446,24
Jensen_Eisai_groupA,2,6,ts-global_detected_seizures,31468,31497,29
Jensen_Eisai_groupA,2,6,ts-global_detected_seizures,31525,31549,24
Jensen_Eisai_groupA,2,6,ts-global_detected_seizures,31553,31589,36
Jensen_Eisai_groupA,2,6,ts-global_detected_seizures,31650,31690,40
Jensen_Eisai_groupA,2,6,ts-global_detected_seizures,31723,31764,41
Jensen_Eisai_groupA,2,6,ts-global_detected_seizures,31781,31803,22
Jensen_Eisai_groupA,2,6,ts-global_detected_seizures,31804,32183,379
Jensen_Eisai_groupA,2,6,ts-global_detected_seizures,32184,32240,56
Jensen_Eisai_groupA,2,6,ts-global_detected_seizures,32262,32287,25
Jensen_Eisai_groupA,2,6,ts-global_detected_seizures,32307,32331,24
Jensen_Eisai_groupA,2,6,ts-global_detected_seizures,32403,32431,28
Jensen_Eisai_groupA,2,6,ts-global_detected_seizures,32481,32506,25
Jensen_Eisai_groupA,2,6,ts-global_detected_seizures,32563,32595,32
Jensen_Eisai_groupA,2,6,ts-global_detected_seizures,32607,32634,27
Jensen_Eisai_groupA,2,6,ts-global_detected_seizures,32666,32701,35
Jensen_Eisai_groupA,2,6,ts-global_detected_seizures,32709,32734,25
Jensen_Eisai_groupA,2,6,ts-global_detected_seizures,32772,32801,29
Jensen_Eisai_groupA,2,6,ts-global_detected_seizures,32812,32842,30
Jensen_Eisai_groupA,1,5,ts-global_detected_seizures,32872,32947,75
Jensen_Eisai_groupA,2,6,ts-global_detected_seizures,32882,32909,27
Jensen_Eisai_groupA,2,6,ts-global_detected_seizures,32936,32959,23
Jensen_Eisai_groupA,1,5,ts-global_detected_seizures,32976,33010,34
Jensen_Eisai_groupA,2,6,ts-global_detected_seizures,33031,33121,90
Jensen_Eisai_groupA,1,5,ts-global_detected_seizures,33049,33078,29
Jensen_Eisai_groupA,1,5,ts-global_detected_seizures,33079,33104,25
Jensen_Eisai_groupA,2,6,ts-global_detected_seizures,33142,33166,24
Jensen_Eisai_groupA,2,6,ts-global_detected_seizures,33180,33214,34
Jensen_Eisai_groupA,1,5,ts-global_detected_seizures,33222,33306,84
Jensen_Eisai_groupA,2,6,ts-global_detected_seizures,33295,33333,38
Jensen_Eisai_groupA,1,5,ts-global_detected_seizures,33307,33349,42
Jensen_Eisai_groupA,1,5,ts-global_detected_seizures,33354,33399,45
Jensen_Eisai_groupA,2,6,ts-global_detected_seizures,33363,33389,26
Jensen_Eisai_groupA,2,6,ts-global_detected_seizures,33412,34231,819
Jensen_Eisai_groupA,1,5,ts-global_detected_seizures,33561,33608,47
Jensen_Eisai_groupA,1,5,ts-global_detected_seizures,33651,33675,24
Jensen_Eisai_groupA,1,5,ts-global_detected_seizures,33769,33809,40
Jensen_Eisai_groupA,1,5,ts-global_detected_seizures,33866,33900,34
Jensen_Eisai_groupA,1,5,ts-global_detected_seizures,33922,33946,24
Jensen_Eisai_groupA,1,5,ts-global_detected_seizures,34047,34072,25
Jensen_Eisai_groupA,1,5,ts-global_detected_seizures,34108,34157,49
Jensen_Eisai_groupA,1,5,ts-global_detected_seizures,34158,34286,128
Jensen_Eisai_groupA,2,6,ts-global_detected_seizures,34234,34258,24
Jensen_Eisai_groupA,1,5,ts-global_detected_seizures,34288,34329,41
Jensen_Eisai_groupA,2,6,ts-global_detected_seizures,34304,34332,28
Jensen_Eisai_groupA,1,5,ts-global_detected_seizures,34339,34394,55
Jensen_Eisai_groupA,2,6,ts-global_detected_seizures,34371,34394,23
Jensen_Eisai_groupA,1,5,ts-global_detected_seizures,34395,34426,31
Jensen_Eisai_groupA,1,5,ts-global_detected_seizures,34445,34484,39
Jensen_Eisai_groupA,2,6,ts-global_detected_seizures,34479,34535,56
Jensen_Eisai_groupA,1,5,ts-global_detected_seizures,34512,34550,38
Jensen_Eisai_groupA,2,6,ts-global_detected_seizures,34551,34583,32
Jensen_Eisai_groupA,1,5,ts-global_detected_seizures,34587,34618,31
Jensen_Eisai_groupA,2,6,ts-global_detected_seizures,34591,34623,32
Jensen_Eisai_groupA,1,5,ts-global_detected_seizures,34619,34696,77
Jensen_Eisai_groupA,2,6,ts-global_detected_seizures,34646,34677,31
Jensen_Eisai_groupA,2,6,ts-global_detected_seizures,34681,34712,31
Jensen_Eisai_groupA,1,5,ts-global_detected_seizures,34708,34754,46
Jensen_Eisai_groupA,2,6,ts-global_detected_seizures,34752,34776,24
Jensen_Eisai_groupA,1,5,ts-global_detected_seizures,34771,34801,30
Jensen_Eisai_groupA,2,6,ts-global_detected_seizures,34778,34801,23
Jensen_Eisai_groupA,1,5,ts-global_detected_seizures,34834,34952,118
Jensen_Eisai_groupA,2,6,ts-global_detected_seizures,34859,34899,40
Jensen_Eisai_groupA,2,6,ts-global_detected_seizures,34924,34949,25
Jensen_Eisai_groupA,2,6,ts-global_detected_seizures,34988,35011,23
Jensen_Eisai_groupA,1,5,ts-global_detected_seizures,34993,35023,30
Jensen_Eisai_groupA,1,5,ts-global_detected_seizures,35036,35084,48
Jensen_Eisai_groupA,2,6,ts-global_detected_seizures,35040,35064,24
Jensen_Eisai_groupA,2,6,ts-global_detected_seizures,35084,35193,109
Jensen_Eisai_groupA,1,5,ts-global_detected_seizures,35096,35148,52
Jensen_Eisai_groupA,1,5,ts-global_detected_seizures,35150,35191,41
Jensen_Eisai_groupA,2,6,ts-global_detected_seizures,35211,35244,33
Jensen_Eisai_groupA,1,5,ts-global_detected_seizures,35213,35248,35
Jensen_Eisai_groupA,1,5,ts-global_detected_seizures,35272,35300,28
Jensen_Eisai_groupA,2,6,ts-global_detected_seizures,35310,35339,29
Jensen_Eisai_groupA,1,5,ts-global_detected_seizures,35328,36609,1281
Jensen_Eisai_groupA,2,6,ts-global_detected_seizures,35360,35386,26
Jensen_Eisai_groupA,2,6,ts-global_detected_seizures,35403,35436,33
Jensen_Eisai_groupA,2,6,ts-global_detected_seizures,35584,35646,62
Jensen_Eisai_groupA,2,6,ts-global_detected_seizures,35647,35682,35
Jensen_Eisai_groupA,2,6,ts-global_detected_seizures,35684,35754,70
Jensen_Eisai_groupA,2,6,ts-global_detected_seizures,35840,35863,23
Jensen_Eisai_groupA,2,6,ts-global_detected_seizures,35891,35922,31
Jensen_Eisai_groupA,2,6,ts-global_detected_seizures,35925,35950,25
Jensen_Eisai_groupA,2,6,ts-global_detected_seizures,35984,36012,28
Jensen_Eisai_groupA,2,6,ts-global_detected_seizures,36015,36057,42
Jensen_Eisai_groupA,2,6,ts-global_detected_seizures,36058,36092,34
Jensen_Eisai_groupA,2,6,ts-global_detected_seizures,36094,36123,29
Jensen_Eisai_groupA,2,6,ts-global_detected_seizures,36142,36170,28
Jensen_Eisai_groupA,2,6,ts-global_detected_seizures,36188,36210,22
Jensen_Eisai_groupA,2,6,ts-global_detected_seizures,36239,36286,47
Jensen_Eisai_groupA,2,6,ts-global_detected_seizures,36334,36400,66
Jensen_Eisai_groupA,2,6,ts-global_detected_seizures,36454,36490,36
Jensen_Eisai_groupA,1,5,ts-global_detected_seizures,36610,36679,69
Jensen_Eisai_groupA,2,6,ts-global_detected_seizures,36616,36641,25
Jensen_Eisai_groupA,2,6,ts-global_detected_seizures,36713,36782,69
Jensen_Eisai_groupA,1,5,ts-global_detected_seizures,36737,36775,38
Jensen_Eisai_groupA,2,6,ts-global_detected_seizures,36784,36809,25
Jensen_Eisai_groupA,2,6,ts-global_detected_seizures,36810,36929,119
Jensen_Eisai_groupA,1,5,ts-global_detected_seizures,36849,36882,33
Jensen_Eisai_groupA,1,5,ts-global_detected_seizures,36929,37031,102
Jensen_Eisai_groupA,2,6,ts-global_detected_seizures,36946,37004,58
Jensen_Eisai_groupA,2,6,ts-global_detected_seizures,37027,37053,26
Jensen_Eisai_groupA,2,6,ts-global_detected_seizures,37095,37128,33
Jensen_Eisai_groupA,1,5,ts-global_detected_seizures,37136,37167,31
Jensen_Eisai_groupA,2,6,ts-global_detected_seizures,37171,37217,46
Jensen_Eisai_groupA,1,5,ts-global_detected_seizures,37196,37254,58
Jensen_Eisai_groupA,2,6,ts-global_detected_seizures,37228,37275,47
Jensen_Eisai_groupA,1,5,ts-global_detected_seizures,37255,37290,35
Jensen_Eisai_groupA,1,5,ts-global_detected_seizures,37297,37350,53
Jensen_Eisai_groupA,2,6,ts-global_detected_seizures,37300,37955,655
Jensen_Eisai_groupA,1,5,ts-global_detected_seizures,37359,37417,58
Jensen_Eisai_groupA,1,5,ts-global_detected_seizures,37439,37477,38
Jensen_Eisai_groupA,1,5,ts-global_detected_seizures,37524,37556,32
Jensen_Eisai_groupA,1,5,ts-global_detected_seizures,37640,37711,71
Jensen_Eisai_groupA,1,5,ts-global_detected_seizures,37769,37796,27
Jensen_Eisai_groupA,1,5,ts-global_detected_seizures,37797,37843,46
Jensen_Eisai_groupA,1,5,ts-global_detected_seizures,37879,37931,52
Jensen_Eisai_groupA,1,5,ts-global_detected_seizures,37954,37984,30
Jensen_Eisai_groupA,2,6,ts-global_detected_seizures,37965,37994,29
Jensen_Eisai_groupA,1,5,ts-global_detected_seizures,37985,38008,23
Jensen_Eisai_groupA,2,6,ts-global_detected_seizures,37995,38041,46
Jensen_Eisai_groupA,1,5,ts-global_detected_seizures,38104,38151,47
Jensen_Eisai_groupA,1,5,ts-global_detected_seizures,38152,38190,38
Jensen_Eisai_groupA,2,6,ts-global_detected_seizures,38168,38196,28
Jensen_Eisai_groupA,1,5,ts-global_detected_seizures,38191,38218,27
Jensen_Eisai_groupA,2,6,ts-global_detected_seizures,38243,38269,26
Jensen_Eisai_groupA,1,5,ts-global_detected_seizures,38264,38580,316
Jensen_Eisai_groupA,2,6,ts-global_detected_seizures,38322,38366,44
Jensen_Eisai_groupA,2,6,ts-global_detected_seizures,38392,38429,37
Jensen_Eisai_groupA,2,6,ts-global_detected_seizures,38454,38495,41
Jensen_Eisai_groupA,2,6,ts-global_detected_seizures,38550,38618,68
Jensen_Eisai_groupA,1,5,ts-global_detected_seizures,38581,38608,27
Jensen_Eisai_groupA,1,5,ts-global_detected_seizures,38627,38691,64
Jensen_Eisai_groupA,2,6,ts-global_detected_seizures,38669,38694,25
Jensen_Eisai_groupA,1,5,ts-global_detected_seizures,38700,38728,28
Jensen_Eisai_groupA,2,6,ts-global_detected_seizures,38746,38768,22
Jensen_Eisai_groupA,1,5,ts-global_detected_seizures,38755,38841,86
Jensen_Eisai_groupA,2,6,ts-global_detected_seizures,38823,38845,22
Jensen_Eisai_groupA,2,6,ts-global_detected_seizures,38887,38912,25
Jensen_Eisai_groupA,1,5,ts-global_detected_seizures,38897,38962,65
Jensen_Eisai_groupA,2,6,ts-global_detected_seizures,38931,38954,23
Jensen_Eisai_groupA,1,5,ts-global_detected_seizures,38984,39016,32
Jensen_Eisai_groupA,2,6,ts-global_detected_seizures,38996,39024,28
Jensen_Eisai_groupA,1,5,ts-global_detected_seizures,39064,39131,67
Jensen_Eisai_groupA,2,6,ts-global_detected_seizures,39138,39188,50
Jensen_Eisai_groupA,1,5,ts-global_detected_seizures,39144,39173,29
Jensen_Eisai_groupA,1,5,ts-global_detected_seizures,39184,39232,48
Jensen_Eisai_groupA,2,6,ts-global_detected_seizures,39279,39347,68
Jensen_Eisai_groupA,1,5,ts-global_detected_seizures,39284,39317,33
Jensen_Eisai_groupA,2,6,ts-global_detected_seizures,39349,39414,65
Jensen_Eisai_groupA,2,6,ts-global_detected_seizures,39425,39447,22
Jensen_Eisai_groupA,1,5,ts-global_detected_seizures,39460,39609,149
Jensen_Eisai_groupA,2,6,ts-global_detected_seizures,39472,39503,31
Jensen_Eisai_groupA,2,6,ts-global_detected_seizures,39547,40269,722
Jensen_Eisai_groupA,1,5,ts-global_detected_seizures,39631,39686,55
Jensen_Eisai_groupA,1,5,ts-global_detected_seizures,39688,39725,37
Jensen_Eisai_groupA,1,5,ts-global_detected_seizures,39726,39750,24
Jensen_Eisai_groupA,1,5,ts-global_detected_seizures,39914,39947,33
Jensen_Eisai_groupA,1,5,ts-global_detected_seizures,39989,40945,956
Jensen_Eisai_groupA,2,6,ts-global_detected_seizures,40283,40315,32
Jensen_Eisai_groupA,2,6,ts-global_detected_seizures,40395,40435,40
Jensen_Eisai_groupA,2,6,ts-global_detected_seizures,40456,40480,24
Jensen_Eisai_groupA,2,6,ts-global_detected_seizures,40512,40537,25
Jensen_Eisai_groupA,2,6,ts-global_detected_seizures,40584,40609,25
Jensen_Eisai_groupA,2,6,ts-global_detected_seizures,40660,40689,29
Jensen_Eisai_groupA,2,6,ts-global_detected_seizures,40786,40814,28
Jensen_Eisai_groupA,2,6,ts-global_detected_seizures,40878,40907,29
Jensen_Eisai_groupA,1,5,ts-global_detected_seizures,40952,41133,181
Jensen_Eisai_groupA,2,6,ts-global_detected_seizures,40981,41010,29
Jensen_Eisai_groupA,2,6,ts-global_detected_seizures,41019,41052,33
Jensen_Eisai_groupA,2,6,ts-global_detected_seizures,41053,41123,70
Jensen_Eisai_groupA,1,5,ts-global_detected_seizures,41138,41168,30
Jensen_Eisai_groupA,1,5,ts-global_detected_seizures,41176,41200,24
Jensen_Eisai_groupA,2,6,ts-global_detected_seizures,41237,41259,22
Jensen_Eisai_groupA,1,5,ts-global_detected_seizures,41262,41312,50
Jensen_Eisai_groupA,1,5,ts-global_detected_seizures,41313,41351,38
Jensen_Eisai_groupA,1,5,ts-global_detected_seizures,41352,41379,27
Jensen_Eisai_groupA,1,5,ts-global_detected_seizures,41380,41421,41
Jensen_Eisai_groupA,1,5,ts-global_detected_seizures,41422,41445,23
Jensen_Eisai_groupA,2,6,ts-global_detected_seizures,41425,41458,33
Jensen_Eisai_groupA,1,5,ts-global_detected_seizures,41446,41494,48
Jensen_Eisai_groupA,1,5,ts-global_detected_seizures,41495,41520,25
Jensen_Eisai_groupA,2,6,ts-global_detected_seizures,41551,41575,24
Jensen_Eisai_groupA,1,5,ts-global_detected_seizures,41581,41621,40
Jensen_Eisai_groupA,2,6,ts-global_detected_seizures,41593,41644,51
Jensen_Eisai_groupA,1,5,ts-global_detected_seizures,41622,41660,38
Jensen_Eisai_groupA,2,6,ts-global_detected_seizures,41645,41675,30
Jensen_Eisai_groupA,1,5,ts-global_detected_seizures,41661,41688,27
Jensen_Eisai_groupA,2,6,ts-global_detected_seizures,41684,41712,28
Jensen_Eisai_groupA,2,6,ts-global_detected_seizures,41715,41743,28
Jensen_Eisai_groupA,1,5,ts-global_detected_seizures,41731,41847,116
Jensen_Eisai_groupA,2,6,ts-global_detected_seizures,41780,41809,29
Jensen_Eisai_groupA,2,6,ts-global_detected_seizures,41854,41882,28
Jensen_Eisai_groupA,1,5,ts-global_detected_seizures,41864,41901,37
Jensen_Eisai_groupA,2,6,ts-global_detected_seizures,41907,42546,639
Jensen_Eisai_groupA,1,5,ts-global_detected_seizures,42045,42070,25
Jensen_Eisai_groupA,1,5,ts-global_detected_seizures,42112,42148,36
Jensen_Eisai_groupA,4,8,ts-global_detected_seizures,42367,80569,38202
Jensen_Eisai_groupA,1,5,ts-global_detected_seizures,42478,54814,12336
Jensen_Eisai_groupA,2,6,ts-global_detected_seizures,42579,43645,1066
Jensen_Eisai_groupA,2,6,ts-global_detected_seizures,43646,43848,202
Jensen_Eisai_groupA,2,6,ts-global_detected_seizures,43849,43939,90
Jensen_Eisai_groupA,2,6,ts-global_detected_seizures,43940,44490,550
Jensen_Eisai_groupA,2,6,ts-global_detected_seizures,44491,44533,42
Jensen_Eisai_groupA,2,6,ts-global_detected_seizures,44534,44569,35
Jensen_Eisai_groupA,2,6,ts-global_detected_seizures,44570,44640,70
Jensen_Eisai_groupA,2,6,ts-global_detected_seizures,44642,44811,169
Jensen_Eisai_groupA,2,6,ts-global_detected_seizures,44834,44887,53
Jensen_Eisai_groupA,2,6,ts-global_detected_seizures,44903,44960,57
Jensen_Eisai_groupA,2,6,ts-global_detected_seizures,44961,44989,28
Jensen_Eisai_groupA,2,6,ts-global_detected_seizures,44990,45041,51
Jensen_Eisai_groupA,2,6,ts-global_detected_seizures,45042,45092,50
Jensen_Eisai_groupA,2,6,ts-global_detected_seizures,45100,45123,23
Jensen_Eisai_groupA,2,6,ts-global_detected_seizures,45124,45189,65
Jensen_Eisai_groupA,2,6,ts-global_detected_seizures,45197,45225,28
Jensen_Eisai_groupA,2,6,ts-global_detected_seizures,45230,45307,77
Jensen_Eisai_groupA,2,6,ts-global_detected_seizures,45345,45374,29
Jensen_Eisai_groupA,2,6,ts-global_detected_seizures,45406,45436,30
Jensen_Eisai_groupA,2,6,ts-global_detected_seizures,45444,45479,35
Jensen_Eisai_groupA,2,6,ts-global_detected_seizures,45481,45821,340
Jensen_Eisai_groupA,2,6,ts-global_detected_seizures,45846,46033,187
Jensen_Eisai_groupA,2,6,ts-global_detected_seizures,46034,47008,974
Jensen_Eisai_groupA,2,6,ts-global_detected_seizures,47010,47041,31
Jensen_Eisai_groupA,2,6,ts-global_detected_seizures,47042,47147,105
Jensen_Eisai_groupA,2,6,ts-global_detected_seizures,47148,47606,458
Jensen_Eisai_groupA,2,6,ts-global_detected_seizures,47607,49538,1931
Jensen_Eisai_groupA,2,6,ts-global_detected_seizures,49539,49914,375
Jensen_Eisai_groupA,2,6,ts-global_detected_seizures,49915,55844,5929
Jensen_Eisai_groupA,1,5,ts-global_detected_seizures,54815,55106,291
Jensen_Eisai_groupA,1,5,ts-global_detected_seizures,55107,55624,517
Jensen_Eisai_groupA,1,5,ts-global_detected_seizures,55626,55845,219
Jensen_Eisai_groupA,2,6,ts-global_detected_seizures,55845,56928,1083
Jensen_Eisai_groupA,1,5,ts-global_detected_seizures,55846,55878,32
Jensen_Eisai_groupA,1,5,ts-global_detected_seizures,55879,56017,138
Jensen_Eisai_groupA,1,5,ts-global_detected_seizures,56018,56254,236
Jensen_Eisai_groupA,1,5,ts-global_detected_seizures,56255,56358,103
Jensen_Eisai_groupA,1,5,ts-global_detected_seizures,56360,58975,2615
Jensen_Eisai_groupA,2,6,ts-global_detected_seizures,56929,58476,1547
Jensen_Eisai_groupA,2,6,ts-global_detected_seizures,58477,59216,739
Jensen_Eisai_groupA,1,5,ts-global_detected_seizures,58976,60718,1742
Jensen_Eisai_groupA,2,6,ts-global_detected_seizures,59217,59253,36
Jensen_Eisai_groupA,2,6,ts-global_detected_seizures,59260,59296,36
Jensen_Eisai_groupA,2,6,ts-global_detected_seizures,59297,59328,31
Jensen_Eisai_groupA,2,6,ts-global_detected_seizures,59329,59366,37
Jensen_Eisai_groupA,2,6,ts-global_detected_seizures,59384,60076,692
Jensen_Eisai_groupA,2,6,ts-global_detected_seizures,60077,60433,356
Jensen_Eisai_groupA,2,6,ts-global_detected_seizures,60434,60484,50
Jensen_Eisai_groupA,2,6,ts-global_detected_seizures,60489,60575,86
Jensen_Eisai_groupA,2,6,ts-global_detected_seizures,60593,60653,60
Jensen_Eisai_groupA,2,6,ts-global_detected_seizures,60685,60740,55
Jensen_Eisai_groupA,1,5,ts-global_detected_seizures,60719,62109,1390
Jensen_Eisai_groupA,2,6,ts-global_detected_seizures,60772,60815,43
Jensen_Eisai_groupA,2,6,ts-global_detected_seizures,60852,60881,29
Jensen_Eisai_groupA,2,6,ts-global_detected_seizures,60882,60918,36
Jensen_Eisai_groupA,2,6,ts-global_detected_seizures,60920,61342,422
Jensen_Eisai_groupA,2,6,ts-global_detected_seizures,61348,61391,43
Jensen_Eisai_groupA,2,6,ts-global_detected_seizures,61398,61429,31
Jensen_Eisai_groupA,2,6,ts-global_detected_seizures,61469,61507,38
Jensen_Eisai_groupA,2,6,ts-global_detected_seizures,61509,61926,417
Jensen_Eisai_groupA,2,6,ts-global_detected_seizures,61927,61950,23
Jensen_Eisai_groupA,2,6,ts-global_detected_seizures,61971,62095,124
Jensen_Eisai_groupA,2,6,ts-global_detected_seizures,62096,62131,35
Jensen_Eisai_groupA,1,5,ts-global_detected_seizures,62110,62148,38
Jensen_Eisai_groupA,2,6,ts-global_detected_seizures,62132,62201,69
Jensen_Eisai_groupA,1,5,ts-global_detected_seizures,62149,63663,1514
Jensen_Eisai_groupA,2,6,ts-global_detected_seizures,62203,62257,54
Jensen_Eisai_groupA,2,6,ts-global_detected_seizures,62258,62296,38
Jensen_Eisai_groupA,2,6,ts-global_detected_seizures,62297,62385,88
Jensen_Eisai_groupA,2,6,ts-global_detected_seizures,62386,62469,83
Jensen_Eisai_groupA,2,6,ts-global_detected_seizures,62484,62509,25
Jensen_Eisai_groupA,2,6,ts-global_detected_seizures,62522,62587,65
Jensen_Eisai_groupA,2,6,ts-global_detected_seizures,62605,62627,22
Jensen_Eisai_groupA,2,6,ts-global_detected_seizures,62640,62704,64
Jensen_Eisai_groupA,2,6,ts-global_detected_seizures,62732,62769,37
Jensen_Eisai_groupA,2,6,ts-global_detected_seizures,62818,63161,343
Jensen_Eisai_groupA,2,6,ts-global_detected_seizures,63187,63242,55
Jensen_Eisai_groupA,2,6,ts-global_detected_seizures,63259,63555,296
Jensen_Eisai_groupA,2,6,ts-global_detected_seizures,63556,63597,41
Jensen_Eisai_groupA,2,6,ts-global_detected_seizures,63598,63639,41
Jensen_Eisai_groupA,2,6,ts-global_detected_seizures,63646,63672,26
Jensen_Eisai_groupA,1,5,ts-global_detected_seizures,63664,64820,1156
Jensen_Eisai_groupA,2,6,ts-global_detected_seizures,63675,63752,77
Jensen_Eisai_groupA,2,6,ts-global_detected_seizures,63753,63835,82
Jensen_Eisai_groupA,2,6,ts-global_detected_seizures,63836,63894,58
Jensen_Eisai_groupA,2,6,ts-global_detected_seizures,63896,64234,338
Jensen_Eisai_groupA,2,6,ts-global_detected_seizures,64250,64276,26
Jensen_Eisai_groupA,2,6,ts-global_detected_seizures,64314,64339,25
Jensen_Eisai_groupA,2,6,ts-global_detected_seizures,64421,64448,27
Jensen_Eisai_groupA,2,6,ts-global_detected_seizures,64463,64499,36
Jensen_Eisai_groupA,2,6,ts-global_detected_seizures,64541,64572,31
Jensen_Eisai_groupA,2,6,ts-global_detected_seizures,64582,64621,39
Jensen_Eisai_groupA,2,6,ts-global_detected_seizures,64647,64675,28
Jensen_Eisai_groupA,2,6,ts-global_detected_seizures,64709,64817,108
Jensen_Eisai_groupA,1,5,ts-global_detected_seizures,64821,66607,1786
Jensen_Eisai_groupA,2,6,ts-global_detected_seizures,64822,64871,49
Jensen_Eisai_groupA,2,6,ts-global_detected_seizures,64874,64912,38
Jensen_Eisai_groupA,2,6,ts-global_detected_seizures,64978,65301,323
Jensen_Eisai_groupA,2,6,ts-global_detected_seizures,65306,65362,56
Jensen_Eisai_groupA,2,6,ts-global_detected_seizures,65403,65447,44
Jensen_Eisai_groupA,2,6,ts-global_detected_seizures,65403,65447,44
Jensen_Eisai_groupA,2,6,ts-global_detected_seizures,65476,65553,77
Jensen_Eisai_groupA,2,6,ts-global_detected_seizures,65573,65909,336
Jensen_Eisai_groupA,2,6,ts-global_detected_seizures,65928,65964,36
Jensen_Eisai_groupA,2,6,ts-global_detected_seizures,65981,66004,23
Jensen_Eisai_groupA,2,6,ts-global_detected_seizures,66007,66043,36
Jensen_Eisai_groupA,2,6,ts-global_detected_seizures,66153,66236,83
Jensen_Eisai_groupA,2,6,ts-global_detected_seizures,66280,66349,69
Jensen_Eisai_groupA,2,6,ts-global_detected_seizures,66374,66408,34
Jensen_Eisai_groupA,2,6,ts-global_detected_seizures,66409,66432,23
Jensen_Eisai_groupA,2,6,ts-global_detected_seizures,66443,66465,22
Jensen_Eisai_groupA,2,6,ts-global_detected_seizures,66466,66493,27
Jensen_Eisai_groupA,2,6,ts-global_detected_seizures,66510,66579,69
Jensen_Eisai_groupA,2,6,ts-global_detected_seizures,66580,66607,27
Jensen_Eisai_groupA,1,5,ts-global_detected_seizures,66608,67148,540
Jensen_Eisai_groupA,2,6,ts-global_detected_seizures,66618,66641,23
Jensen_Eisai_groupA,2,6,ts-global_detected_seizures,66657,66715,58
Jensen_Eisai_groupA,2,6,ts-global_detected_seizures,66796,66818,22
Jensen_Eisai_groupA,2,6,ts-global_detected_seizures,66903,66930,27
Jensen_Eisai_groupA,2,6,ts-global_detected_seizures,66953,66975,22
Jensen_Eisai_groupA,2,6,ts-global_detected_seizures,67026,67818,792
Jensen_Eisai_groupA,1,5,ts-global_detected_seizures,67149,68194,1045
Jensen_Eisai_groupA,2,6,ts-global_detected_seizures,67819,67844,25
Jensen_Eisai_groupA,2,6,ts-global_detected_seizures,67845,67868,23
Jensen_Eisai_groupA,2,6,ts-global_detected_seizures,67910,67956,46
Jensen_Eisai_groupA,2,6,ts-global_detected_seizures,67960,67994,34
Jensen_Eisai_groupA,2,6,ts-global_detected_seizures,68013,68038,25
Jensen_Eisai_groupA,2,6,ts-global_detected_seizures,68040,68088,48
Jensen_Eisai_groupA,2,6,ts-global_detected_seizures,68089,68111,22
Jensen_Eisai_groupA,2,6,ts-global_detected_seizures,68149,68201,52
Jensen_Eisai_groupA,1,5,ts-global_detected_seizures,68195,68385,190
Jensen_Eisai_groupA,2,6,ts-global_detected_seizures,68238,68277,39
Jensen_Eisai_groupA,2,6,ts-global_detected_seizures,68285,68313,28
Jensen_Eisai_groupA,2,6,ts-global_detected_seizures,68342,68470,128
Jensen_Eisai_groupA,1,5,ts-global_detected_seizures,68386,68609,223
Jensen_Eisai_groupA,2,6,ts-global_detected_seizures,68495,68542,47
Jensen_Eisai_groupA,2,6,ts-global_detected_seizures,68591,68618,27
Jensen_Eisai_groupA,1,5,ts-global_detected_seizures,68610,68641,31
Jensen_Eisai_groupA,2,6,ts-global_detected_seizures,68631,68817,186
Jensen_Eisai_groupA,1,5,ts-global_detected_seizures,68642,68733,91
Jensen_Eisai_groupA,1,5,ts-global_detected_seizures,68734,68757,23
Jensen_Eisai_groupA,1,5,ts-global_detected_seizures,68758,68855,97
Jensen_Eisai_groupA,2,6,ts-global_detected_seizures,68829,68857,28
Jensen_Eisai_groupA,1,5,ts-global_detected_seizures,68856,68931,75
Jensen_Eisai_groupA,2,6,ts-global_detected_seizures,68869,68902,33
Jensen_Eisai_groupA,2,6,ts-global_detected_seizures,68906,68931,25
Jensen_Eisai_groupA,1,5,ts-global_detected_seizures,68932,69001,69
Jensen_Eisai_groupA,2,6,ts-global_detected_seizures,68958,68986,28
Jensen_Eisai_groupA,2,6,ts-global_detected_seizures,68996,69055,59
Jensen_Eisai_groupA,1,5,ts-global_detected_seizures,69002,69026,24
Jensen_Eisai_groupA,1,5,ts-global_detected_seizures,69027,69062,35
Jensen_Eisai_groupA,1,5,ts-global_detected_seizures,69063,69488,425
Jensen_Eisai_groupA,2,6,ts-global_detected_seizures,69064,69104,40
Jensen_Eisai_groupA,2,6,ts-global_detected_seizures,69202,69266,64
Jensen_Eisai_groupA,2,6,ts-global_detected_seizures,69267,69646,379
Jensen_Eisai_groupA,1,5,ts-global_detected_seizures,69489,69522,33
Jensen_Eisai_groupA,1,5,ts-global_detected_seizures,69523,69703,180
Jensen_Eisai_groupA,2,6,ts-global_detected_seizures,69679,69701,22
Jensen_Eisai_groupA,1,5,ts-global_detected_seizures,69704,69770,66
Jensen_Eisai_groupA,2,6,ts-global_detected_seizures,69764,69969,205
Jensen_Eisai_groupA,1,5,ts-global_detected_seizures,69771,69809,38
Jensen_Eisai_groupA,1,5,ts-global_detected_seizures,69820,69932,112
Jensen_Eisai_groupA,1,5,ts-global_detected_seizures,69933,69995,62
Jensen_Eisai_groupA,2,6,ts-global_detected_seizures,69978,70055,77
Jensen_Eisai_groupA,1,5,ts-global_detected_seizures,69997,70160,163
Jensen_Eisai_groupA,2,6,ts-global_detected_seizures,70058,70148,90
Jensen_Eisai_groupA,2,6,ts-global_detected_seizures,70156,70413,257
Jensen_Eisai_groupA,1,5,ts-global_detected_seizures,70161,70331,170
Jensen_Eisai_groupA,1,5,ts-global_detected_seizures,70332,70401,69
Jensen_Eisai_groupA,1,5,ts-global_detected_seizures,70402,70460,58
Jensen_Eisai_groupA,2,6,ts-global_detected_seizures,70414,70468,54
Jensen_Eisai_groupA,1,5,ts-global_detected_seizures,70507,70547,40
Jensen_Eisai_groupA,2,6,ts-global_detected_seizures,70512,70537,25
Jensen_Eisai_groupA,2,6,ts-global_detected_seizures,70547,70571,24
Jensen_Eisai_groupA,2,6,ts-global_detected_seizures,70613,70699,86
Jensen_Eisai_groupA,1,5,ts-global_detected_seizures,70617,70659,42
Jensen_Eisai_groupA,1,5,ts-global_detected_seizures,70666,70756,90
Jensen_Eisai_groupA,2,6,ts-global_detected_seizures,70717,70740,23
Jensen_Eisai_groupA,1,5,ts-global_detected_seizures,70757,70956,199
Jensen_Eisai_groupA,2,6,ts-global_detected_seizures,70797,70901,104
Jensen_Eisai_groupA,2,6,ts-global_detected_seizures,70902,70933,31
Jensen_Eisai_groupA,2,6,ts-global_detected_seizures,70955,70978,23
Jensen_Eisai_groupA,1,5,ts-global_detected_seizures,70962,71009,47
Jensen_Eisai_groupA,2,6,ts-global_detected_seizures,70979,71003,24
Jensen_Eisai_groupA,1,5,ts-global_detected_seizures,71010,71055,45
Jensen_Eisai_groupA,2,6,ts-global_detected_seizures,71034,71077,43
Jensen_Eisai_groupA,1,5,ts-global_detected_seizures,71056,71083,27
Jensen_Eisai_groupA,1,5,ts-global_detected_seizures,71085,71179,94
Jensen_Eisai_groupA,2,6,ts-global_detected_seizures,71187,71225,38
Jensen_Eisai_groupA,1,5,ts-global_detected_seizures,71202,71224,22
Jensen_Eisai_groupA,1,5,ts-global_detected_seizures,71231,71365,134
Jensen_Eisai_groupA,2,6,ts-global_detected_seizures,71290,71319,29
Jensen_Eisai_groupA,2,6,ts-global_detected_seizures,71327,71370,43
Jensen_Eisai_groupA,1,5,ts-global_detected_seizures,71382,71451,69
Jensen_Eisai_groupA,1,5,ts-global_detected_seizures,71469,71545,76
Jensen_Eisai_groupA,2,6,ts-global_detected_seizures,71513,71550,37
Jensen_Eisai_groupA,1,5,ts-global_detected_seizures,71547,71579,32
Jensen_Eisai_groupA,2,6,ts-global_detected_seizures,71567,71596,29
Jensen_Eisai_groupA,1,5,ts-global_detected_seizures,71623,71658,35
Jensen_Eisai_groupA,2,6,ts-global_detected_seizures,71631,71670,39
Jensen_Eisai_groupA,1,5,ts-global_detected_seizures,71735,71813,78
Jensen_Eisai_groupA,2,6,ts-global_detected_seizures,71794,71835,41
Jensen_Eisai_groupA,1,5,ts-global_detected_seizures,71814,71854,40
Jensen_Eisai_groupA,1,5,ts-global_detected_seizures,71855,71956,101
Jensen_Eisai_groupA,2,6,ts-global_detected_seizures,71864,71895,31
Jensen_Eisai_groupA,2,6,ts-global_detected_seizures,71906,71934,28
Jensen_Eisai_groupA,2,6,ts-global_detected_seizures,71943,72042,99
Jensen_Eisai_groupA,1,5,ts-global_detected_seizures,71975,72017,42
Jensen_Eisai_groupA,2,6,ts-global_detected_seizures,72043,72076,33
Jensen_Eisai_groupA,1,5,ts-global_detected_seizures,72069,72135,66
Jensen_Eisai_groupA,2,6,ts-global_detected_seizures,72085,72223,138
Jensen_Eisai_groupA,1,5,ts-global_detected_seizures,72137,72215,78
Jensen_Eisai_groupA,1,5,ts-global_detected_seizures,72218,72265,47
Jensen_Eisai_groupA,2,6,ts-global_detected_seizures,72227,72249,22
Jensen_Eisai_groupA,2,6,ts-global_detected_seizures,72303,72336,33
Jensen_Eisai_groupA,1,5,ts-global_detected_seizures,72328,72520,192
Jensen_Eisai_groupA,2,6,ts-global_detected_seizures,72379,72439,60
Jensen_Eisai_groupA,2,6,ts-global_detected_seizures,72467,72492,25
Jensen_Eisai_groupA,1,5,ts-global_detected_seizures,72521,72634,113
Jensen_Eisai_groupA,2,6,ts-global_detected_seizures,72538,72829,291
Jensen_Eisai_groupA,1,5,ts-global_detected_seizures,72652,72709,57
Jensen_Eisai_groupA,1,5,ts-global_detected_seizures,72710,72756,46
Jensen_Eisai_groupA,1,5,ts-global_detected_seizures,72772,72814,42
Jensen_Eisai_groupA,2,6,ts-global_detected_seizures,72854,72879,25
Jensen_Eisai_groupA,1,5,ts-global_detected_seizures,72868,72991,123
Jensen_Eisai_groupA,2,6,ts-global_detected_seizures,72975,73307,332
Jensen_Eisai_groupA,1,5,ts-global_detected_seizures,72992,73062,70
Jensen_Eisai_groupA,1,5,ts-global_detected_seizures,73063,73118,55
Jensen_Eisai_groupA,1,5,ts-global_detected_seizures,73139,73164,25
Jensen_Eisai_groupA,1,5,ts-global_detected_seizures,73178,73228,50
Jensen_Eisai_groupA,1,5,ts-global_detected_seizures,73229,73294,65
Jensen_Eisai_groupA,2,6,ts-global_detected_seizures,73308,73346,38
Jensen_Eisai_groupA,1,5,ts-global_detected_seizures,73318,73365,47
Jensen_Eisai_groupA,2,6,ts-global_detected_seizures,73347,73378,31
Jensen_Eisai_groupA,2,6,ts-global_detected_seizures,73390,73501,111
Jensen_Eisai_groupA,1,5,ts-global_detected_seizures,73565,73613,48
Jensen_Eisai_groupA,1,5,ts-global_detected_seizures,73614,73668,54
Jensen_Eisai_groupA,1,5,ts-global_detected_seizures,73765,73932,167
Jensen_Eisai_groupA,2,6,ts-global_detected_seizures,73822,73846,24
Jensen_Eisai_groupA,2,6,ts-global_detected_seizures,73858,73898,40
Jensen_Eisai_groupA,2,6,ts-global_detected_seizures,73901,73930,29
Jensen_Eisai_groupA,1,5,ts-global_detected_seizures,73933,73960,27
Jensen_Eisai_groupA,1,5,ts-global_detected_seizures,73961,74106,145
Jensen_Eisai_groupA,2,6,ts-global_detected_seizures,73972,74001,29
Jensen_Eisai_groupA,2,6,ts-global_detected_seizures,74030,74066,36
Jensen_Eisai_groupA,1,5,ts-global_detected_seizures,74122,74494,372
Jensen_Eisai_groupA,2,6,ts-global_detected_seizures,74131,74220,89
Jensen_Eisai_groupA,2,6,ts-global_detected_seizures,74229,74268,39
Jensen_Eisai_groupA,2,6,ts-global_detected_seizures,74278,74301,23
Jensen_Eisai_groupA,2,6,ts-global_detected_seizures,74339,74373,34
Jensen_Eisai_groupA,2,6,ts-global_detected_seizures,74417,74458,41
Jensen_Eisai_groupA,1,5,ts-global_detected_seizures,74495,76883,2388
Jensen_Eisai_groupA,2,6,ts-global_detected_seizures,74500,74815,315
Jensen_Eisai_groupA,2,6,ts-global_detected_seizures,74816,75381,565
Jensen_Eisai_groupA,2,6,ts-global_detected_seizures,75383,75412,29
Jensen_Eisai_groupA,2,6,ts-global_detected_seizures,75473,75584,111
Jensen_Eisai_groupA,2,6,ts-global_detected_seizures,75586,75625,39
Jensen_Eisai_groupA,2,6,ts-global_detected_seizures,75657,76268,611
Jensen_Eisai_groupA,2,6,ts-global_detected_seizures,76269,76291,22
Jensen_Eisai_groupA,2,6,ts-global_detected_seizures,76292,76342,50
Jensen_Eisai_groupA,2,6,ts-global_detected_seizures,76351,76395,44
Jensen_Eisai_groupA,2,6,ts-global_detected_seizures,76444,76494,50
Jensen_Eisai_groupA,2,6,ts-global_detected_seizures,76578,76602,24
Jensen_Eisai_groupA,2,6,ts-global_detected_seizures,76695,76729,34
Jensen_Eisai_groupA,1,5,ts-global_detected_seizures,76902,77140,238
Jensen_Eisai_groupA,2,6,ts-global_detected_seizures,76909,76941,32
Jensen_Eisai_groupA,2,6,ts-global_detected_seizures,76974,77011,37
Jensen_Eisai_groupA,2,6,ts-global_detected_seizures,77106,77135,29
Jensen_Eisai_groupA,1,5,ts-global_detected_seizures,77141,77418,277
Jensen_Eisai_groupA,2,6,ts-global_detected_seizures,77155,77190,35
Jensen_Eisai_groupA,2,6,ts-global_detected_seizures,77263,77297,34
Jensen_Eisai_groupA,2,6,ts-global_detected_seizures,77394,77419,25
Jensen_Eisai_groupA,1,5,ts-global_detected_seizures,77419,78047,628
Jensen_Eisai_groupA,2,6,ts-global_detected_seizures,77444,77550,106
Jensen_Eisai_groupA,2,6,ts-global_detected_seizures,77565,77613,48
Jensen_Eisai_groupA,2,6,ts-global_detected_seizures,77616,77640,24
Jensen_Eisai_groupA,2,6,ts-global_detected_seizures,77654,77686,32
Jensen_Eisai_groupA,2,6,ts-global_detected_seizures,77689,77714,25
Jensen_Eisai_groupA,2,6,ts-global_detected_seizures,77725,77805,80
Jensen_Eisai_groupA,2,6,ts-global_detected_seizures,77853,77891,38
Jensen_Eisai_groupA,2,6,ts-global_detected_seizures,77931,77973,42
Jensen_Eisai_groupA,2,6,ts-global_detected_seizures,77985,78021,36
Jensen_Eisai_groupA,2,6,ts-global_detected_seizures,78045,78086,41
Jensen_Eisai_groupA,1,5,ts-global_detected_seizures,78048,78664,616
Jensen_Eisai_groupA,2,6,ts-global_detected_seizures,78150,78291,141
Jensen_Eisai_groupA,2,6,ts-global_detected_seizures,78293,78330,37
Jensen_Eisai_groupA,2,6,ts-global_detected_seizures,78347,78377,30
Jensen_Eisai_groupA,2,6,ts-global_detected_seizures,78398,78816,418
Jensen_Eisai_groupA,1,5,ts-global_detected_seizures,78665,81127,2462
Jensen_Eisai_groupA,2,6,ts-global_detected_seizures,78834,78920,86
Jensen_Eisai_groupA,2,6,ts-global_detected_seizures,78926,78951,25
Jensen_Eisai_groupA,2,6,ts-global_detected_seizures,78997,79037,40
Jensen_Eisai_groupA,2,6,ts-global_detected_seizures,79063,79093,30
Jensen_Eisai_groupA,2,6,ts-global_detected_seizures,79124,79174,50
Jensen_Eisai_groupA,2,6,ts-global_detected_seizures,79205,79289,84
Jensen_Eisai_groupA,2,6,ts-global_detected_seizures,79291,79314,23
Jensen_Eisai_groupA,2,6,ts-global_detected_seizures,79354,79398,44
Jensen_Eisai_groupA,2,6,ts-global_detected_seizures,79413,79436,23
Jensen_Eisai_groupA,2,6,ts-global_detected_seizures,79439,79511,72
Jensen_Eisai_groupA,2,6,ts-global_detected_seizures,79532,80335,803
Jensen_Eisai_groupA,2,6,ts-global_detected_seizures,80336,80385,49
Jensen_Eisai_groupA,2,6,ts-global_detected_seizures,80386,80434,48
Jensen_Eisai_groupA,2,6,ts-global_detected_seizures,80456,80480,24
Jensen_Eisai_groupA,2,6,ts-global_detected_seizures,80490,80598,108
Jensen_Eisai_groupA,4,8,ts-global_detected_seizures,80570,85894,5324
Jensen_Eisai_groupA,2,6,ts-global_detected_seizures,80649,80671,22
Jensen_Eisai_groupA,2,6,ts-global_detected_seizures,80688,80724,36
Jensen_Eisai_groupA,2,6,ts-global_detected_seizures,80731,80755,24
Jensen_Eisai_groupA,2,6,ts-global_detected_seizures,80817,80917,100
Jensen_Eisai_groupA,2,6,ts-global_detected_seizures,80919,80952,33
Jensen_Eisai_groupA,2,6,ts-global_detected_seizures,81011,81038,27
Jensen_Eisai_groupA,2,6,ts-global_detected_seizures,81058,81088,30
Jensen_Eisai_groupA,1,5,ts-global_detected_seizures,81128,81653,525
Jensen_Eisai_groupA,2,6,ts-global_detected_seizures,81133,81155,22
Jensen_Eisai_groupA,2,6,ts-global_detected_seizures,81160,81192,32
Jensen_Eisai_groupA,2,6,ts-global_detected_seizures,81210,81238,28
Jensen_Eisai_groupA,2,6,ts-global_detected_seizures,81258,81280,22
Jensen_Eisai_groupA,2,6,ts-global_detected_seizures,81304,81349,45
Jensen_Eisai_groupA,2,6,ts-global_detected_seizures,81425,81450,25
Jensen_Eisai_groupA,2,6,ts-global_detected_seizures,81469,81587,118
Jensen_Eisai_groupA,2,6,ts-global_detected_seizures,81598,81637,39
Jensen_Eisai_groupA,1,5,ts-global_detected_seizures,81654,81782,128
Jensen_Eisai_groupA,2,6,ts-global_detected_seizures,81663,81699,36
Jensen_Eisai_groupA,2,6,ts-global_detected_seizures,81738,81771,33
Jensen_Eisai_groupA,1,5,ts-global_detected_seizures,81783,82572,789
Jensen_Eisai_groupA,2,6,ts-global_detected_seizures,81831,81854,23
Jensen_Eisai_groupA,2,6,ts-global_detected_seizures,81878,81903,25
Jensen_Eisai_groupA,2,6,ts-global_detected_seizures,81971,81999,28
Jensen_Eisai_groupA,2,6,ts-global_detected_seizures,82026,82052,26
Jensen_Eisai_groupA,2,6,ts-global_detected_seizures,82072,82095,23
Jensen_Eisai_groupA,2,6,ts-global_detected_seizures,82142,82178,36
Jensen_Eisai_groupA,2,6,ts-global_detected_seizures,82205,82244,39
Jensen_Eisai_groupA,2,6,ts-global_detected_seizures,82264,82324,60
Jensen_Eisai_groupA,2,6,ts-global_detected_seizures,82334,83239,905
Jensen_Eisai_groupA,1,5,ts-global_detected_seizures,82598,83168,570
Jensen_Eisai_groupA,1,5,ts-global_detected_seizures,83169,83689,520
Jensen_Eisai_groupA,2,6,ts-global_detected_seizures,83243,84010,767
Jensen_Eisai_groupA,1,5,ts-global_detected_seizures,83690,84018,328
Jensen_Eisai_groupA,2,6,ts-global_detected_seizures,84011,84114,103
Jensen_Eisai_groupA,1,5,ts-global_detected_seizures,84051,84088,37
Jensen_Eisai_groupA,1,5,ts-global_detected_seizures,84089,84529,440
Jensen_Eisai_groupA,2,6,ts-global_detected_seizures,84115,84163,48
Jensen_Eisai_groupA,2,6,ts-global_detected_seizures,84212,84237,25
Jensen_Eisai_groupA,2,6,ts-global_detected_seizures,84238,84296,58
Jensen_Eisai_groupA,2,6,ts-global_detected_seizures,84299,84359,60
Jensen_Eisai_groupA,2,6,ts-global_detected_seizures,84394,85613,1219
Jensen_Eisai_groupA,1,5,ts-global_detected_seizures,84549,84576,27
Jensen_Eisai_groupA,1,5,ts-global_detected_seizures,84668,84701,33
Jensen_Eisai_groupA,1,5,ts-global_detected_seizures,84810,84853,43
Jensen_Eisai_groupA,1,5,ts-global_detected_seizures,84905,85372,467
Jensen_Eisai_groupA,1,5,ts-global_detected_seizures,85457,85496,39
Jensen_Eisai_groupA,1,5,ts-global_detected_seizures,85522,85570,48
Jensen_Eisai_groupA,1,5,ts-global_detected_seizures,85580,85602,22
Jensen_Eisai_groupA,2,6,ts-global_detected_seizures,85614,85688,74
Jensen_Eisai_groupA,1,5,ts-global_detected_seizures,85667,85710,43
Jensen_Eisai_groupA,2,6,ts-global_detected_seizures,85689,85720,31
Jensen_Eisai_groupA,2,6,ts-global_detected_seizures,85722,85894,172
Jensen_Eisai_groupA,1,5,ts-global_detected_seizures,85726,85761,35
Jensen_Eisai_groupA,1,5,ts-global_detected_seizures,85789,85844,55
Jensen_Eisai_groupA,4,8,ts-global_detected_seizures,86618,94278,7660
Jensen_Eisai_groupA,1,5,ts-global_detected_seizures,86692,86765,73
Jensen_Eisai_groupA,1,5,ts-global_detected_seizures,86851,86894,43
Jensen_Eisai_groupA,1,5,ts-global_detected_seizures,86912,86959,47
Jensen_Eisai_groupA,1,5,ts-global_detected_seizures,86967,86992,25
Jensen_Eisai_groupA,1,5,ts-global_detected_seizures,87007,87052,45
Jensen_Eisai_groupA,1,5,ts-global_detected_seizures,87053,87080,27
Jensen_Eisai_groupA,1,5,ts-global_detected_seizures,87084,87118,34
Jensen_Eisai_groupA,1,5,ts-global_detected_seizures,87119,87178,59
Jensen_Eisai_groupA,1,5,ts-global_detected_seizures,87185,87227,42
Jensen_Eisai_groupA,1,5,ts-global_detected_seizures,87228,87254,26
Jensen_Eisai_groupA,1,5,ts-global_detected_seizures,87271,87315,44
Jensen_Eisai_groupA,1,5,ts-global_detected_seizures,87335,87357,22
Jensen_Eisai_groupA,1,5,ts-global_detected_seizures,87377,87673,296
Jensen_Eisai_groupA,1,5,ts-global_detected_seizures,87675,87702,27
Jensen_Eisai_groupA,1,5,ts-global_detected_seizures,87703,87783,80
Jensen_Eisai_groupA,1,5,ts-global_detected_seizures,87784,87806,22
Jensen_Eisai_groupA,1,5,ts-global_detected_seizures,87825,87870,45
Jensen_Eisai_groupA,1,5,ts-global_detected_seizures,87885,87969,84
Jensen_Eisai_groupA,2,6,ts-global_detected_seizures,87903,88354,451
Jensen_Eisai_groupA,1,5,ts-global_detected_seizures,87988,88178,190
Jensen_Eisai_groupA,1,5,ts-global_detected_seizures,88189,88258,69
Jensen_Eisai_groupA,1,5,ts-global_detected_seizures,88300,88344,44
Jensen_Eisai_groupA,2,6,ts-global_detected_seizures,88355,88401,46
Jensen_Eisai_groupA,2,6,ts-global_detected_seizures,88402,88592,190
Jensen_Eisai_groupA,1,5,ts-global_detected_seizures,88478,88596,118
Jensen_Eisai_groupA,2,6,ts-global_detected_seizures,88617,88674,57
Jensen_Eisai_groupA,1,5,ts-global_detected_seizures,88673,88713,40
Jensen_Eisai_groupA,2,6,ts-global_detected_seizures,88675,88736,61
Jensen_Eisai_groupA,2,6,ts-global_detected_seizures,88741,88831,90
Jensen_Eisai_groupA,1,5,ts-global_detected_seizures,88751,88782,31
Jensen_Eisai_groupA,2,6,ts-global_detected_seizures,88842,88978,136
Jensen_Eisai_groupA,1,5,ts-global_detected_seizures,88878,88953,75
Jensen_Eisai_groupA,2,6,ts-global_detected_seizures,88982,89077,95
Jensen_Eisai_groupA,1,5,ts-global_detected_seizures,88990,89167,177
Jensen_Eisai_groupA,2,6,ts-global_detected_seizures,89129,89195,66
Jensen_Eisai_groupA,1,5,ts-global_detected_seizures,89168,89305,137
Jensen_Eisai_groupA,2,6,ts-global_detected_seizures,89203,89237,34
Jensen_Eisai_groupA,2,6,ts-global_detected_seizures,89269,89317,48
Jensen_Eisai_groupA,1,5,ts-global_detected_seizures,89306,89351,45
Jensen_Eisai_groupA,2,6,ts-global_detected_seizures,89318,89450,132
Jensen_Eisai_groupA,1,5,ts-global_detected_seizures,89355,89389,34
Jensen_Eisai_groupA,2,6,ts-global_detected_seizures,89454,89496,42
Jensen_Eisai_groupA,1,5,ts-global_detected_seizures,89494,89546,52
Jensen_Eisai_groupA,2,6,ts-global_detected_seizures,89506,89535,29
Jensen_Eisai_groupA,2,6,ts-global_detected_seizures,89536,89767,231
Jensen_Eisai_groupA,1,5,ts-global_detected_seizures,89602,89650,48
Jensen_Eisai_groupA,1,5,ts-global_detected_seizures,89684,89866,182
Jensen_Eisai_groupA,2,6,ts-global_detected_seizures,89768,89811,43
Jensen_Eisai_groupA,2,6,ts-global_detected_seizures,89813,89843,30
Jensen_Eisai_groupA,2,6,ts-global_detected_seizures,89865,89965,100
Jensen_Eisai_groupA,1,5,ts-global_detected_seizures,89877,89906,29
Jensen_Eisai_groupA,1,5,ts-global_detected_seizures,89959,90003,44
Jensen_Eisai_groupA,2,6,ts-global_detected_seizures,89969,89992,23
Jensen_Eisai_groupA,1,5,ts-global_detected_seizures,90025,90071,46
Jensen_Eisai_groupA,2,6,ts-global_detected_seizures,90033,90083,50
Jensen_Eisai_groupA,1,5,ts-global_detected_seizures,90095,90135,40
Jensen_Eisai_groupA,2,6,ts-global_detected_seizures,90126,90610,484
Jensen_Eisai_groupA,1,5,ts-global_detected_seizures,90136,90201,65
Jensen_Eisai_groupA,1,5,ts-global_detected_seizures,90216,90265,49
Jensen_Eisai_groupA,1,5,ts-global_detected_seizures,90273,90295,22
Jensen_Eisai_groupA,1,5,ts-global_detected_seizures,90322,90378,56
Jensen_Eisai_groupA,1,5,ts-global_detected_seizures,90393,90446,53
Jensen_Eisai_groupA,1,5,ts-global_detected_seizures,90509,90573,64
Jensen_Eisai_groupA,1,5,ts-global_detected_seizures,90592,90632,40
Jensen_Eisai_groupA,2,6,ts-global_detected_seizures,90622,90665,43
Jensen_Eisai_groupA,1,5,ts-global_detected_seizures,90633,90669,36
Jensen_Eisai_groupA,2,6,ts-global_detected_seizures,90666,90689,23
Jensen_Eisai_groupA,2,6,ts-global_detected_seizures,90694,90754,60
Jensen_Eisai_groupA,1,5,ts-global_detected_seizures,90723,90778,55
Jensen_Eisai_groupA,2,6,ts-global_detected_seizures,90785,90814,29
Jensen_Eisai_groupA,1,5,ts-global_detected_seizures,90788,90811,23
Jensen_Eisai_groupA,2,6,ts-global_detected_seizures,90831,90869,38
Jensen_Eisai_groupA,1,5,ts-global_detected_seizures,90883,90946,63
Jensen_Eisai_groupA,2,6,ts-global_detected_seizures,90906,90935,29
Jensen_Eisai_groupA,1,5,ts-global_detected_seizures,90962,91001,39
Jensen_Eisai_groupA,2,6,ts-global_detected_seizures,90983,91006,23
Jensen_Eisai_groupA,1,5,ts-global_detected_seizures,91018,91089,71
Jensen_Eisai_groupA,2,6,ts-global_detected_seizures,91067,91104,37
Jensen_Eisai_groupA,1,5,ts-global_detected_seizures,91104,91171,67
Jensen_Eisai_groupA,1,5,ts-global_detected_seizures,91185,91225,40
Jensen_Eisai_groupA,2,6,ts-global_detected_seizures,91199,91225,26
Jensen_Eisai_groupA,1,5,ts-global_detected_seizures,91278,91342,64
Jensen_Eisai_groupA,2,6,ts-global_detected_seizures,91281,91311,30
Jensen_Eisai_groupA,2,6,ts-global_detected_seizures,91329,91355,26
Jensen_Eisai_groupA,1,5,ts-global_detected_seizures,91343,91373,30
Jensen_Eisai_groupA,1,5,ts-global_detected_seizures,91374,91409,35
Jensen_Eisai_groupA,1,5,ts-global_detected_seizures,91410,91454,44
Jensen_Eisai_groupA,2,6,ts-global_detected_seizures,91412,91443,31
Jensen_Eisai_groupA,2,6,ts-global_detected_seizures,91493,91519,26
Jensen_Eisai_groupA,1,5,ts-global_detected_seizures,91504,91689,185
Jensen_Eisai_groupA,2,6,ts-global_detected_seizures,91543,91567,24
Jensen_Eisai_groupA,2,6,ts-global_detected_seizures,91614,91636,22
Jensen_Eisai_groupA,1,5,ts-global_detected_seizures,91701,91733,32
Jensen_Eisai_groupA,2,6,ts-global_detected_seizures,91749,91792,43
Jensen_Eisai_groupA,1,5,ts-global_detected_seizures,91787,91871,84
Jensen_Eisai_groupA,2,6,ts-global_detected_seizures,91877,91915,38
Jensen_Eisai_groupA,1,5,ts-global_detected_seizures,91883,91935,52
Jensen_Eisai_groupA,1,5,ts-global_detected_seizures,91944,92007,63
Jensen_Eisai_groupA,2,6,ts-global_detected_seizures,92003,92111,108
Jensen_Eisai_groupA,1,5,ts-global_detected_seizures,92047,92093,46
Jensen_Eisai_groupA,1,5,ts-global_detected_seizures,92094,92119,25
Jensen_Eisai_groupA,1,5,ts-global_detected_seizures,92166,92354,188
Jensen_Eisai_groupA,2,6,ts-global_detected_seizures,92173,92202,29
Jensen_Eisai_groupA,2,6,ts-global_detected_seizures,92206,92237,31
Jensen_Eisai_groupA,2,6,ts-global_detected_seizures,92281,92306,25
Jensen_Eisai_groupA,2,6,ts-global_detected_seizures,92341,92368,27
Jensen_Eisai_groupA,1,5,ts-global_detected_seizures,92364,92406,42
Jensen_Eisai_groupA,1,5,ts-global_detected_seizures,92408,92455,47
Jensen_Eisai_groupA,2,6,ts-global_detected_seizures,92423,92452,29
Jensen_Eisai_groupA,1,5,ts-global_detected_seizures,92461,92508,47
Jensen_Eisai_groupA,2,6,ts-global_detected_seizures,92477,92508,31
Jensen_Eisai_groupA,1,5,ts-global_detected_seizures,92543,92576,33
Jensen_Eisai_groupA,2,6,ts-global_detected_seizures,92565,92618,53
Jensen_Eisai_groupA,1,5,ts-global_detected_seizures,92615,92683,68
Jensen_Eisai_groupA,2,6,ts-global_detected_seizures,92677,92740,63
Jensen_Eisai_groupA,1,5,ts-global_detected_seizures,92718,92789,71
Jensen_Eisai_groupA,1,5,ts-global_detected_seizures,92790,93040,250
Jensen_Eisai_groupA,2,6,ts-global_detected_seizures,92811,92846,35
Jensen_Eisai_groupA,2,6,ts-global_detected_seizures,92940,93016,76
Jensen_Eisai_groupA,2,6,ts-global_detected_seizures,93017,94090,1073
Jensen_Eisai_groupA,1,5,ts-global_detected_seizures,93058,93140,82
Jensen_Eisai_groupA,1,5,ts-global_detected_seizures,93141,93199,58
Jensen_Eisai_groupA,1,5,ts-global_detected_seizures,93217,93266,49
Jensen_Eisai_groupA,1,5,ts-global_detected_seizures,93272,93394,122
Jensen_Eisai_groupA,1,5,ts-global_detected_seizures,93395,93445,50
Jensen_Eisai_groupA,1,5,ts-global_detected_seizures,93446,93579,133
Jensen_Eisai_groupA,1,5,ts-global_detected_seizures,93580,93612,32
Jensen_Eisai_groupA,1,5,ts-global_detected_seizures,93613,93646,33
Jensen_Eisai_groupA,1,5,ts-global_detected_seizures,93664,93731,67
Jensen_Eisai_groupA,1,5,ts-global_detected_seizures,93743,93800,57
Jensen_Eisai_groupA,1,5,ts-global_detected_seizures,93846,93868,22
Jensen_Eisai_groupA,1,5,ts-global_detected_seizures,93887,93943,56
Jensen_Eisai_groupA,1,5,ts-global_detected_seizures,93972,94039,67
Jensen_Eisai_groupA,1,5,ts-global_detected_seizures,94049,94183,134
Jensen_Eisai_groupA,2,6,ts-global_detected_seizures,94091,94579,488
Jensen_Eisai_groupA,1,5,ts-global_detected_seizures,94193,94230,37
Jensen_Eisai_groupA,1,5,ts-global_detected_seizures,94238,94364,126
Jensen_Eisai_groupA,4,8,ts-global_detected_seizures,94279,106901,12622
Jensen_Eisai_groupA,1,5,ts-global_detected_seizures,94365,94432,67
Jensen_Eisai_groupA,1,5,ts-global_detected_seizures,94433,94466,33
Jensen_Eisai_groupA,1,5,ts-global_detected_seizures,94471,94508,37
Jensen_Eisai_groupA,1,5,ts-global_detected_seizures,94509,94576,67
Jensen_Eisai_groupA,2,6,ts-global_detected_seizures,94580,94642,62
Jensen_Eisai_groupA,1,5,ts-global_detected_seizures,94582,94618,36
Jensen_Eisai_groupA,1,5,ts-global_detected_seizures,94627,94683,56
Jensen_Eisai_groupA,2,6,ts-global_detected_seizures,94643,94665,22
Jensen_Eisai_groupA,2,6,ts-global_detected_seizures,94674,94706,32
Jensen_Eisai_groupA,1,5,ts-global_detected_seizures,94686,94766,80
Jensen_Eisai_groupA,2,6,ts-global_detected_seizures,94772,94801,29
Jensen_Eisai_groupA,2,6,ts-global_detected_seizures,94802,94844,42
Jensen_Eisai_groupA,1,5,ts-global_detected_seizures,94848,94940,92
Jensen_Eisai_groupA,2,6,ts-global_detected_seizures,94854,94896,42
Jensen_Eisai_groupA,2,6,ts-global_detected_seizures,94903,94937,34
Jensen_Eisai_groupA,1,5,ts-global_detected_seizures,94941,95025,84
Jensen_Eisai_groupA,2,6,ts-global_detected_seizures,94946,94968,22
Jensen_Eisai_groupA,2,6,ts-global_detected_seizures,95017,95059,42
Jensen_Eisai_groupA,1,5,ts-global_detected_seizures,95040,95125,85
Jensen_Eisai_groupA,2,6,ts-global_detected_seizures,95076,95099,23
Jensen_Eisai_groupA,2,6,ts-global_detected_seizures,95113,95141,28
Jensen_Eisai_groupA,2,6,ts-global_detected_seizures,95160,95198,38
Jensen_Eisai_groupA,1,5,ts-global_detected_seizures,95186,95233,47
Jensen_Eisai_groupA,2,6,ts-global_detected_seizures,95219,95245,26
Jensen_Eisai_groupA,1,5,ts-global_detected_seizures,95234,95382,148
Jensen_Eisai_groupA,2,6,ts-global_detected_seizures,95247,95270,23
Jensen_Eisai_groupA,2,6,ts-global_detected_seizures,95321,95392,71
Jensen_Eisai_groupA,1,5,ts-global_detected_seizures,95383,95457,74
Jensen_Eisai_groupA,2,6,ts-global_detected_seizures,95434,95464,30
Jensen_Eisai_groupA,1,5,ts-global_detected_seizures,95458,95506,48
Jensen_Eisai_groupA,2,6,ts-global_detected_seizures,95500,95543,43
Jensen_Eisai_groupA,1,5,ts-global_detected_seizures,95507,95567,60
Jensen_Eisai_groupA,2,6,ts-global_detected_seizures,95559,95585,26
Jensen_Eisai_groupA,1,5,ts-global_detected_seizures,95569,95615,46
Jensen_Eisai_groupA,1,5,ts-global_detected_seizures,95616,95701,85
Jensen_Eisai_groupA,2,6,ts-global_detected_seizures,95661,95690,29
Jensen_Eisai_groupA,2,6,ts-global_detected_seizures,95691,95725,34
Jensen_Eisai_groupA,1,5,ts-global_detected_seizures,95716,95784,68
Jensen_Eisai_groupA,2,6,ts-global_detected_seizures,95732,95780,48
Jensen_Eisai_groupA,2,6,ts-global_detected_seizures,95781,95829,48
Jensen_Eisai_groupA,1,5,ts-global_detected_seizures,95786,95813,27
Jensen_Eisai_groupA,1,5,ts-global_detected_seizures,95786,95813,27
Jensen_Eisai_groupA,1,5,ts-global_detected_seizures,95815,95859,44
Jensen_Eisai_groupA,2,6,ts-global_detected_seizures,95837,95881,44
Jensen_Eisai_groupA,1,5,ts-global_detected_seizures,95861,95934,73
Jensen_Eisai_groupA,2,6,ts-global_detected_seizures,95897,95950,53
Jensen_Eisai_groupA,1,5,ts-global_detected_seizures,95956,96101,145
Jensen_Eisai_groupA,2,6,ts-global_detected_seizures,95961,95995,34
Jensen_Eisai_groupA,2,6,ts-global_detected_seizures,96010,96043,33
Jensen_Eisai_groupA,1,5,ts-global_detected_seizures,96102,96141,39
Jensen_Eisai_groupA,2,6,ts-global_detected_seizures,96111,96152,41
Jensen_Eisai_groupA,1,5,ts-global_detected_seizures,96166,96200,34
Jensen_Eisai_groupA,2,6,ts-global_detected_seizures,96178,96257,79
Jensen_Eisai_groupA,1,5,ts-global_detected_seizures,96234,96297,63
Jensen_Eisai_groupA,2,6,ts-global_detected_seizures,96290,96322,32
Jensen_Eisai_groupA,1,5,ts-global_detected_seizures,96298,96349,51
Jensen_Eisai_groupA,2,6,ts-global_detected_seizures,96342,96379,37
Jensen_Eisai_groupA,1,5,ts-global_detected_seizures,96379,96442,63
Jensen_Eisai_groupA,2,6,ts-global_detected_seizures,96407,96455,48
Jensen_Eisai_groupA,2,6,ts-global_detected_seizures,96485,96525,40
Jensen_Eisai_groupA,1,5,ts-global_detected_seizures,96521,96581,60
Jensen_Eisai_groupA,2,6,ts-global_detected_seizures,96541,96592,51
Jensen_Eisai_groupA,1,5,ts-global_detected_seizures,96583,96630,47
Jensen_Eisai_groupA,2,6,ts-global_detected_seizures,96622,96843,221
Jensen_Eisai_groupA,1,5,ts-global_detected_seizures,96631,96686,55
Jensen_Eisai_groupA,1,5,ts-global_detected_seizures,96687,96797,110
Jensen_Eisai_groupA,2,6,ts-global_detected_seizures,96859,96881,22
Jensen_Eisai_groupA,1,5,ts-global_detected_seizures,96866,96954,88
Jensen_Eisai_groupA,2,6,ts-global_detected_seizures,96887,96965,78
Jensen_Eisai_groupA,2,6,ts-global_detected_seizures,96968,97279,311
Jensen_Eisai_groupA,1,5,ts-global_detected_seizures,96976,97048,72
Jensen_Eisai_groupA,1,5,ts-global_detected_seizures,97050,97200,150
Jensen_Eisai_groupA,1,5,ts-global_detected_seizures,97210,97298,88
Jensen_Eisai_groupA,2,6,ts-global_detected_seizures,97290,97332,42
Jensen_Eisai_groupA,1,5,ts-global_detected_seizures,97321,97379,58
Jensen_Eisai_groupA,2,6,ts-global_detected_seizures,97363,97407,44
Jensen_Eisai_groupA,1,5,ts-global_detected_seizures,97381,97413,32
Jensen_Eisai_groupA,1,5,ts-global_detected_seizures,97415,97486,71
Jensen_Eisai_groupA,2,6,ts-global_detected_seizures,97434,97457,23
Jensen_Eisai_groupA,1,5,ts-global_detected_seizures,97495,97554,59
Jensen_Eisai_groupA,2,6,ts-global_detected_seizures,97514,97574,60
Jensen_Eisai_groupA,1,5,ts-global_detected_seizures,97555,97590,35
Jensen_Eisai_groupA,2,6,ts-global_detected_seizures,97575,97598,23
Jensen_Eisai_groupA,1,5,ts-global_detected_seizures,97592,97664,72
Jensen_Eisai_groupA,2,6,ts-global_detected_seizures,97642,97664,22
Jensen_Eisai_groupA,1,5,ts-global_detected_seizures,97674,97808,134
Jensen_Eisai_groupA,2,6,ts-global_detected_seizures,97697,97757,60
Jensen_Eisai_groupA,2,6,ts-global_detected_seizures,97773,97803,30
Jensen_Eisai_groupA,1,5,ts-global_detected_seizures,97853,97974,121
Jensen_Eisai_groupA,2,6,ts-global_detected_seizures,97855,97895,40
Jensen_Eisai_groupA,2,6,ts-global_detected_seizures,97936,97958,22
Jensen_Eisai_groupA,2,6,ts-global_detected_seizures,97965,97995,30
Jensen_Eisai_groupA,1,5,ts-global_detected_seizures,97975,98064,89
Jensen_Eisai_groupA,2,6,ts-global_detected_seizures,98007,98029,22
Jensen_Eisai_groupA,1,5,ts-global_detected_seizures,98071,98212,141
Jensen_Eisai_groupA,2,6,ts-global_detected_seizures,98073,98107,34
Jensen_Eisai_groupA,2,6,ts-global_detected_seizures,98191,98251,60
Jensen_Eisai_groupA,1,5,ts-global_detected_seizures,98213,98266,53
Jensen_Eisai_groupA,2,6,ts-global_detected_seizures,98264,98317,53
Jensen_Eisai_groupA,1,5,ts-global_detected_seizures,98267,98343,76
Jensen_Eisai_groupA,2,6,ts-global_detected_seizures,98333,98375,42
Jensen_Eisai_groupA,2,6,ts-global_detected_seizures,98379,98405,26
Jensen_Eisai_groupA,2,6,ts-global_detected_seizures,98429,98508,79
Jensen_Eisai_groupA,1,5,ts-global_detected_seizures,98494,101447,2953
Jensen_Eisai_groupA,2,6,ts-global_detected_seizures,98520,99495,975
Jensen_Eisai_groupA,2,6,ts-global_detected_seizures,99498,99600,102
Jensen_Eisai_groupA,2,6,ts-global_detected_seizures,99615,99639,24
Jensen_Eisai_groupA,2,6,ts-global_detected_seizures,99643,99669,26
Jensen_Eisai_groupA,2,6,ts-global_detected_seizures,99675,99704,29
Jensen_Eisai_groupA,2,6,ts-global_detected_seizures,99729,99798,69
Jensen_Eisai_groupA,2,6,ts-global_detected_seizures,99849,99883,34
Jensen_Eisai_groupA,2,6,ts-global_detected_seizures,99986,100017,31
Jensen_Eisai_groupA,2,6,ts-global_detected_seizures,100057,100089,32
Jensen_Eisai_groupA,2,6,ts-global_detected_seizures,100090,100123,33
Jensen_Eisai_groupA,2,6,ts-global_detected_seizures,100130,100171,41
Jensen_Eisai_groupA,2,6,ts-global_detected_seizures,100212,100240,28
Jensen_Eisai_groupA,2,6,ts-global_detected_seizures,100259,100289,30
Jensen_Eisai_groupA,2,6,ts-global_detected_seizures,100337,100393,56
Jensen_Eisai_groupA,2,6,ts-global_detected_seizures,100394,100428,34
Jensen_Eisai_groupA,2,6,ts-global_detected_seizures,100444,100479,35
Jensen_Eisai_groupA,2,6,ts-global_detected_seizures,100480,100536,56
Jensen_Eisai_groupA,2,6,ts-global_detected_seizures,100564,100607,43
Jensen_Eisai_groupA,2,6,ts-global_detected_seizures,100637,100675,38
Jensen_Eisai_groupA,2,6,ts-global_detected_seizures,100682,100721,39
Jensen_Eisai_groupA,2,6,ts-global_detected_seizures,100761,100791,30
Jensen_Eisai_groupA,2,6,ts-global_detected_seizures,100830,100865,35
Jensen_Eisai_groupA,2,6,ts-global_detected_seizures,100891,100926,35
Jensen_Eisai_groupA,2,6,ts-global_detected_seizures,100930,100964,34
Jensen_Eisai_groupA,2,6,ts-global_detected_seizures,100989,101047,58
Jensen_Eisai_groupA,2,6,ts-global_detected_seizures,101077,101116,39
Jensen_Eisai_groupA,2,6,ts-global_detected_seizures,101117,101142,25
Jensen_Eisai_groupA,2,6,ts-global_detected_seizures,101177,101248,71
Jensen_Eisai_groupA,2,6,ts-global_detected_seizures,101249,101291,42
Jensen_Eisai_groupA,2,6,ts-global_detected_seizures,101343,101380,37
Jensen_Eisai_groupA,2,6,ts-global_detected_seizures,101427,101452,25
Jensen_Eisai_groupA,1,5,ts-global_detected_seizures,101490,101556,66
Jensen_Eisai_groupA,2,6,ts-global_detected_seizures,101543,101587,44
Jensen_Eisai_groupA,1,5,ts-global_detected_seizures,101573,101596,23
Jensen_Eisai_groupA,2,6,ts-global_detected_seizures,101609,101652,43
Jensen_Eisai_groupA,1,5,ts-global_detected_seizures,101615,101784,169
Jensen_Eisai_groupA,2,6,ts-global_detected_seizures,101653,101685,32
Jensen_Eisai_groupA,2,6,ts-global_detected_seizures,101718,101741,23
Jensen_Eisai_groupA,2,6,ts-global_detected_seizures,101744,101775,31
Jensen_Eisai_groupA,2,6,ts-global_detected_seizures,101779,101801,22
Jensen_Eisai_groupA,1,5,ts-global_detected_seizures,101786,101828,42
Jensen_Eisai_groupA,2,6,ts-global_detected_seizures,101821,101873,52
Jensen_Eisai_groupA,2,6,ts-global_detected_seizures,101891,101931,40
Jensen_Eisai_groupA,1,5,ts-global_detected_seizures,101892,101921,29
Jensen_Eisai_groupA,1,5,ts-global_detected_seizures,101922,101967,45
Jensen_Eisai_groupA,2,6,ts-global_detected_seizures,101950,102239,289
Jensen_Eisai_groupA,1,5,ts-global_detected_seizures,102005,102039,34
Jensen_Eisai_groupA,1,5,ts-global_detected_seizures,102040,102077,37
Jensen_Eisai_groupA,1,5,ts-global_detected_seizures,102078,102185,107
Jensen_Eisai_groupA,1,5,ts-global_detected_seizures,102203,102234,31
Jensen_Eisai_groupA,2,6,ts-global_detected_seizures,102242,102327,85
Jensen_Eisai_groupA,1,5,ts-global_detected_seizures,102321,102414,93
Jensen_Eisai_groupA,2,6,ts-global_detected_seizures,102331,102355,24
Jensen_Eisai_groupA,2,6,ts-global_detected_seizures,102371,102430,59
Jensen_Eisai_groupA,2,6,ts-global_detected_seizures,102435,102463,28
Jensen_Eisai_groupA,2,6,ts-global_detected_seizures,102476,102534,58
Jensen_Eisai_groupA,1,5,ts-global_detected_seizures,102509,102543,34
Jensen_Eisai_groupA,1,5,ts-global_detected_seizures,102544,102659,115
Jensen_Eisai_groupA,2,6,ts-global_detected_seizures,102558,102591,33
Jensen_Eisai_groupA,2,6,ts-global_detected_seizures,102606,102677,71
Jensen_Eisai_groupA,1,5,ts-global_detected_seizures,102660,102771,111
Jensen_Eisai_groupA,2,6,ts-global_detected_seizures,102693,102759,66
Jensen_Eisai_groupA,1,5,ts-global_detected_seizures,102791,102829,38
Jensen_Eisai_groupA,2,6,ts-global_detected_seizures,102812,102836,24
Jensen_Eisai_groupA,1,5,ts-global_detected_seizures,102833,102868,35
Jensen_Eisai_groupA,2,6,ts-global_detected_seizures,102850,102879,29
Jensen_Eisai_groupA,1,5,ts-global_detected_seizures,102895,102973,78
Jensen_Eisai_groupA,2,6,ts-global_detected_seizures,102931,102987,56
Jensen_Eisai_groupA,1,5,ts-global_detected_seizures,102975,103005,30
Jensen_Eisai_groupA,2,6,ts-global_detected_seizures,102996,103039,43
Jensen_Eisai_groupA,1,5,ts-global_detected_seizures,103019,103042,23
Jensen_Eisai_groupA,1,5,ts-global_detected_seizures,103064,103092,28
Jensen_Eisai_groupA,2,6,ts-global_detected_seizures,103070,103138,68
Jensen_Eisai_groupA,1,5,ts-global_detected_seizures,103135,103191,56
Jensen_Eisai_groupA,2,6,ts-global_detected_seizures,103140,103265,125
Jensen_Eisai_groupA,1,5,ts-global_detected_seizures,103210,103262,52
Jensen_Eisai_groupA,1,5,ts-global_detected_seizures,103286,103353,67
Jensen_Eisai_groupA,2,6,ts-global_detected_seizures,103301,103353,52
Jensen_Eisai_groupA,1,5,ts-global_detected_seizures,103369,103404,35
Jensen_Eisai_groupA,2,6,ts-global_detected_seizures,103401,103601,200
Jensen_Eisai_groupA,1,5,ts-global_detected_seizures,103423,103461,38
Jensen_Eisai_groupA,1,5,ts-global_detected_seizures,103490,103904,414
Jensen_Eisai_groupA,2,6,ts-global_detected_seizures,103686,103734,48
Jensen_Eisai_groupA,2,6,ts-global_detected_seizures,103743,103773,30
Jensen_Eisai_groupA,2,6,ts-global_detected_seizures,103807,103870,63
Jensen_Eisai_groupA,2,6,ts-global_detected_seizures,103871,103905,34
Jensen_Eisai_groupA,1,5,ts-global_detected_seizures,103905,103981,76
Jensen_Eisai_groupA,2,6,ts-global_detected_seizures,103914,103962,48
Jensen_Eisai_groupA,2,6,ts-global_detected_seizures,103978,104028,50
Jensen_Eisai_groupA,1,5,ts-global_detected_seizures,103982,104149,167
Jensen_Eisai_groupA,2,6,ts-global_detected_seizures,104041,104071,30
Jensen_Eisai_groupA,2,6,ts-global_detected_seizures,104119,104159,40
Jensen_Eisai_groupA,1,5,ts-global_detected_seizures,104151,104256,105
Jensen_Eisai_groupA,2,6,ts-global_detected_seizures,104160,104230,70
Jensen_Eisai_groupA,2,6,ts-global_detected_seizures,104242,104273,31
Jensen_Eisai_groupA,1,5,ts-global_detected_seizures,104257,104302,45
Jensen_Eisai_groupA,2,6,ts-global_detected_seizures,104295,104347,52
Jensen_Eisai_groupA,1,5,ts-global_detected_seizures,104310,104462,152
Jensen_Eisai_groupA,2,6,ts-global_detected_seizures,104391,104424,33
Jensen_Eisai_groupA,1,5,ts-global_detected_seizures,104463,104513,50
Jensen_Eisai_groupA,2,6,ts-global_detected_seizures,104483,104573,90
Jensen_Eisai_groupA,1,5,ts-global_detected_seizures,104515,104553,38
Jensen_Eisai_groupA,2,6,ts-global_detected_seizures,104584,104619,35
Jensen_Eisai_groupA,2,6,ts-global_detected_seizures,104620,104660,40
Jensen_Eisai_groupA,1,5,ts-global_detected_seizures,104634,104718,84
Jensen_Eisai_groupA,2,6,ts-global_detected_seizures,104670,104701,31
Jensen_Eisai_groupA,2,6,ts-global_detected_seizures,104709,104756,47
Jensen_Eisai_groupA,1,5,ts-global_detected_seizures,104719,104906,187
Jensen_Eisai_groupA,2,6,ts-global_detected_seizures,104768,104798,30
Jensen_Eisai_groupA,2,6,ts-global_detected_seizures,104800,104877,77
Jensen_Eisai_groupA,2,6,ts-global_detected_seizures,104890,104923,33
Jensen_Eisai_groupA,1,5,ts-global_detected_seizures,104907,105146,239
Jensen_Eisai_groupA,2,6,ts-global_detected_seizures,104960,104987,27
Jensen_Eisai_groupA,2,6,ts-global_detected_seizures,104990,105059,69
Jensen_Eisai_groupA,2,6,ts-global_detected_seizures,105083,105143,60
Jensen_Eisai_groupA,1,5,ts-global_detected_seizures,105159,105184,25
Jensen_Eisai_groupA,2,6,ts-global_detected_seizures,105160,105199,39
Jensen_Eisai_groupA,2,6,ts-global_detected_seizures,105200,105236,36
Jensen_Eisai_groupA,1,5,ts-global_detected_seizures,105216,105348,132
Jensen_Eisai_groupA,2,6,ts-global_detected_seizures,105259,105299,40
Jensen_Eisai_groupA,2,6,ts-global_detected_seizures,105332,105369,37
Jensen_Eisai_groupA,1,5,ts-global_detected_seizures,105354,105414,60
Jensen_Eisai_groupA,2,6,ts-global_detected_seizures,105427,105490,63
Jensen_Eisai_groupA,1,5,ts-global_detected_seizures,105434,105488,54
Jensen_Eisai_groupA,1,5,ts-global_detected_seizures,105509,105546,37
Jensen_Eisai_groupA,2,6,ts-global_detected_seizures,105528,105568,40
Jensen_Eisai_groupA,1,5,ts-global_detected_seizures,105572,105640,68
Jensen_Eisai_groupA,2,6,ts-global_detected_seizures,105592,105644,52
Jensen_Eisai_groupA,1,5,ts-global_detected_seizures,105641,105671,30
Jensen_Eisai_groupA,2,6,ts-global_detected_seizures,105654,105731,77
Jensen_Eisai_groupA,1,5,ts-global_detected_seizures,105673,105713,40
Jensen_Eisai_groupA,2,6,ts-global_detected_seizures,105742,105770,28
Jensen_Eisai_groupA,2,6,ts-global_detected_seizures,105783,106001,218
Jensen_Eisai_groupA,1,5,ts-global_detected_seizures,105929,105991,62
Jensen_Eisai_groupA,2,6,ts-global_detected_seizures,106006,106161,155
Jensen_Eisai_groupA,1,5,ts-global_detected_seizures,106033,106059,26
Jensen_Eisai_groupA,1,5,ts-global_detected_seizures,106076,106154,78
Jensen_Eisai_groupA,1,5,ts-global_detected_seizures,106155,106204,49
Jensen_Eisai_groupA,2,6,ts-global_detected_seizures,106166,106190,24
Jensen_Eisai_groupA,1,5,ts-global_detected_seizures,106206,106255,49
Jensen_Eisai_groupA,2,6,ts-global_detected_seizures,106226,106543,317
Jensen_Eisai_groupA,1,5,ts-global_detected_seizures,106267,106420,153
Jensen_Eisai_groupA,1,5,ts-global_detected_seizures,106422,106478,56
Jensen_Eisai_groupA,1,5,ts-global_detected_seizures,106479,106731,252
Jensen_Eisai_groupA,2,6,ts-global_detected_seizures,106544,107318,774
Jensen_Eisai_groupA,1,5,ts-global_detected_seizures,106732,106803,71
Jensen_Eisai_groupA,1,5,ts-global_detected_seizures,106895,106988,93
Jensen_Eisai_groupA,4,8,ts-global_detected_seizures,106902,120702,13800
Jensen_Eisai_groupA,1,5,ts-global_detected_seizures,106989,107019,30
Jensen_Eisai_groupA,1,5,ts-global_detected_seizures,107035,107059,24
Jensen_Eisai_groupA,1,5,ts-global_detected_seizures,107060,107082,22
Jensen_Eisai_groupA,1,5,ts-global_detected_seizures,107106,107138,32
Jensen_Eisai_groupA,1,5,ts-global_detected_seizures,107139,107181,42
Jensen_Eisai_groupA,1,5,ts-global_detected_seizures,107223,107272,49
Jensen_Eisai_groupA,1,5,ts-global_detected_seizures,107288,107310,22
Jensen_Eisai_groupA,1,5,ts-global_detected_seizures,107311,107358,47
Jensen_Eisai_groupA,2,6,ts-global_detected_seizures,107320,107372,52
Jensen_Eisai_groupA,1,5,ts-global_detected_seizures,107359,107572,213
Jensen_Eisai_groupA,2,6,ts-global_detected_seizures,107394,107421,27
Jensen_Eisai_groupA,2,6,ts-global_detected_seizures,107422,107475,53
Jensen_Eisai_groupA,2,6,ts-global_detected_seizures,107501,107573,72
Jensen_Eisai_groupA,1,5,ts-global_detected_seizures,107573,107713,140
Jensen_Eisai_groupA,2,6,ts-global_detected_seizures,107574,107607,33
Jensen_Eisai_groupA,2,6,ts-global_detected_seizures,107630,107682,52
Jensen_Eisai_groupA,2,6,ts-global_detected_seizures,107719,107794,75
Jensen_Eisai_groupA,1,5,ts-global_detected_seizures,107737,107774,37
Jensen_Eisai_groupA,1,5,ts-global_detected_seizures,107798,107830,32
Jensen_Eisai_groupA,1,5,ts-global_detected_seizures,107831,107943,112
Jensen_Eisai_groupA,2,6,ts-global_detected_seizures,107846,107877,31
Jensen_Eisai_groupA,2,6,ts-global_detected_seizures,107915,107987,72
Jensen_Eisai_groupA,1,5,ts-global_detected_seizures,107944,107975,31
Jensen_Eisai_groupA,1,5,ts-global_detected_seizures,107991,108043,52
Jensen_Eisai_groupA,2,6,ts-global_detected_seizures,108009,108041,32
Jensen_Eisai_groupA,1,5,ts-global_detected_seizures,108044,108087,43
Jensen_Eisai_groupA,2,6,ts-global_detected_seizures,108048,108135,87
Jensen_Eisai_groupA,1,5,ts-global_detected_seizures,108097,108212,115
Jensen_Eisai_groupA,2,6,ts-global_detected_seizures,108137,108169,32
Jensen_Eisai_groupA,2,6,ts-global_detected_seizures,108181,108206,25
Jensen_Eisai_groupA,2,6,ts-global_detected_seizures,108207,108423,216
Jensen_Eisai_groupA,1,5,ts-global_detected_seizures,108213,108310,97
Jensen_Eisai_groupA,1,5,ts-global_detected_seizures,108329,109923,1594
Jensen_Eisai_groupA,2,6,ts-global_detected_seizures,108428,108482,54
Jensen_Eisai_groupA,2,6,ts-global_detected_seizures,108491,108565,74
Jensen_Eisai_groupA,2,6,ts-global_detected_seizures,108566,108610,44
Jensen_Eisai_groupA,2,6,ts-global_detected_seizures,108648,108679,31
Jensen_Eisai_groupA,2,6,ts-global_detected_seizures,108734,108791,57
Jensen_Eisai_groupA,2,6,ts-global_detected_seizures,108800,108831,31
Jensen_Eisai_groupA,2,6,ts-global_detected_seizures,108883,108985,102
Jensen_Eisai_groupA,2,6,ts-global_detected_seizures,109028,109089,61
Jensen_Eisai_groupA,2,6,ts-global_detected_seizures,109108,109152,44
Jensen_Eisai_groupA,2,6,ts-global_detected_seizures,109165,109195,30
Jensen_Eisai_groupA,2,6,ts-global_detected_seizures,109242,109277,35
Jensen_Eisai_groupA,2,6,ts-global_detected_seizures,109292,109342,50
Jensen_Eisai_groupA,2,6,ts-global_detected_seizures,109376,109409,33
Jensen_Eisai_groupA,2,6,ts-global_detected_seizures,109412,109553,141
Jensen_Eisai_groupA,2,6,ts-global_detected_seizures,109586,109613,27
Jensen_Eisai_groupA,2,6,ts-global_detected_seizures,109643,109710,67
Jensen_Eisai_groupA,2,6,ts-global_detected_seizures,109720,109768,48
Jensen_Eisai_groupA,2,6,ts-global_detected_seizures,109791,109822,31
Jensen_Eisai_groupA,2,6,ts-global_detected_seizures,109841,109869,28
Jensen_Eisai_groupA,2,6,ts-global_detected_seizures,109905,109982,77
Jensen_Eisai_groupA,1,5,ts-global_detected_seizures,109924,110083,159
Jensen_Eisai_groupA,2,6,ts-global_detected_seizures,110007,110031,24
Jensen_Eisai_groupA,2,6,ts-global_detected_seizures,110033,110078,45
Jensen_Eisai_groupA,1,5,ts-global_detected_seizures,110084,110128,44
Jensen_Eisai_groupA,2,6,ts-global_detected_seizures,110132,110171,39
Jensen_Eisai_groupA,2,6,ts-global_detected_seizures,110216,110261,45
Jensen_Eisai_groupA,1,5,ts-global_detected_seizures,110256,110356,100
Jensen_Eisai_groupA,2,6,ts-global_detected_seizures,110296,110359,63
Jensen_Eisai_groupA,2,6,ts-global_detected_seizures,110369,110414,45
Jensen_Eisai_groupA,1,5,ts-global_detected_seizures,110390,110657,267
Jensen_Eisai_groupA,2,6,ts-global_detected_seizures,110464,110504,40
Jensen_Eisai_groupA,2,6,ts-global_detected_seizures,110528,110573,45
Jensen_Eisai_groupA,2,6,ts-global_detected_seizures,110574,110644,70
Jensen_Eisai_groupA,2,6,ts-global_detected_seizures,110646,110681,35
Jensen_Eisai_groupA,1,5,ts-global_detected_seizures,110680,110723,43
Jensen_Eisai_groupA,2,6,ts-global_detected_seizures,110692,110722,30
Jensen_Eisai_groupA,1,5,ts-global_detected_seizures,110724,110829,105
Jensen_Eisai_groupA,2,6,ts-global_detected_seizures,110765,110810,45
Jensen_Eisai_groupA,2,6,ts-global_detected_seizures,110819,110853,34
Jensen_Eisai_groupA,2,6,ts-global_detected_seizures,110869,110891,22
Jensen_Eisai_groupA,2,6,ts-global_detected_seizures,110960,110999,39
Jensen_Eisai_groupA,2,6,ts-global_detected_seizures,111027,111080,53
Jensen_Eisai_groupA,1,5,ts-global_detected_seizures,111102,111146,44
Jensen_Eisai_groupA,2,6,ts-global_detected_seizures,111120,111522,402
Jensen_Eisai_groupA,1,5,ts-global_detected_seizures,111147,111176,29
Jensen_Eisai_groupA,1,5,ts-global_detected_seizures,111188,111267,79
Jensen_Eisai_groupA,1,5,ts-global_detected_seizures,111274,111307,33
Jensen_Eisai_groupA,1,5,ts-global_detected_seizures,111329,111406,77
Jensen_Eisai_groupA,1,5,ts-global_detected_seizures,111454,111497,43
Jensen_Eisai_groupA,1,5,ts-global_detected_seizures,111519,111657,138
Jensen_Eisai_groupA,2,6,ts-global_detected_seizures,111530,111577,47
Jensen_Eisai_groupA,2,6,ts-global_detected_seizures,111578,111613,35
Jensen_Eisai_groupA,2,6,ts-global_detected_seizures,111616,111661,45
Jensen_Eisai_groupA,1,5,ts-global_detected_seizures,111658,111803,145
Jensen_Eisai_groupA,2,6,ts-global_detected_seizures,111693,111726,33
Jensen_Eisai_groupA,2,6,ts-global_detected_seizures,111756,111796,40
Jensen_Eisai_groupA,1,5,ts-global_detected_seizures,111812,111847,35
Jensen_Eisai_groupA,1,5,ts-global_detected_seizures,111848,111887,39
Jensen_Eisai_groupA,2,6,ts-global_detected_seizures,111863,111897,34
Jensen_Eisai_groupA,1,5,ts-global_detected_seizures,111889,111942,53
Jensen_Eisai_groupA,2,6,ts-global_detected_seizures,111931,111965,34
Jensen_Eisai_groupA,1,5,ts-global_detected_seizures,111952,112096,144
Jensen_Eisai_groupA,2,6,ts-global_detected_seizures,111994,112039,45
Jensen_Eisai_groupA,2,6,ts-global_detected_seizures,112065,112119,54
Jensen_Eisai_groupA,1,5,ts-global_detected_seizures,112107,112132,25
Jensen_Eisai_groupA,2,6,ts-global_detected_seizures,112134,112177,43
Jensen_Eisai_groupA,1,5,ts-global_detected_seizures,112153,112516,363
Jensen_Eisai_groupA,2,6,ts-global_detected_seizures,112208,112235,27
Jensen_Eisai_groupA,2,6,ts-global_detected_seizures,112249,112285,36
Jensen_Eisai_groupA,2,6,ts-global_detected_seizures,112299,112325,26
Jensen_Eisai_groupA,2,6,ts-global_detected_seizures,112328,112431,103
Jensen_Eisai_groupA,2,6,ts-global_detected_seizures,112432,112454,22
Jensen_Eisai_groupA,2,6,ts-global_detected_seizures,112491,112518,27
Jensen_Eisai_groupA,1,5,ts-global_detected_seizures,112517,112590,73
Jensen_Eisai_groupA,2,6,ts-global_detected_seizures,112527,112551,24
Jensen_Eisai_groupA,2,6,ts-global_detected_seizures,112572,112594,22
Jensen_Eisai_groupA,1,5,ts-global_detected_seizures,112602,112657,55
Jensen_Eisai_groupA,2,6,ts-global_detected_seizures,112629,112705,76
Jensen_Eisai_groupA,1,5,ts-global_detected_seizures,112658,112758,100
Jensen_Eisai_groupA,2,6,ts-global_detected_seizures,112706,112869,163
Jensen_Eisai_groupA,1,5,ts-global_detected_seizures,112759,112812,53
Jensen_Eisai_groupA,1,5,ts-global_detected_seizures,112813,112860,47
Jensen_Eisai_groupA,1,5,ts-global_detected_seizures,112861,112895,34
Jensen_Eisai_groupA,2,6,ts-global_detected_seizures,112880,112904,24
Jensen_Eisai_groupA,1,5,ts-global_detected_seizures,112896,113049,153
Jensen_Eisai_groupA,2,6,ts-global_detected_seizures,112938,112973,35
Jensen_Eisai_groupA,2,6,ts-global_detected_seizures,112989,113032,43
Jensen_Eisai_groupA,1,5,ts-global_detected_seizures,113051,113134,83
Jensen_Eisai_groupA,2,6,ts-global_detected_seizures,113058,113089,31
Jensen_Eisai_groupA,2,6,ts-global_detected_seizures,113111,113169,58
Jensen_Eisai_groupA,1,5,ts-global_detected_seizures,113139,113163,24
Jensen_Eisai_groupA,1,5,ts-global_detected_seizures,113215,113401,186
Jensen_Eisai_groupA,2,6,ts-global_detected_seizures,113221,113293,72
Jensen_Eisai_groupA,2,6,ts-global_detected_seizures,113294,113316,22
Jensen_Eisai_groupA,2,6,ts-global_detected_seizures,113338,113378,40
Jensen_Eisai_groupA,2,6,ts-global_detected_seizures,113407,113462,55
Jensen_Eisai_groupA,1,5,ts-global_detected_seizures,113423,113452,29
Jensen_Eisai_groupA,1,5,ts-global_detected_seizures,113453,113524,71
Jensen_Eisai_groupA,2,6,ts-global_detected_seizures,113499,113542,43
Jensen_Eisai_groupA,1,5,ts-global_detected_seizures,113525,113581,56
Jensen_Eisai_groupA,2,6,ts-global_detected_seizures,113551,113590,39
Jensen_Eisai_groupA,1,5,ts-global_detected_seizures,113589,113695,106
Jensen_Eisai_groupA,2,6,ts-global_detected_seizures,113633,113661,28
Jensen_Eisai_groupA,2,6,ts-global_detected_seizures,113662,113699,37
Jensen_Eisai_groupA,2,6,ts-global_detected_seizures,113720,113751,31
Jensen_Eisai_groupA,1,5,ts-global_detected_seizures,113734,114581,847
Jensen_Eisai_groupA,2,6,ts-global_detected_seizures,113773,113816,43
Jensen_Eisai_groupA,2,6,ts-global_detected_seizures,113858,113918,60
Jensen_Eisai_groupA,2,6,ts-global_detected_seizures,113963,114012,49
Jensen_Eisai_groupA,2,6,ts-global_detected_seizures,114013,114037,24
Jensen_Eisai_groupA,2,6,ts-global_detected_seizures,114038,114063,25
Jensen_Eisai_groupA,2,6,ts-global_detected_seizures,114064,114125,61
Jensen_Eisai_groupA,2,6,ts-global_detected_seizures,114142,114180,38
Jensen_Eisai_groupA,2,6,ts-global_detected_seizures,114193,114259,66
Jensen_Eisai_groupA,2,6,ts-global_detected_seizures,114277,115468,1191
Jensen_Eisai_groupA,1,5,ts-global_detected_seizures,114582,114676,94
Jensen_Eisai_groupA,1,5,ts-global_detected_seizures,114677,115068,391
Jensen_Eisai_groupA,1,5,ts-global_detected_seizures,115069,115331,262
Jensen_Eisai_groupA,1,5,ts-global_detected_seizures,115332,115413,81
Jensen_Eisai_groupA,1,5,ts-global_detected_seizures,115429,115472,43
Jensen_Eisai_groupA,2,6,ts-global_detected_seizures,115470,115538,68
Jensen_Eisai_groupA,1,5,ts-global_detected_seizures,115473,115575,102
Jensen_Eisai_groupA,2,6,ts-global_detected_seizures,115539,115571,32
Jensen_Eisai_groupA,1,5,ts-global_detected_seizures,115583,115697,114
Jensen_Eisai_groupA,2,6,ts-global_detected_seizures,115632,115674,42
Jensen_Eisai_groupA,2,6,ts-global_detected_seizures,115691,115717,26
Jensen_Eisai_groupA,1,5,ts-global_detected_seizures,115739,116033,294
Jensen_Eisai_groupA,2,6,ts-global_detected_seizures,115748,115776,28
Jensen_Eisai_groupA,2,6,ts-global_detected_seizures,115808,115837,29
Jensen_Eisai_groupA,2,6,ts-global_detected_seizures,115864,115891,27
Jensen_Eisai_groupA,2,6,ts-global_detected_seizures,115920,115969,49
Jensen_Eisai_groupA,2,6,ts-global_detected_seizures,115982,116014,32
Jensen_Eisai_groupA,2,6,ts-global_detected_seizures,116043,116067,24
Jensen_Eisai_groupA,2,6,ts-global_detected_seizures,116090,116126,36
Jensen_Eisai_groupA,1,5,ts-global_detected_seizures,116093,116166,73
Jensen_Eisai_groupA,2,6,ts-global_detected_seizures,116157,116186,29
Jensen_Eisai_groupA,1,5,ts-global_detected_seizures,116167,116200,33
Jensen_Eisai_groupA,2,6,ts-global_detected_seizures,116197,116225,28
Jensen_Eisai_groupA,1,5,ts-global_detected_seizures,116223,116383,160
Jensen_Eisai_groupA,2,6,ts-global_detected_seizures,116230,116281,51
Jensen_Eisai_groupA,2,6,ts-global_detected_seizures,116293,116331,38
Jensen_Eisai_groupA,2,6,ts-global_detected_seizures,116364,116390,26
Jensen_Eisai_groupA,2,6,ts-global_detected_seizures,116391,116416,25
Jensen_Eisai_groupA,1,5,ts-global_detected_seizures,116398,116598,200
Jensen_Eisai_groupA,2,6,ts-global_detected_seizures,116421,116453,32
Jensen_Eisai_groupA,2,6,ts-global_detected_seizures,116467,116489,22
Jensen_Eisai_groupA,2,6,ts-global_detected_seizures,116509,116545,36
Jensen_Eisai_groupA,2,6,ts-global_detected_seizures,116546,116578,32
Jensen_Eisai_groupA,2,6,ts-global_detected_seizures,116588,116616,28
Jensen_Eisai_groupA,1,5,ts-global_detected_seizures,116600,116683,83
Jensen_Eisai_groupA,2,6,ts-global_detected_seizures,116656,116680,24
Jensen_Eisai_groupA,1,5,ts-global_detected_seizures,116684,116743,59
Jensen_Eisai_groupA,2,6,ts-global_detected_seizures,116710,116742,32
Jensen_Eisai_groupA,1,5,ts-global_detected_seizures,116748,116774,26
Jensen_Eisai_groupA,1,5,ts-global_detected_seizures,116780,116816,36
Jensen_Eisai_groupA,2,6,ts-global_detected_seizures,116783,116828,45
Jensen_Eisai_groupA,1,5,ts-global_detected_seizures,116817,116877,60
Jensen_Eisai_groupA,2,6,ts-global_detected_seizures,116862,116893,31
Jensen_Eisai_groupA,1,5,ts-global_detected_seizures,116883,117065,182
Jensen_Eisai_groupA,2,6,ts-global_detected_seizures,116927,116955,28
Jensen_Eisai_groupA,2,6,ts-global_detected_seizures,116977,117043,66
Jensen_Eisai_groupA,1,5,ts-global_detected_seizures,117066,117211,145
Jensen_Eisai_groupA,2,6,ts-global_detected_seizures,117090,117126,36
Jensen_Eisai_groupA,2,6,ts-global_detected_seizures,117163,117225,62
Jensen_Eisai_groupA,1,5,ts-global_detected_seizures,117212,117376,164
Jensen_Eisai_groupA,2,6,ts-global_detected_seizures,117252,118062,810
Jensen_Eisai_groupA,1,5,ts-global_detected_seizures,117388,117500,112
Jensen_Eisai_groupA,1,5,ts-global_detected_seizures,117551,117700,149
Jensen_Eisai_groupA,1,5,ts-global_detected_seizures,117701,117789,88
Jensen_Eisai_groupA,1,5,ts-global_detected_seizures,117824,117919,95
Jensen_Eisai_groupA,1,5,ts-global_detected_seizures,117920,117946,26
Jensen_Eisai_groupA,1,5,ts-global_detected_seizures,117947,118008,61
Jensen_Eisai_groupA,1,5,ts-global_detected_seizures,118022,118054,32
Jensen_Eisai_groupA,1,5,ts-global_detected_seizures,118055,118091,36
Jensen_Eisai_groupA,2,6,ts-global_detected_seizures,118083,118164,81
Jensen_Eisai_groupA,1,5,ts-global_detected_seizures,118107,118157,50
Jensen_Eisai_groupA,1,5,ts-global_detected_seizures,118173,118200,27
Jensen_Eisai_groupA,2,6,ts-global_detected_seizures,118188,118529,341
Jensen_Eisai_groupA,1,5,ts-global_detected_seizures,118214,118278,64
Jensen_Eisai_groupA,1,5,ts-global_detected_seizures,118282,118323,41
Jensen_Eisai_groupA,1,5,ts-global_detected_seizures,118324,118354,30
Jensen_Eisai_groupA,1,5,ts-global_detected_seizures,118356,118402,46
Jensen_Eisai_groupA,1,5,ts-global_detected_seizures,118430,118597,167
Jensen_Eisai_groupA,2,6,ts-global_detected_seizures,118570,118596,26
Jensen_Eisai_groupA,2,6,ts-global_detected_seizures,118610,118647,37
Jensen_Eisai_groupA,1,5,ts-global_detected_seizures,118618,118662,44
Jensen_Eisai_groupA,1,5,ts-global_detected_seizures,118663,118820,157
Jensen_Eisai_groupA,2,6,ts-global_detected_seizures,118668,118705,37
Jensen_Eisai_groupA,2,6,ts-global_detected_seizures,118668,118705,37
Jensen_Eisai_groupA,2,6,ts-global_detected_seizures,118721,118744,23
Jensen_Eisai_groupA,2,6,ts-global_detected_seizures,118801,118834,33
Jensen_Eisai_groupA,1,5,ts-global_detected_seizures,118821,118851,30
Jensen_Eisai_groupA,2,6,ts-global_detected_seizures,118851,118876,25
Jensen_Eisai_groupA,1,5,ts-global_detected_seizures,118852,118990,138
Jensen_Eisai_groupA,2,6,ts-global_detected_seizures,118914,118945,31
Jensen_Eisai_groupA,2,6,ts-global_detected_seizures,118977,119016,39
Jensen_Eisai_groupA,2,6,ts-global_detected_seizures,119024,119056,32
Jensen_Eisai_groupA,1,5,ts-global_detected_seizures,119035,119230,195
Jensen_Eisai_groupA,2,6,ts-global_detected_seizures,119088,119114,26
Jensen_Eisai_groupA,2,6,ts-global_detected_seizures,119115,119139,24
Jensen_Eisai_groupA,2,6,ts-global_detected_seizures,119164,119187,23
Jensen_Eisai_groupA,2,6,ts-global_detected_seizures,119188,119311,123
Jensen_Eisai_groupA,1,5,ts-global_detected_seizures,119231,119380,149
Jensen_Eisai_groupA,2,6,ts-global_detected_seizures,119333,119358,25
Jensen_Eisai_groupA,2,6,ts-global_detected_seizures,119369,119821,452
Jensen_Eisai_groupA,1,5,ts-global_detected_seizures,119422,119464,42
Jensen_Eisai_groupA,1,5,ts-global_detected_seizures,119465,119519,54
Jensen_Eisai_groupA,1,5,ts-global_detected_seizures,119520,119573,53
Jensen_Eisai_groupA,1,5,ts-global_detected_seizures,119574,119598,24
Jensen_Eisai_groupA,1,5,ts-global_detected_seizures,119630,119731,101
Jensen_Eisai_groupA,1,5,ts-global_detected_seizures,119732,119889,157
Jensen_Eisai_groupA,2,6,ts-global_detected_seizures,119823,119936,113
Jensen_Eisai_groupA,1,5,ts-global_detected_seizures,119890,119925,35
Jensen_Eisai_groupA,2,6,ts-global_detected_seizures,119937,119990,53
Jensen_Eisai_groupA,1,5,ts-global_detected_seizures,119966,120007,41
Jensen_Eisai_groupA,1,5,ts-global_detected_seizures,120008,120107,99
Jensen_Eisai_groupA,2,6,ts-global_detected_seizures,120013,120037,24
Jensen_Eisai_groupA,2,6,ts-global_detected_seizures,120045,120072,27
Jensen_Eisai_groupA,2,6,ts-global_detected_seizures,120073,120095,22
Jensen_Eisai_groupA,2,6,ts-global_detected_seizures,120103,120138,35
Jensen_Eisai_groupA,1,5,ts-global_detected_seizures,120108,120151,43
Jensen_Eisai_groupA,2,6,ts-global_detected_seizures,120139,120175,36
Jensen_Eisai_groupA,1,5,ts-global_detected_seizures,120176,120412,236
Jensen_Eisai_groupA,2,6,ts-global_detected_seizures,120213,120239,26
Jensen_Eisai_groupA,2,6,ts-global_detected_seizures,120278,120321,43
Jensen_Eisai_groupA,2,6,ts-global_detected_seizures,120356,120392,36
Jensen_Eisai_groupA,2,6,ts-global_detected_seizures,120411,120435,24
Jensen_Eisai_groupA,1,5,ts-global_detected_seizures,120413,120459,46
Jensen_Eisai_groupA,1,5,ts-global_detected_seizures,120481,120629,148
Jensen_Eisai_groupA,2,6,ts-global_detected_seizures,120485,120515,30
Jensen_Eisai_groupA,2,6,ts-global_detected_seizures,120559,120585,26
Jensen_Eisai_groupA,2,6,ts-global_detected_seizures,120638,120683,45
Jensen_Eisai_groupA,1,5,ts-global_detected_seizures,120650,120722,72
Jensen_Eisai_groupA,2,6,ts-global_detected_seizures,120684,120712,28
Jensen_Eisai_groupA,4,8,ts-global_detected_seizures,120703,127677,6974
Jensen_Eisai_groupA,2,6,ts-global_detected_seizures,120741,120780,39
Jensen_Eisai_groupA,1,5,ts-global_detected_seizures,120753,120831,78
Jensen_Eisai_groupA,1,5,ts-global_detected_seizures,120832,120861,29
Jensen_Eisai_groupA,2,6,ts-global_detected_seizures,120900,120934,34
Jensen_Eisai_groupA,1,5,ts-global_detected_seizures,120908,121981,1073
Jensen_Eisai_groupA,2,6,ts-global_detected_seizures,121011,121040,29
Jensen_Eisai_groupA,2,6,ts-global_detected_seizures,121067,121094,27
Jensen_Eisai_groupA,2,6,ts-global_detected_seizures,121160,121274,114
Jensen_Eisai_groupA,2,6,ts-global_detected_seizures,121275,121363,88
Jensen_Eisai_groupA,2,6,ts-global_detected_seizures,121368,121410,42
Jensen_Eisai_groupA,2,6,ts-global_detected_seizures,121411,121437,26
Jensen_Eisai_groupA,2,6,ts-global_detected_seizures,121448,121482,34
Jensen_Eisai_groupA,2,6,ts-global_detected_seizures,121489,121515,26
Jensen_Eisai_groupA,2,6,ts-global_detected_seizures,121538,121568,30
Jensen_Eisai_groupA,2,6,ts-global_detected_seizures,121571,121594,23
Jensen_Eisai_groupA,2,6,ts-global_detected_seizures,121626,121658,32
Jensen_Eisai_groupA,2,6,ts-global_detected_seizures,121670,121711,41
Jensen_Eisai_groupA,2,6,ts-global_detected_seizures,121713,122363,650
Jensen_Eisai_groupA,1,5,ts-global_detected_seizures,121982,122013,31
Jensen_Eisai_groupA,1,5,ts-global_detected_seizures,122014,122071,57
Jensen_Eisai_groupA,1,5,ts-global_detected_seizures,122072,122105,33
Jensen_Eisai_groupA,1,5,ts-global_detected_seizures,122106,122338,232
Jensen_Eisai_groupA,1,5,ts-global_detected_seizures,122339,122400,61
Jensen_Eisai_groupA,2,6,ts-global_detected_seizures,122391,122431,40
Jensen_Eisai_groupA,1,5,ts-global_detected_seizures,122408,122473,65
Jensen_Eisai_groupA,2,6,ts-global_detected_seizures,122437,122497,60
Jensen_Eisai_groupA,1,5,ts-global_detected_seizures,122474,122546,72
Jensen_Eisai_groupA,2,6,ts-global_detected_seizures,122498,122520,22
Jensen_Eisai_groupA,2,6,ts-global_detected_seizures,122550,122573,23
Jensen_Eisai_groupA,2,6,ts-global_detected_seizures,122586,122623,37
Jensen_Eisai_groupA,1,5,ts-global_detected_seizures,122587,122653,66
Jensen_Eisai_groupA,1,5,ts-global_detected_seizures,122654,122676,22
Jensen_Eisai_groupA,2,6,ts-global_detected_seizures,122656,122720,64
Jensen_Eisai_groupA,1,5,ts-global_detected_seizures,122679,122730,51
Jensen_Eisai_groupA,2,6,ts-global_detected_seizures,122729,122753,24
Jensen_Eisai_groupA,1,5,ts-global_detected_seizures,122741,122769,28
Jensen_Eisai_groupA,1,5,ts-global_detected_seizures,122770,122863,93
Jensen_Eisai_groupA,2,6,ts-global_detected_seizures,122798,122820,22
Jensen_Eisai_groupA,2,6,ts-global_detected_seizures,122836,122858,22
Jensen_Eisai_groupA,1,5,ts-global_detected_seizures,122864,122920,56
Jensen_Eisai_groupA,2,6,ts-global_detected_seizures,122915,122944,29
Jensen_Eisai_groupA,1,5,ts-global_detected_seizures,122930,122965,35
Jensen_Eisai_groupA,1,5,ts-global_detected_seizures,122983,123049,66
Jensen_Eisai_groupA,2,6,ts-global_detected_seizures,123009,123031,22
Jensen_Eisai_groupA,1,5,ts-global_detected_seizures,123055,123107,52
Jensen_Eisai_groupA,2,6,ts-global_detected_seizures,123109,123167,58
Jensen_Eisai_groupA,1,5,ts-global_detected_seizures,123119,123237,118
Jensen_Eisai_groupA,2,6,ts-global_detected_seizures,123181,123225,44
Jensen_Eisai_groupA,2,6,ts-global_detected_seizures,123226,123257,31
Jensen_Eisai_groupA,1,5,ts-global_detected_seizures,123252,123370,118
Jensen_Eisai_groupA,2,6,ts-global_detected_seizures,123265,123308,43
Jensen_Eisai_groupA,2,6,ts-global_detected_seizures,123309,123336,27
Jensen_Eisai_groupA,2,6,ts-global_detected_seizures,123349,123900,551
Jensen_Eisai_groupA,1,5,ts-global_detected_seizures,123397,123429,32
Jensen_Eisai_groupA,1,5,ts-global_detected_seizures,123430,123471,41
Jensen_Eisai_groupA,1,5,ts-global_detected_seizures,123496,123595,99
Jensen_Eisai_groupA,1,5,ts-global_detected_seizures,123596,123683,87
Jensen_Eisai_groupA,1,5,ts-global_detected_seizures,123688,123795,107
Jensen_Eisai_groupA,1,5,ts-global_detected_seizures,123812,123900,88
Jensen_Eisai_groupA,2,6,ts-global_detected_seizures,123901,124025,124
Jensen_Eisai_groupA,1,5,ts-global_detected_seizures,123902,123933,31
Jensen_Eisai_groupA,1,5,ts-global_detected_seizures,123934,123971,37
Jensen_Eisai_groupA,1,5,ts-global_detected_seizures,123972,124013,41
Jensen_Eisai_groupA,1,5,ts-global_detected_seizures,124014,124036,22
Jensen_Eisai_groupA,2,6,ts-global_detected_seizures,124026,124083,57
Jensen_Eisai_groupA,1,5,ts-global_detected_seizures,124037,124851,814
Jensen_Eisai_groupA,2,6,ts-global_detected_seizures,124084,124129,45
Jensen_Eisai_groupA,2,6,ts-global_detected_seizures,124162,124213,51
Jensen_Eisai_groupA,2,6,ts-global_detected_seizures,124236,124303,67
Jensen_Eisai_groupA,2,6,ts-global_detected_seizures,124304,124327,23
Jensen_Eisai_groupA,2,6,ts-global_detected_seizures,124334,124375,41
Jensen_Eisai_groupA,2,6,ts-global_detected_seizures,124376,124425,49
Jensen_Eisai_groupA,2,6,ts-global_detected_seizures,124433,124466,33
Jensen_Eisai_groupA,2,6,ts-global_detected_seizures,124481,124507,26
Jensen_Eisai_groupA,2,6,ts-global_detected_seizures,124524,124549,25
Jensen_Eisai_groupA,2,6,ts-global_detected_seizures,124559,124581,22
Jensen_Eisai_groupA,2,6,ts-global_detected_seizures,124604,124634,30
Jensen_Eisai_groupA,2,6,ts-global_detected_seizures,124658,124690,32
Jensen_Eisai_groupA,2,6,ts-global_detected_seizures,124708,124741,33
Jensen_Eisai_groupA,2,6,ts-global_detected_seizures,124747,124795,48
Jensen_Eisai_groupA,2,6,ts-global_detected_seizures,124819,124885,66
Jensen_Eisai_groupA,1,5,ts-global_detected_seizures,124864,124906,42
Jensen_Eisai_groupA,1,5,ts-global_detected_seizures,124911,125019,108
Jensen_Eisai_groupA,2,6,ts-global_detected_seizures,124936,124968,32
Jensen_Eisai_groupA,2,6,ts-global_detected_seizures,124994,125037,43
Jensen_Eisai_groupA,1,5,ts-global_detected_seizures,125020,125058,38
Jensen_Eisai_groupA,2,6,ts-global_detected_seizures,125050,125072,22
Jensen_Eisai_groupA,1,5,ts-global_detected_seizures,125059,125084,25
Jensen_Eisai_groupA,2,6,ts-global_detected_seizures,125120,125150,30
Jensen_Eisai_groupA,1,5,ts-global_detected_seizures,125161,125211,50
Jensen_Eisai_groupA,2,6,ts-global_detected_seizures,125179,125861,682
Jensen_Eisai_groupA,1,5,ts-global_detected_seizures,125215,125300,85
Jensen_Eisai_groupA,1,5,ts-global_detected_seizures,125314,125361,47
Jensen_Eisai_groupA,1,5,ts-global_detected_seizures,125400,125528,128
Jensen_Eisai_groupA,1,5,ts-global_detected_seizures,125599,125693,94
Jensen_Eisai_groupA,1,5,ts-global_detected_seizures,125694,125792,98
Jensen_Eisai_groupA,1,5,ts-global_detected_seizures,125811,125856,45
Jensen_Eisai_groupA,1,5,ts-global_detected_seizures,125857,125922,65
Jensen_Eisai_groupA,2,6,ts-global_detected_seizures,125871,125967,96
Jensen_Eisai_groupA,1,5,ts-global_detected_seizures,125923,125963,40
Jensen_Eisai_groupA,1,5,ts-global_detected_seizures,125995,126046,51
Jensen_Eisai_groupA,2,6,ts-global_detected_seizures,126007,126069,62
Jensen_Eisai_groupA,1,5,ts-global_detected_seizures,126067,126113,46
Jensen_Eisai_groupA,2,6,ts-global_detected_seizures,126072,126094,22
Jensen_Eisai_groupA,1,5,ts-global_detected_seizures,126114,126143,29
Jensen_Eisai_groupA,2,6,ts-global_detected_seizures,126120,126164,44
Jensen_Eisai_groupA,1,5,ts-global_detected_seizures,126144,126175,31
Jensen_Eisai_groupA,2,6,ts-global_detected_seizures,126173,126203,30
Jensen_Eisai_groupA,1,5,ts-global_detected_seizures,126185,126218,33
Jensen_Eisai_groupA,2,6,ts-global_detected_seizures,126217,126245,28
Jensen_Eisai_groupA,1,5,ts-global_detected_seizures,126219,126264,45
Jensen_Eisai_groupA,2,6,ts-global_detected_seizures,126268,126308,40
Jensen_Eisai_groupA,1,5,ts-global_detected_seizures,126294,126441,147
Jensen_Eisai_groupA,2,6,ts-global_detected_seizures,126315,126341,26
Jensen_Eisai_groupA,2,6,ts-global_detected_seizures,126358,126390,32
Jensen_Eisai_groupA,2,6,ts-global_detected_seizures,126417,126443,26
Jensen_Eisai_groupA,1,5,ts-global_detected_seizures,126444,126513,69
Jensen_Eisai_groupA,2,6,ts-global_detected_seizures,126472,126503,31
Jensen_Eisai_groupA,2,6,ts-global_detected_seizures,126515,126538,23
Jensen_Eisai_groupA,1,5,ts-global_detected_seizures,126554,126640,86
Jensen_Eisai_groupA,2,6,ts-global_detected_seizures,126556,126584,28
Jensen_Eisai_groupA,2,6,ts-global_detected_seizures,126591,126622,31
Jensen_Eisai_groupA,2,6,ts-global_detected_seizures,126642,126689,47
Jensen_Eisai_groupA,1,5,ts-global_detected_seizures,126646,126809,163
Jensen_Eisai_groupA,2,6,ts-global_detected_seizures,126712,126760,48
Jensen_Eisai_groupA,2,6,ts-global_detected_seizures,126768,127845,1077
Jensen_Eisai_groupA,1,5,ts-global_detected_seizures,126812,126849,37
Jensen_Eisai_groupA,1,5,ts-global_detected_seizures,126883,126931,48
Jensen_Eisai_groupA,1,5,ts-global_detected_seizures,126963,127064,101
Jensen_Eisai_groupA,1,5,ts-global_detected_seizures,127092,127222,130
Jensen_Eisai_groupA,1,5,ts-global_detected_seizures,127223,127458,235
Jensen_Eisai_groupA,1,5,ts-global_detected_seizures,127459,127617,158
Jensen_Eisai_groupA,1,5,ts-global_detected_seizures,127620,127756,136
Jensen_Eisai_groupA,4,8,ts-global_detected_seizures,127707,137443,9736
Jensen_Eisai_groupA,1,5,ts-global_detected_seizures,127770,129291,1521
Jensen_Eisai_groupA,2,6,ts-global_detected_seizures,127846,127874,28
Jensen_Eisai_groupA,2,6,ts-global_detected_seizures,127875,129834,1959
Jensen_Eisai_groupA,1,5,ts-global_detected_seizures,129292,129566,274
Jensen_Eisai_groupA,1,5,ts-global_detected_seizures,129567,130951,1384
Jensen_Eisai_groupA,2,6,ts-global_detected_seizures,129835,130048,213
Jensen_Eisai_groupA,2,6,ts-global_detected_seizures,130049,132384,2335
Jensen_Eisai_groupA,1,5,ts-global_detected_seizures,130952,131882,930
Jensen_Eisai_groupA,1,5,ts-global_detected_seizures,131883,132321,438
Jensen_Eisai_groupA,1,5,ts-global_detected_seizures,132322,132442,120
Jensen_Eisai_groupA,2,6,ts-global_detected_seizures,132385,132481,96
Jensen_Eisai_groupA,1,5,ts-global_detected_seizures,132443,132626,183
Jensen_Eisai_groupA,2,6,ts-global_detected_seizures,132482,132531,49
Jensen_Eisai_groupA,2,6,ts-global_detected_seizures,132545,132636,91
Jensen_Eisai_groupA,1,5,ts-global_detected_seizures,132627,132653,26
Jensen_Eisai_groupA,2,6,ts-global_detected_seizures,132652,133164,512
Jensen_Eisai_groupA,1,5,ts-global_detected_seizures,132659,132687,28
Jensen_Eisai_groupA,1,5,ts-global_detected_seizures,132688,132732,44
Jensen_Eisai_groupA,1,5,ts-global_detected_seizures,132763,133603,840
Jensen_Eisai_groupA,2,6,ts-global_detected_seizures,133165,133218,53
Jensen_Eisai_groupA,2,6,ts-global_detected_seizures,133220,133287,67
Jensen_Eisai_groupA,2,6,ts-global_detected_seizures,133288,133314,26
Jensen_Eisai_groupA,2,6,ts-global_detected_seizures,133355,133380,25
Jensen_Eisai_groupA,2,6,ts-global_detected_seizures,133387,133459,72
Jensen_Eisai_groupA,2,6,ts-global_detected_seizures,133464,133495,31
Jensen_Eisai_groupA,2,6,ts-global_detected_seizures,133496,133526,30
Jensen_Eisai_groupA,2,6,ts-global_detected_seizures,133528,133561,33
Jensen_Eisai_groupA,2,6,ts-global_detected_seizures,133562,133585,23
Jensen_Eisai_groupA,2,6,ts-global_detected_seizures,133599,133648,49
Jensen_Eisai_groupA,1,5,ts-global_detected_seizures,133604,133783,179
Jensen_Eisai_groupA,2,6,ts-global_detected_seizures,133650,133684,34
Jensen_Eisai_groupA,2,6,ts-global_detected_seizures,133687,133749,62
Jensen_Eisai_groupA,2,6,ts-global_detected_seizures,133754,133783,29
Jensen_Eisai_groupA,1,5,ts-global_detected_seizures,133784,133887,103
Jensen_Eisai_groupA,2,6,ts-global_detected_seizures,133800,133842,42
Jensen_Eisai_groupA,2,6,ts-global_detected_seizures,133886,133926,40
Jensen_Eisai_groupA,1,5,ts-global_detected_seizures,133888,133952,64
Jensen_Eisai_groupA,1,5,ts-global_detected_seizures,133953,134093,140
Jensen_Eisai_groupA,2,6,ts-global_detected_seizures,133955,134005,50
Jensen_Eisai_groupA,2,6,ts-global_detected_seizures,134057,134109,52
Jensen_Eisai_groupA,1,5,ts-global_detected_seizures,134094,134228,134
Jensen_Eisai_groupA,2,6,ts-global_detected_seizures,134139,134184,45
Jensen_Eisai_groupA,2,6,ts-global_detected_seizures,134202,135104,902
Jensen_Eisai_groupA,1,5,ts-global_detected_seizures,134229,134336,107
Jensen_Eisai_groupA,1,5,ts-global_detected_seizures,134363,134436,73
Jensen_Eisai_groupA,1,5,ts-global_detected_seizures,134437,134994,557
Jensen_Eisai_groupA,1,5,ts-global_detected_seizures,134995,135773,778
Jensen_Eisai_groupA,2,6,ts-global_detected_seizures,135105,135155,50
Jensen_Eisai_groupA,2,6,ts-global_detected_seizures,135158,135352,194
Jensen_Eisai_groupA,2,6,ts-global_detected_seizures,135353,135510,157
Jensen_Eisai_groupA,2,6,ts-global_detected_seizures,135511,135596,85
Jensen_Eisai_groupA,2,6,ts-global_detected_seizures,135606,135630,24
Jensen_Eisai_groupA,2,6,ts-global_detected_seizures,135631,135658,27
Jensen_Eisai_groupA,2,6,ts-global_detected_seizures,135659,135720,61
Jensen_Eisai_groupA,1,5,ts-global_detected_seizures,135774,135876,102
Jensen_Eisai_groupA,2,6,ts-global_detected_seizures,135779,135839,60
Jensen_Eisai_groupA,2,6,ts-global_detected_seizures,135845,135894,49
Jensen_Eisai_groupA,1,5,ts-global_detected_seizures,135890,135915,25
Jensen_Eisai_groupA,2,6,ts-global_detected_seizures,135909,135941,32
Jensen_Eisai_groupA,1,5,ts-global_detected_seizures,135916,135953,37
Jensen_Eisai_groupA,2,6,ts-global_detected_seizures,135953,135989,36
Jensen_Eisai_groupA,1,5,ts-global_detected_seizures,135978,136007,29
Jensen_Eisai_groupA,2,6,ts-global_detected_seizures,136004,136031,27
Jensen_Eisai_groupA,1,5,ts-global_detected_seizures,136025,136088,63
Jensen_Eisai_groupA,2,6,ts-global_detected_seizures,136042,136075,33
Jensen_Eisai_groupA,2,6,ts-global_detected_seizures,136081,136109,28
Jensen_Eisai_groupA,2,6,ts-global_detected_seizures,136125,136316,191
Jensen_Eisai_groupA,1,5,ts-global_detected_seizures,136131,136337,206
Jensen_Eisai_groupA,2,6,ts-global_detected_seizures,136322,136348,26
Jensen_Eisai_groupA,1,5,ts-global_detected_seizures,136338,137152,814
Jensen_Eisai_groupA,2,6,ts-global_detected_seizures,136365,137327,962
Jensen_Eisai_groupA,1,5,ts-global_detected_seizures,137153,138301,1148
Jensen_Eisai_groupA,2,6,ts-global_detected_seizures,137328,137356,28
Jensen_Eisai_groupA,2,6,ts-global_detected_seizures,137357,137436,79
Jensen_Eisai_groupA,2,6,ts-global_detected_seizures,137437,137467,30
Jensen_Eisai_groupA,4,8,ts-global_detected_seizures,137444,141686,4242
Jensen_Eisai_groupA,2,6,ts-global_detected_seizures,137472,137522,50
Jensen_Eisai_groupA,2,6,ts-global_detected_seizures,137523,137597,74
Jensen_Eisai_groupA,2,6,ts-global_detected_seizures,137625,137654,29
Jensen_Eisai_groupA,2,6,ts-global_detected_seizures,137670,137717,47
Jensen_Eisai_groupA,2,6,ts-global_detected_seizures,137739,137792,53
Jensen_Eisai_groupA,2,6,ts-global_detected_seizures,137829,137888,59
Jensen_Eisai_groupA,2,6,ts-global_detected_seizures,137889,138001,112
Jensen_Eisai_groupA,2,6,ts-global_detected_seizures,138005,138040,35
Jensen_Eisai_groupA,2,6,ts-global_detected_seizures,138042,138230,188
Jensen_Eisai_groupA,2,6,ts-global_detected_seizures,138237,138260,23
Jensen_Eisai_groupA,2,6,ts-global_detected_seizures,138261,138317,56
Jensen_Eisai_groupA,1,5,ts-global_detected_seizures,138302,138814,512
Jensen_Eisai_groupA,2,6,ts-global_detected_seizures,138341,139305,964
Jensen_Eisai_groupA,2,6,ts-global_detected_seizures,139307,139331,24
Jensen_Eisai_groupA,2,6,ts-global_detected_seizures,139334,139385,51
Jensen_Eisai_groupA,2,6,ts-global_detected_seizures,139387,139440,53
Jensen_Eisai_groupA,1,5,ts-global_detected_seizures,139428,139558,130
Jensen_Eisai_groupA,2,6,ts-global_detected_seizures,139462,139580,118
Jensen_Eisai_groupA,1,5,ts-global_detected_seizures,139587,139617,30
Jensen_Eisai_groupA,2,6,ts-global_detected_seizures,139590,139628,38
Jensen_Eisai_groupA,1,5,ts-global_detected_seizures,139618,139703,85
Jensen_Eisai_groupA,2,6,ts-global_detected_seizures,139648,139671,23
Jensen_Eisai_groupA,2,6,ts-global_detected_seizures,139686,139737,51
Jensen_Eisai_groupA,2,6,ts-global_detected_seizures,139745,139773,28
Jensen_Eisai_groupA,1,5,ts-global_detected_seizures,139778,139828,50
Jensen_Eisai_groupA,2,6,ts-global_detected_seizures,139800,139822,22
Jensen_Eisai_groupA,1,5,ts-global_detected_seizures,139862,139900,38
Jensen_Eisai_groupA,2,6,ts-global_detected_seizures,139885,139926,41
Jensen_Eisai_groupA,1,5,ts-global_detected_seizures,139910,140009,99
Jensen_Eisai_groupA,2,6,ts-global_detected_seizures,139972,140016,44
Jensen_Eisai_groupA,2,6,ts-global_detected_seizures,140017,140057,40
Jensen_Eisai_groupA,2,6,ts-global_detected_seizures,140064,140093,29
Jensen_Eisai_groupA,2,6,ts-global_detected_seizures,140103,140128,25
Jensen_Eisai_groupA,1,5,ts-global_detected_seizures,140106,140152,46
Jensen_Eisai_groupA,2,6,ts-global_detected_seizures,140136,140169,33
Jensen_Eisai_groupA,2,6,ts-global_detected_seizures,140177,140206,29
Jensen_Eisai_groupA,1,5,ts-global_detected_seizures,140253,140281,28
Jensen_Eisai_groupA,2,6,ts-global_detected_seizures,140258,140297,39
Jensen_Eisai_groupA,2,6,ts-global_detected_seizures,140325,140347,22
Jensen_Eisai_groupA,1,5,ts-global_detected_seizures,140352,140376,24
Jensen_Eisai_groupA,1,5,ts-global_detected_seizures,140380,140414,34
Jensen_Eisai_groupA,1,5,ts-global_detected_seizures,140441,140466,25
Jensen_Eisai_groupA,2,6,ts-global_detected_seizures,140442,140473,31
Jensen_Eisai_groupA,1,5,ts-global_detected_seizures,140467,140492,25
Jensen_Eisai_groupA,1,5,ts-global_detected_seizures,140498,140523,25
Jensen_Eisai_groupA,2,6,ts-global_detected_seizures,140502,140539,37
Jensen_Eisai_groupA,2,6,ts-global_detected_seizures,140559,140588,29
Jensen_Eisai_groupA,1,5,ts-global_detected_seizures,140576,140707,131
Jensen_Eisai_groupA,2,6,ts-global_detected_seizures,140628,140663,35
Jensen_Eisai_groupA,1,5,ts-global_detected_seizures,140708,140776,68
Jensen_Eisai_groupA,1,5,ts-global_detected_seizures,140777,140886,109
Jensen_Eisai_groupA,2,6,ts-global_detected_seizures,140813,140858,45
Jensen_Eisai_groupA,2,6,ts-global_detected_seizures,140868,140890,22
Jensen_Eisai_groupA,1,5,ts-global_detected_seizures,140887,141004,117
Jensen_Eisai_groupA,2,6,ts-global_detected_seizures,140907,140956,49
Jensen_Eisai_groupA,2,6,ts-global_detected_seizures,140976,141007,31
Jensen_Eisai_groupA,1,5,ts-global_detected_seizures,141008,141310,302
Jensen_Eisai_groupA,2,6,ts-global_detected_seizures,141052,141077,25
Jensen_Eisai_groupA,2,6,ts-global_detected_seizures,141111,141142,31
Jensen_Eisai_groupA,2,6,ts-global_detected_seizures,141176,141221,45
Jensen_Eisai_groupA,2,6,ts-global_detected_seizures,141250,141295,45
Jensen_Eisai_groupA,2,6,ts-global_detected_seizures,141309,141342,33
Jensen_Eisai_groupA,1,5,ts-global_detected_seizures,141311,143204,1893
Jensen_Eisai_groupA,2,6,ts-global_detected_seizures,141376,141413,37
Jensen_Eisai_groupA,2,6,ts-global_detected_seizures,141458,141510,52
Jensen_Eisai_groupA,2,6,ts-global_detected_seizures,141511,141650,139
Jensen_Eisai_groupA,2,6,ts-global_detected_seizures,141651,141681,30
Jensen_Eisai_groupA,4,8,ts-global_detected_seizures,141687,151162,9475
Jensen_Eisai_groupA,2,6,ts-global_detected_seizures,141774,141799,25
Jensen_Eisai_groupA,2,6,ts-global_detected_seizures,141821,141845,24
Jensen_Eisai_groupA,2,6,ts-global_detected_seizures,141879,142149,270
Jensen_Eisai_groupA,2,6,ts-global_detected_seizures,142162,142205,43
Jensen_Eisai_groupA,2,6,ts-global_detected_seizures,142206,142251,45
Jensen_Eisai_groupA,2,6,ts-global_detected_seizures,142314,142347,33
Jensen_Eisai_groupA,2,6,ts-global_detected_seizures,142352,142390,38
Jensen_Eisai_groupA,2,6,ts-global_detected_seizures,142405,142463,58
Jensen_Eisai_groupA,2,6,ts-global_detected_seizures,142487,143176,689
Jensen_Eisai_groupA,2,6,ts-global_detected_seizures,143177,143532,355
Jensen_Eisai_groupA,1,5,ts-global_detected_seizures,143205,143247,42
Jensen_Eisai_groupA,1,5,ts-global_detected_seizures,143248,143678,430
Jensen_Eisai_groupA,2,6,ts-global_detected_seizures,143533,143589,56
Jensen_Eisai_groupA,1,5,ts-global_detected_seizures,143679,143943,264
Jensen_Eisai_groupA,2,6,ts-global_detected_seizures,143680,143706,26
Jensen_Eisai_groupA,2,6,ts-global_detected_seizures,143723,143757,34
Jensen_Eisai_groupA,2,6,ts-global_detected_seizures,143775,143798,23
Jensen_Eisai_groupA,2,6,ts-global_detected_seizures,143824,143858,34
Jensen_Eisai_groupA,2,6,ts-global_detected_seizures,143943,143974,31
Jensen_Eisai_groupA,1,5,ts-global_detected_seizures,143944,144221,277
Jensen_Eisai_groupA,2,6,ts-global_detected_seizures,144010,144084,74
Jensen_Eisai_groupA,2,6,ts-global_detected_seizures,144098,144142,44
Jensen_Eisai_groupA,1,5,ts-global_detected_seizures,144222,144505,283
Jensen_Eisai_groupA,2,6,ts-global_detected_seizures,144254,144277,23
Jensen_Eisai_groupA,2,6,ts-global_detected_seizures,144310,144349,39
Jensen_Eisai_groupA,2,6,ts-global_detected_seizures,144359,144404,45
Jensen_Eisai_groupA,2,6,ts-global_detected_seizures,144467,144497,30
Jensen_Eisai_groupA,2,6,ts-global_detected_seizures,144539,144575,36
Jensen_Eisai_groupA,1,5,ts-global_detected_seizures,144547,144795,248
Jensen_Eisai_groupA,2,6,ts-global_detected_seizures,144620,144646,26
Jensen_Eisai_groupA,2,6,ts-global_detected_seizures,144672,144747,75
Jensen_Eisai_groupA,2,6,ts-global_detected_seizures,144782,144815,33
Jensen_Eisai_groupA,1,5,ts-global_detected_seizures,144796,144981,185
Jensen_Eisai_groupA,2,6,ts-global_detected_seizures,144835,144901,66
Jensen_Eisai_groupA,2,6,ts-global_detected_seizures,144912,144949,37
Jensen_Eisai_groupA,2,6,ts-global_detected_seizures,144951,144975,24
Jensen_Eisai_groupA,2,6,ts-global_detected_seizures,145001,145028,27
Jensen_Eisai_groupA,1,5,ts-global_detected_seizures,145029,145062,33
Jensen_Eisai_groupA,2,6,ts-global_detected_seizures,145040,145070,30
Jensen_Eisai_groupA,1,5,ts-global_detected_seizures,145086,145111,25
Jensen_Eisai_groupA,2,6,ts-global_detected_seizures,145120,145153,33
Jensen_Eisai_groupA,2,6,ts-global_detected_seizures,145172,146436,1264
Jensen_Eisai_groupA,1,5,ts-global_detected_seizures,145248,145303,55
Jensen_Eisai_groupA,1,5,ts-global_detected_seizures,145370,145417,47
Jensen_Eisai_groupA,1,5,ts-global_detected_seizures,145482,145510,28
Jensen_Eisai_groupA,1,5,ts-global_detected_seizures,145542,145565,23
Jensen_Eisai_groupA,1,5,ts-global_detected_seizures,145716,145819,103
Jensen_Eisai_groupA,1,5,ts-global_detected_seizures,145895,145920,25
Jensen_Eisai_groupA,1,5,ts-global_detected_seizures,146025,146068,43
Jensen_Eisai_groupA,1,5,ts-global_detected_seizures,146083,146110,27
Jensen_Eisai_groupA,1,5,ts-global_detected_seizures,146111,146137,26
Jensen_Eisai_groupA,1,5,ts-global_detected_seizures,146170,146202,32
Jensen_Eisai_groupA,1,5,ts-global_detected_seizures,146260,146333,73
Jensen_Eisai_groupA,1,5,ts-global_detected_seizures,146404,146436,32
Jensen_Eisai_groupA,2,6,ts-global_detected_seizures,146437,146645,208
Jensen_Eisai_groupA,1,5,ts-global_detected_seizures,146529,146594,65
Jensen_Eisai_groupA,1,5,ts-global_detected_seizures,146595,146624,29
Jensen_Eisai_groupA,1,5,ts-global_detected_seizures,146638,146681,43
Jensen_Eisai_groupA,2,6,ts-global_detected_seizures,146646,146803,157
Jensen_Eisai_groupA,1,5,ts-global_detected_seizures,146712,146736,24
Jensen_Eisai_groupA,1,5,ts-global_detected_seizures,146773,146859,86
Jensen_Eisai_groupA,2,6,ts-global_detected_seizures,146805,146845,40
Jensen_Eisai_groupA,1,5,ts-global_detected_seizures,146880,146917,37
Jensen_Eisai_groupA,2,6,ts-global_detected_seizures,146944,146985,41
Jensen_Eisai_groupA,1,5,ts-global_detected_seizures,146956,146991,35
Jensen_Eisai_groupA,2,6,ts-global_detected_seizures,147026,147049,23
Jensen_Eisai_groupA,1,5,ts-global_detected_seizures,147058,147088,30
Jensen_Eisai_groupA,2,6,ts-global_detected_seizures,147060,147094,34
Jensen_Eisai_groupA,1,5,ts-global_detected_seizures,147089,147190,101
Jensen_Eisai_groupA,2,6,ts-global_detected_seizures,147097,147124,27
Jensen_Eisai_groupA,2,6,ts-global_detected_seizures,147160,147186,26
Jensen_Eisai_groupA,1,5,ts-global_detected_seizures,147191,147242,51
Jensen_Eisai_groupA,2,6,ts-global_detected_seizures,147204,147227,23
Jensen_Eisai_groupA,1,5,ts-global_detected_seizures,147245,147281,36
Jensen_Eisai_groupA,1,5,ts-global_detected_seizures,147288,147404,116
Jensen_Eisai_groupA,2,6,ts-global_detected_seizures,147335,147359,24
Jensen_Eisai_groupA,2,6,ts-global_detected_seizures,147360,147391,31
Jensen_Eisai_groupA,1,5,ts-global_detected_seizures,147405,147439,34
Jensen_Eisai_groupA,2,6,ts-global_detected_seizures,147406,147431,25
Jensen_Eisai_groupA,2,6,ts-global_detected_seizures,147448,147481,33
Jensen_Eisai_groupA,1,5,ts-global_detected_seizures,147449,147600,151
Jensen_Eisai_groupA,2,6,ts-global_detected_seizures,147516,147548,32
Jensen_Eisai_groupA,2,6,ts-global_detected_seizures,147552,147580,28
Jensen_Eisai_groupA,2,6,ts-global_detected_seizures,147622,147680,58
Jensen_Eisai_groupA,1,5,ts-global_detected_seizures,147654,147725,71
Jensen_Eisai_groupA,2,6,ts-global_detected_seizures,147709,147783,74
Jensen_Eisai_groupA,1,5,ts-global_detected_seizures,147750,147869,119
Jensen_Eisai_groupA,2,6,ts-global_detected_seizures,147791,147847,56
Jensen_Eisai_groupA,1,5,ts-global_detected_seizures,147872,147912,40
Jensen_Eisai_groupA,2,6,ts-global_detected_seizures,147880,147912,32
Jensen_Eisai_groupA,1,5,ts-global_detected_seizures,147929,147988,59
Jensen_Eisai_groupA,2,6,ts-global_detected_seizures,147973,148004,31
Jensen_Eisai_groupA,2,6,ts-global_detected_seizures,148045,148067,22
Jensen_Eisai_groupA,1,5,ts-global_detected_seizures,148056,148112,56
Jensen_Eisai_groupA,2,6,ts-global_detected_seizures,148107,148133,26
Jensen_Eisai_groupA,1,5,ts-global_detected_seizures,148113,148173,60
Jensen_Eisai_groupA,2,6,ts-global_detected_seizures,148154,148185,31
Jensen_Eisai_groupA,1,5,ts-global_detected_seizures,148174,148217,43
Jensen_Eisai_groupA,2,6,ts-global_detected_seizures,148215,148241,26
Jensen_Eisai_groupA,2,6,ts-global_detected_seizures,148281,148304,23
Jensen_Eisai_groupA,1,5,ts-global_detected_seizures,148289,148335,46
Jensen_Eisai_groupA,2,6,ts-global_detected_seizures,148305,148337,32
Jensen_Eisai_groupA,2,6,ts-global_detected_seizures,148340,148363,23
Jensen_Eisai_groupA,1,5,ts-global_detected_seizures,148345,148386,41
Jensen_Eisai_groupA,2,6,ts-global_detected_seizures,148380,148407,27
Jensen_Eisai_groupA,1,5,ts-global_detected_seizures,148392,148418,26
Jensen_Eisai_groupA,2,6,ts-global_detected_seizures,148413,148468,55
Jensen_Eisai_groupA,1,5,ts-global_detected_seizures,148419,148480,61
Jensen_Eisai_groupA,1,5,ts-global_detected_seizures,148481,148512,31
Jensen_Eisai_groupA,2,6,ts-global_detected_seizures,148494,148526,32
Jensen_Eisai_groupA,1,5,ts-global_detected_seizures,148513,148650,137
Jensen_Eisai_groupA,2,6,ts-global_detected_seizures,148546,148579,33
Jensen_Eisai_groupA,2,6,ts-global_detected_seizures,148612,148636,24
Jensen_Eisai_groupA,1,5,ts-global_detected_seizures,148657,148680,23
Jensen_Eisai_groupA,2,6,ts-global_detected_seizures,148671,148702,31
Jensen_Eisai_groupA,1,5,ts-global_detected_seizures,148693,148723,30
Jensen_Eisai_groupA,1,5,ts-global_detected_seizures,148724,148785,61
Jensen_Eisai_groupA,2,6,ts-global_detected_seizures,148730,148754,24
Jensen_Eisai_groupA,2,6,ts-global_detected_seizures,148760,148800,40
Jensen_Eisai_groupA,1,5,ts-global_detected_seizures,148786,148827,41
Jensen_Eisai_groupA,2,6,ts-global_detected_seizures,148844,148891,47
Jensen_Eisai_groupA,1,5,ts-global_detected_seizures,148849,148884,35
Jensen_Eisai_groupA,1,5,ts-global_detected_seizures,148886,148923,37
Jensen_Eisai_groupA,2,6,ts-global_detected_seizures,148896,148956,60
Jensen_Eisai_groupA,2,6,ts-global_detected_seizures,148957,149064,107
Jensen_Eisai_groupA,1,5,ts-global_detected_seizures,148971,149048,77
Jensen_Eisai_groupA,1,5,ts-global_detected_seizures,149049,149097,48
Jensen_Eisai_groupA,2,6,ts-global_detected_seizures,149065,149099,34
Jensen_Eisai_groupA,1,5,ts-global_detected_seizures,149101,149124,23
Jensen_Eisai_groupA,2,6,ts-global_detected_seizures,149111,149155,44
Jensen_Eisai_groupA,1,5,ts-global_detected_seizures,149125,149148,23
Jensen_Eisai_groupA,2,6,ts-global_detected_seizures,149177,149218,41
Jensen_Eisai_groupA,1,5,ts-global_detected_seizures,149180,149298,118
Jensen_Eisai_groupA,2,6,ts-global_detected_seizures,149296,149318,22
Jensen_Eisai_groupA,1,5,ts-global_detected_seizures,149299,149340,41
Jensen_Eisai_groupA,1,5,ts-global_detected_seizures,149349,149396,47
Jensen_Eisai_groupA,2,6,ts-global_detected_seizures,149350,149390,40
Jensen_Eisai_groupA,2,6,ts-global_detected_seizures,149391,149415,24
Jensen_Eisai_groupA,2,6,ts-global_detected_seizures,149416,149442,26
Jensen_Eisai_groupA,2,6,ts-global_detected_seizures,149450,149537,87
Jensen_Eisai_groupA,2,6,ts-global_detected_seizures,149545,150289,744
Jensen_Eisai_groupA,1,5,ts-global_detected_seizures,149612,151650,2038
Jensen_Eisai_groupA,2,6,ts-global_detected_seizures,150290,150471,181
Jensen_Eisai_groupA,2,6,ts-global_detected_seizures,150474,150496,22
Jensen_Eisai_groupA,2,6,ts-global_detected_seizures,150505,150536,31
Jensen_Eisai_groupA,2,6,ts-global_detected_seizures,150537,150570,33
Jensen_Eisai_groupA,2,6,ts-global_detected_seizures,150653,150678,25
Jensen_Eisai_groupA,2,6,ts-global_detected_seizures,150703,150727,24
Jensen_Eisai_groupA,2,6,ts-global_detected_seizures,150731,150768,37
Jensen_Eisai_groupA,2,6,ts-global_detected_seizures,150772,150799,27
Jensen_Eisai_groupA,2,6,ts-global_detected_seizures,150848,150881,33
Jensen_Eisai_groupA,2,6,ts-global_detected_seizures,150896,150918,22
Jensen_Eisai_groupA,2,6,ts-global_detected_seizures,150943,150977,34
Jensen_Eisai_groupA,2,6,ts-global_detected_seizures,150990,151061,71
Jensen_Eisai_groupA,2,6,ts-global_detected_seizures,151067,151089,22
Jensen_Eisai_groupA,2,6,ts-global_detected_seizures,151106,151131,25
Jensen_Eisai_groupA,4,8,ts-global_detected_seizures,151163,171548,20385
Jensen_Eisai_groupA,2,6,ts-global_detected_seizures,151170,151193,23
Jensen_Eisai_groupA,2,6,ts-global_detected_seizures,151206,151244,38
Jensen_Eisai_groupA,2,6,ts-global_detected_seizures,151268,151299,31
Jensen_Eisai_groupA,2,6,ts-global_detected_seizures,151345,151378,33
Jensen_Eisai_groupA,2,6,ts-global_detected_seizures,151405,151427,22
Jensen_Eisai_groupA,2,6,ts-global_detected_seizures,151442,151475,33
Jensen_Eisai_groupA,2,6,ts-global_detected_seizures,151522,151592,70
Jensen_Eisai_groupA,2,6,ts-global_detected_seizures,151606,151808,202
Jensen_Eisai_groupA,1,5,ts-global_detected_seizures,151651,151847,196
Jensen_Eisai_groupA,2,6,ts-global_detected_seizures,151822,151864,42
Jensen_Eisai_groupA,1,5,ts-global_detected_seizures,151862,151921,59
Jensen_Eisai_groupA,2,6,ts-global_detected_seizures,151883,151908,25
Jensen_Eisai_groupA,2,6,ts-global_detected_seizures,151915,151938,23
Jensen_Eisai_groupA,1,5,ts-global_detected_seizures,151922,152572,650
Jensen_Eisai_groupA,2,6,ts-global_detected_seizures,151963,152003,40
Jensen_Eisai_groupA,2,6,ts-global_detected_seizures,152021,152049,28
Jensen_Eisai_groupA,2,6,ts-global_detected_seizures,152058,152706,648
Jensen_Eisai_groupA,1,5,ts-global_detected_seizures,152573,152736,163
Jensen_Eisai_groupA,2,6,ts-global_detected_seizures,152707,153047,340
Jensen_Eisai_groupA,1,5,ts-global_detected_seizures,152737,152792,55
Jensen_Eisai_groupA,1,5,ts-global_detected_seizures,152793,152891,98
Jensen_Eisai_groupA,1,5,ts-global_detected_seizures,152892,153606,714
Jensen_Eisai_groupA,2,6,ts-global_detected_seizures,153048,153091,43
Jensen_Eisai_groupA,2,6,ts-global_detected_seizures,153126,153152,26
Jensen_Eisai_groupA,2,6,ts-global_detected_seizures,153165,153539,374
Jensen_Eisai_groupA,2,6,ts-global_detected_seizures,153540,153637,97
Jensen_Eisai_groupA,1,5,ts-global_detected_seizures,153622,153673,51
Jensen_Eisai_groupA,2,6,ts-global_detected_seizures,153666,153693,27
Jensen_Eisai_groupA,1,5,ts-global_detected_seizures,153674,155089,1415
Jensen_Eisai_groupA,2,6,ts-global_detected_seizures,153709,153742,33
Jensen_Eisai_groupA,2,6,ts-global_detected_seizures,153743,153766,23
Jensen_Eisai_groupA,2,6,ts-global_detected_seizures,153796,154282,486
Jensen_Eisai_groupA,2,6,ts-global_detected_seizures,154283,154308,25
Jensen_Eisai_groupA,2,6,ts-global_detected_seizures,154311,154347,36
Jensen_Eisai_groupA,2,6,ts-global_detected_seizures,154391,154427,36
Jensen_Eisai_groupA,2,6,ts-global_detected_seizures,154446,154492,46
Jensen_Eisai_groupA,2,6,ts-global_detected_seizures,154511,154534,23
Jensen_Eisai_groupA,2,6,ts-global_detected_seizures,154544,154609,65
Jensen_Eisai_groupA,2,6,ts-global_detected_seizures,154617,154647,30
Jensen_Eisai_groupA,2,6,ts-global_detected_seizures,154648,154688,40
Jensen_Eisai_groupA,2,6,ts-global_detected_seizures,154698,154726,28
Jensen_Eisai_groupA,2,6,ts-global_detected_seizures,154762,154817,55
Jensen_Eisai_groupA,2,6,ts-global_detected_seizures,154842,154874,32
Jensen_Eisai_groupA,2,6,ts-global_detected_seizures,154891,154921,30
Jensen_Eisai_groupA,2,6,ts-global_detected_seizures,154975,155003,28
Jensen_Eisai_groupA,2,6,ts-global_detected_seizures,155008,155098,90
Jensen_Eisai_groupA,1,5,ts-global_detected_seizures,155103,155192,89
Jensen_Eisai_groupA,2,6,ts-global_detected_seizures,155105,155127,22
Jensen_Eisai_groupA,2,6,ts-global_detected_seizures,155139,155172,33
Jensen_Eisai_groupA,1,5,ts-global_detected_seizures,155208,155285,77
Jensen_Eisai_groupA,2,6,ts-global_detected_seizures,155268,155292,24
Jensen_Eisai_groupA,1,5,ts-global_detected_seizures,155295,155385,90
Jensen_Eisai_groupA,2,6,ts-global_detected_seizures,155338,155361,23
Jensen_Eisai_groupA,1,5,ts-global_detected_seizures,155386,155652,266
Jensen_Eisai_groupA,2,6,ts-global_detected_seizures,155401,155424,23
Jensen_Eisai_groupA,2,6,ts-global_detected_seizures,155432,155478,46
Jensen_Eisai_groupA,2,6,ts-global_detected_seizures,155517,155551,34
Jensen_Eisai_groupA,2,6,ts-global_detected_seizures,155601,155687,86
Jensen_Eisai_groupA,1,5,ts-global_detected_seizures,155655,155689,34
Jensen_Eisai_groupA,1,5,ts-global_detected_seizures,155700,155733,33
Jensen_Eisai_groupA,2,6,ts-global_detected_seizures,155816,155849,33
Jensen_Eisai_groupA,1,5,ts-global_detected_seizures,155824,157206,1382
Jensen_Eisai_groupA,2,6,ts-global_detected_seizures,155945,155990,45
Jensen_Eisai_groupA,2,6,ts-global_detected_seizures,156024,156047,23
Jensen_Eisai_groupA,2,6,ts-global_detected_seizures,156078,156116,38
Jensen_Eisai_groupA,2,6,ts-global_detected_seizures,156130,156156,26
Jensen_Eisai_groupA,2,6,ts-global_detected_seizures,156223,156255,32
Jensen_Eisai_groupA,2,6,ts-global_detected_seizures,156298,156332,34
Jensen_Eisai_groupA,2,6,ts-global_detected_seizures,156333,156358,25
Jensen_Eisai_groupA,2,6,ts-global_detected_seizures,156390,157091,701
Jensen_Eisai_groupA,2,6,ts-global_detected_seizures,157104,157187,83
Jensen_Eisai_groupA,2,6,ts-global_detected_seizures,157188,157425,237
Jensen_Eisai_groupA,1,5,ts-global_detected_seizures,157207,157244,37
Jensen_Eisai_groupA,1,5,ts-global_detected_seizures,157245,157674,429
Jensen_Eisai_groupA,2,6,ts-global_detected_seizures,157441,157756,315
Jensen_Eisai_groupA,1,5,ts-global_detected_seizures,157675,157703,28
Jensen_Eisai_groupA,1,5,ts-global_detected_seizures,157705,157801,96
Jensen_Eisai_groupA,2,6,ts-global_detected_seizures,157757,158081,324
Jensen_Eisai_groupA,1,5,ts-global_detected_seizures,157802,157879,77
Jensen_Eisai_groupA,1,5,ts-global_detected_seizures,157949,157995,46
Jensen_Eisai_groupA,1,5,ts-global_detected_seizures,158045,158132,87
Jensen_Eisai_groupA,2,6,ts-global_detected_seizures,158082,158129,47
Jensen_Eisai_groupA,1,5,ts-global_detected_seizures,158133,158161,28
Jensen_Eisai_groupA,2,6,ts-global_detected_seizures,158152,158186,34
Jensen_Eisai_groupA,2,6,ts-global_detected_seizures,158199,158236,37
Jensen_Eisai_groupA,1,5,ts-global_detected_seizures,158257,158282,25
Jensen_Eisai_groupA,2,6,ts-global_detected_seizures,158265,158318,53
Jensen_Eisai_groupA,2,6,ts-global_detected_seizures,158331,158788,457
Jensen_Eisai_groupA,1,5,ts-global_detected_seizures,158379,158411,32
Jensen_Eisai_groupA,1,5,ts-global_detected_seizures,158453,158477,24
Jensen_Eisai_groupA,1,5,ts-global_detected_seizures,158635,158659,24
Jensen_Eisai_groupA,1,5,ts-global_detected_seizures,158729,158776,47
Jensen_Eisai_groupA,1,5,ts-global_detected_seizures,158788,158814,26
Jensen_Eisai_groupA,2,6,ts-global_detected_seizures,158789,159260,471
Jensen_Eisai_groupA,1,5,ts-global_detected_seizures,158833,158881,48
Jensen_Eisai_groupA,1,5,ts-global_detected_seizures,158907,158979,72
Jensen_Eisai_groupA,1,5,ts-global_detected_seizures,159044,159070,26
Jensen_Eisai_groupA,1,5,ts-global_detected_seizures,159155,159239,84
Jensen_Eisai_groupA,1,5,ts-global_detected_seizures,159250,159297,47
Jensen_Eisai_groupA,2,6,ts-global_detected_seizures,159261,159511,250
Jensen_Eisai_groupA,1,5,ts-global_detected_seizures,159303,159390,87
Jensen_Eisai_groupA,1,5,ts-global_detected_seizures,159391,159461,70
Jensen_Eisai_groupA,1,5,ts-global_detected_seizures,159468,159490,22
Jensen_Eisai_groupA,2,6,ts-global_detected_seizures,159513,159556,43
Jensen_Eisai_groupA,1,5,ts-global_detected_seizures,159526,159569,43
Jensen_Eisai_groupA,2,6,ts-global_detected_seizures,159557,159607,50
Jensen_Eisai_groupA,1,5,ts-global_detected_seizures,159571,159621,50
Jensen_Eisai_groupA,2,6,ts-global_detected_seizures,159624,159656,32
Jensen_Eisai_groupA,1,5,ts-global_detected_seizures,159643,159710,67
Jensen_Eisai_groupA,2,6,ts-global_detected_seizures,159657,159925,268
Jensen_Eisai_groupA,1,5,ts-global_detected_seizures,159711,159746,35
Jensen_Eisai_groupA,1,5,ts-global_detected_seizures,159747,159778,31
Jensen_Eisai_groupA,1,5,ts-global_detected_seizures,159803,161089,1286
Jensen_Eisai_groupA,2,6,ts-global_detected_seizures,159926,160118,192
Jensen_Eisai_groupA,2,6,ts-global_detected_seizures,160119,160148,29
Jensen_Eisai_groupA,2,6,ts-global_detected_seizures,160168,160190,22
Jensen_Eisai_groupA,2,6,ts-global_detected_seizures,160287,160331,44
Jensen_Eisai_groupA,2,6,ts-global_detected_seizures,160418,160464,46
Jensen_Eisai_groupA,2,6,ts-global_detected_seizures,160490,160520,30
Jensen_Eisai_groupA,2,6,ts-global_detected_seizures,160540,160579,39
Jensen_Eisai_groupA,2,6,ts-global_detected_seizures,160609,160637,28
Jensen_Eisai_groupA,2,6,ts-global_detected_seizures,160671,160737,66
Jensen_Eisai_groupA,2,6,ts-global_detected_seizures,160740,160768,28
Jensen_Eisai_groupA,2,6,ts-global_detected_seizures,160840,160883,43
Jensen_Eisai_groupA,2,6,ts-global_detected_seizures,160895,160920,25
Jensen_Eisai_groupA,2,6,ts-global_detected_seizures,160961,161068,107
Jensen_Eisai_groupA,1,5,ts-global_detected_seizures,161090,162426,1336
Jensen_Eisai_groupA,2,6,ts-global_detected_seizures,161092,161121,29
Jensen_Eisai_groupA,2,6,ts-global_detected_seizures,161136,161166,30
Jensen_Eisai_groupA,2,6,ts-global_detected_seizures,161220,161262,42
Jensen_Eisai_groupA,2,6,ts-global_detected_seizures,161264,161400,136
Jensen_Eisai_groupA,2,6,ts-global_detected_seizures,161430,161453,23
Jensen_Eisai_groupA,2,6,ts-global_detected_seizures,161481,161505,24
Jensen_Eisai_groupA,2,6,ts-global_detected_seizures,161508,161537,29
Jensen_Eisai_groupA,2,6,ts-global_detected_seizures,161604,161626,22
Jensen_Eisai_groupA,2,6,ts-global_detected_seizures,161663,161690,27
Jensen_Eisai_groupA,2,6,ts-global_detected_seizures,161740,161764,24
Jensen_Eisai_groupA,2,6,ts-global_detected_seizures,161796,161823,27
Jensen_Eisai_groupA,2,6,ts-global_detected_seizures,161844,161877,33
Jensen_Eisai_groupA,2,6,ts-global_detected_seizures,161897,161945,48
Jensen_Eisai_groupA,2,6,ts-global_detected_seizures,161969,162488,519
Jensen_Eisai_groupA,1,5,ts-global_detected_seizures,162427,162666,239
Jensen_Eisai_groupA,2,6,ts-global_detected_seizures,162489,162512,23
Jensen_Eisai_groupA,2,6,ts-global_detected_seizures,162565,162593,28
Jensen_Eisai_groupA,2,6,ts-global_detected_seizures,162597,162648,51
Jensen_Eisai_groupA,1,5,ts-global_detected_seizures,162667,162861,194
Jensen_Eisai_groupA,2,6,ts-global_detected_seizures,162689,162717,28
Jensen_Eisai_groupA,2,6,ts-global_detected_seizures,162753,162780,27
Jensen_Eisai_groupA,2,6,ts-global_detected_seizures,162862,162903,41
Jensen_Eisai_groupA,2,6,ts-global_detected_seizures,162916,162950,34
Jensen_Eisai_groupA,2,6,ts-global_detected_seizures,162975,162997,22
Jensen_Eisai_groupA,2,6,ts-global_detected_seizures,163051,163099,48
Jensen_Eisai_groupA,2,6,ts-global_detected_seizures,163146,163207,61
Jensen_Eisai_groupA,2,6,ts-global_detected_seizures,163219,163252,33
Jensen_Eisai_groupA,2,6,ts-global_detected_seizures,163274,163308,34
Jensen_Eisai_groupA,2,6,ts-global_detected_seizures,163324,163350,26
Jensen_Eisai_groupA,2,6,ts-global_detected_seizures,163380,163413,33
Jensen_Eisai_groupA,2,6,ts-global_detected_seizures,163420,163449,29
Jensen_Eisai_groupA,2,6,ts-global_detected_seizures,163518,163557,39
Jensen_Eisai_groupA,2,6,ts-global_detected_seizures,163558,163699,141
Jensen_Eisai_groupA,2,6,ts-global_detected_seizures,163720,163795,75
Jensen_Eisai_groupA,1,5,ts-global_detected_seizures,163813,163890,77
Jensen_Eisai_groupA,2,6,ts-global_detected_seizures,163820,163846,26
Jensen_Eisai_groupA,1,5,ts-global_detected_seizures,163891,163921,30
Jensen_Eisai_groupA,2,6,ts-global_detected_seizures,163954,163989,35
Jensen_Eisai_groupA,1,5,ts-global_detected_seizures,163983,164005,22
Jensen_Eisai_groupA,2,6,ts-global_detected_seizures,164032,164060,28
Jensen_Eisai_groupA,2,6,ts-global_detected_seizures,164062,164091,29
Jensen_Eisai_groupA,1,5,ts-global_detected_seizures,164074,164737,663
Jensen_Eisai_groupA,2,6,ts-global_detected_seizures,164106,164154,48
Jensen_Eisai_groupA,2,6,ts-global_detected_seizures,164168,164199,31
Jensen_Eisai_groupA,2,6,ts-global_detected_seizures,164200,164312,112
Jensen_Eisai_groupA,2,6,ts-global_detected_seizures,164313,164338,25
Jensen_Eisai_groupA,2,6,ts-global_detected_seizures,164370,164394,24
Jensen_Eisai_groupA,2,6,ts-global_detected_seizures,164406,164428,22
Jensen_Eisai_groupA,2,6,ts-global_detected_seizures,164445,164475,30
Jensen_Eisai_groupA,2,6,ts-global_detected_seizures,164509,164546,37
Jensen_Eisai_groupA,2,6,ts-global_detected_seizures,164601,164632,31
Jensen_Eisai_groupA,2,6,ts-global_detected_seizures,164674,164708,34
Jensen_Eisai_groupA,2,6,ts-global_detected_seizures,164733,164767,34
Jensen_Eisai_groupA,1,5,ts-global_detected_seizures,164738,165074,336
Jensen_Eisai_groupA,2,6,ts-global_detected_seizures,164783,164830,47
Jensen_Eisai_groupA,2,6,ts-global_detected_seizures,164890,164914,24
Jensen_Eisai_groupA,2,6,ts-global_detected_seizures,164919,164957,38
Jensen_Eisai_groupA,2,6,ts-global_detected_seizures,164959,164999,40
Jensen_Eisai_groupA,2,6,ts-global_detected_seizures,165018,165046,28
Jensen_Eisai_groupA,1,5,ts-global_detected_seizures,165075,165128,53
Jensen_Eisai_groupA,2,6,ts-global_detected_seizures,165096,165148,52
Jensen_Eisai_groupA,2,6,ts-global_detected_seizures,165153,165428,275
Jensen_Eisai_groupA,1,5,ts-global_detected_seizures,165183,165230,47
Jensen_Eisai_groupA,1,5,ts-global_detected_seizures,165233,165255,22
Jensen_Eisai_groupA,1,5,ts-global_detected_seizures,165257,165279,22
Jensen_Eisai_groupA,1,5,ts-global_detected_seizures,165340,165383,43
Jensen_Eisai_groupA,1,5,ts-global_detected_seizures,165384,165409,25
Jensen_Eisai_groupA,2,6,ts-global_detected_seizures,165429,165457,28
Jensen_Eisai_groupA,2,6,ts-global_detected_seizures,165458,165508,50
Jensen_Eisai_groupA,2,6,ts-global_detected_seizures,165513,165542,29
Jensen_Eisai_groupA,1,5,ts-global_detected_seizures,165539,165572,33
Jensen_Eisai_groupA,1,5,ts-global_detected_seizures,165586,165617,31
Jensen_Eisai_groupA,2,6,ts-global_detected_seizures,165598,165621,23
Jensen_Eisai_groupA,1,5,ts-global_detected_seizures,165632,165657,25
Jensen_Eisai_groupA,2,6,ts-global_detected_seizures,165633,165677,44
Jensen_Eisai_groupA,1,5,ts-global_detected_seizures,165694,165716,22
Jensen_Eisai_groupA,2,6,ts-global_detected_seizures,165700,165728,28
Jensen_Eisai_groupA,1,5,ts-global_detected_seizures,165747,165783,36
Jensen_Eisai_groupA,2,6,ts-global_detected_seizures,165764,165790,26
Jensen_Eisai_groupA,2,6,ts-global_detected_seizures,165832,165859,27
Jensen_Eisai_groupA,1,5,ts-global_detected_seizures,165865,165887,22
Jensen_Eisai_groupA,2,6,ts-global_detected_seizures,165882,166047,165
Jensen_Eisai_groupA,1,5,ts-global_detected_seizures,165945,166001,56
Jensen_Eisai_groupA,1,5,ts-global_detected_seizures,166024,166142,118
Jensen_Eisai_groupA,2,6,ts-global_detected_seizures,166073,166104,31
Jensen_Eisai_groupA,2,6,ts-global_detected_seizures,166112,166177,65
Jensen_Eisai_groupA,2,6,ts-global_detected_seizures,166182,166209,27
Jensen_Eisai_groupA,1,5,ts-global_detected_seizures,166185,166228,43
Jensen_Eisai_groupA,1,5,ts-global_detected_seizures,166275,166347,72
Jensen_Eisai_groupA,2,6,ts-global_detected_seizures,166280,166310,30
Jensen_Eisai_groupA,2,6,ts-global_detected_seizures,166327,166356,29
Jensen_Eisai_groupA,1,5,ts-global_detected_seizures,166349,166381,32
Jensen_Eisai_groupA,2,6,ts-global_detected_seizures,166376,166663,287
Jensen_Eisai_groupA,1,5,ts-global_detected_seizures,166396,166426,30
Jensen_Eisai_groupA,1,5,ts-global_detected_seizures,166454,166515,61
Jensen_Eisai_groupA,1,5,ts-global_detected_seizures,166536,166566,30
Jensen_Eisai_groupA,1,5,ts-global_detected_seizures,166602,166635,33
Jensen_Eisai_groupA,2,6,ts-global_detected_seizures,166664,166706,42
Jensen_Eisai_groupA,1,5,ts-global_detected_seizures,166694,166719,25
Jensen_Eisai_groupA,2,6,ts-global_detected_seizures,166721,166751,30
Jensen_Eisai_groupA,1,5,ts-global_detected_seizures,166747,166800,53
Jensen_Eisai_groupA,2,6,ts-global_detected_seizures,166752,166780,28
Jensen_Eisai_groupA,2,6,ts-global_detected_seizures,166787,166825,38
Jensen_Eisai_groupA,1,5,ts-global_detected_seizures,166809,166839,30
Jensen_Eisai_groupA,2,6,ts-global_detected_seizures,166846,166897,51
Jensen_Eisai_groupA,1,5,ts-global_detected_seizures,166891,166914,23
Jensen_Eisai_groupA,2,6,ts-global_detected_seizures,166943,167002,59
Jensen_Eisai_groupA,1,5,ts-global_detected_seizures,166948,167049,101
Jensen_Eisai_groupA,1,5,ts-global_detected_seizures,167050,167102,52
Jensen_Eisai_groupA,2,6,ts-global_detected_seizures,167073,167113,40
Jensen_Eisai_groupA,1,5,ts-global_detected_seizures,167103,167131,28
Jensen_Eisai_groupA,1,5,ts-global_detected_seizures,167132,167166,34
Jensen_Eisai_groupA,2,6,ts-global_detected_seizures,167134,167200,66
Jensen_Eisai_groupA,1,5,ts-global_detected_seizures,167167,167194,27
Jensen_Eisai_groupA,1,5,ts-global_detected_seizures,167202,167224,22
Jensen_Eisai_groupA,2,6,ts-global_detected_seizures,167206,167261,55
Jensen_Eisai_groupA,1,5,ts-global_detected_seizures,167226,167250,24
Jensen_Eisai_groupA,1,5,ts-global_detected_seizures,167258,167283,25
Jensen_Eisai_groupA,2,6,ts-global_detected_seizures,167275,167532,257
Jensen_Eisai_groupA,1,5,ts-global_detected_seizures,167293,167334,41
Jensen_Eisai_groupA,1,5,ts-global_detected_seizures,167335,167368,33
Jensen_Eisai_groupA,1,5,ts-global_detected_seizures,167369,167409,40
Jensen_Eisai_groupA,1,5,ts-global_detected_seizures,167425,167476,51
Jensen_Eisai_groupA,2,6,ts-global_detected_seizures,167547,169088,1541
Jensen_Eisai_groupA,1,5,ts-global_detected_seizures,167553,167599,46
Jensen_Eisai_groupA,1,5,ts-global_detected_seizures,167643,167690,47
Jensen_Eisai_groupA,1,5,ts-global_detected_seizures,167706,167749,43
Jensen_Eisai_groupA,1,5,ts-global_detected_seizures,167750,168235,485
Jensen_Eisai_groupA,1,5,ts-global_detected_seizures,168236,171016,2780
Jensen_Eisai_groupA,2,6,ts-global_detected_seizures,169089,169168,79
Jensen_Eisai_groupA,2,6,ts-global_detected_seizures,169169,169488,319
Jensen_Eisai_groupA,2,6,ts-global_detected_seizures,169489,169644,155
Jensen_Eisai_groupA,2,6,ts-global_detected_seizures,169645,170291,646
Jensen_Eisai_groupA,2,6,ts-global_detected_seizures,170292,170801,509
Jensen_Eisai_groupA,2,6,ts-global_detected_seizures,170802,171051,249
Jensen_Eisai_groupA,1,5,ts-global_detected_seizures,171017,171428,411
Jensen_Eisai_groupA,2,6,ts-global_detected_seizures,171052,171423,371
Jensen_Eisai_groupA,2,6,ts-global_detected_seizures,171424,171474,50
Jensen_Eisai_groupA,1,5,ts-global_detected_seizures,171429,171548,119
Jensen_Eisai_groupA,2,6,ts-global_detected_seizures,171475,171548,73
Jensen_Eisai_groupA,4,8,ts-global_detected_seizures,172080,214441,42361
Jensen_Eisai_groupA,1,5,ts-global_detected_seizures,172107,172248,141
Jensen_Eisai_groupA,1,5,ts-global_detected_seizures,172249,172272,23
Jensen_Eisai_groupA,1,5,ts-global_detected_seizures,172273,172306,33
Jensen_Eisai_groupA,2,6,ts-global_detected_seizures,172285,172579,294
Jensen_Eisai_groupA,1,5,ts-global_detected_seizures,172322,172350,28
Jensen_Eisai_groupA,1,5,ts-global_detected_seizures,172352,172506,154
Jensen_Eisai_groupA,1,5,ts-global_detected_seizures,172539,172564,25
Jensen_Eisai_groupA,2,6,ts-global_detected_seizures,172580,172685,105
Jensen_Eisai_groupA,1,5,ts-global_detected_seizures,172626,172863,237
Jensen_Eisai_groupA,2,6,ts-global_detected_seizures,172686,172896,210
Jensen_Eisai_groupA,1,5,ts-global_detected_seizures,172864,172942,78
Jensen_Eisai_groupA,2,6,ts-global_detected_seizures,172897,173089,192
Jensen_Eisai_groupA,1,5,ts-global_detected_seizures,172943,173010,67
Jensen_Eisai_groupA,1,5,ts-global_detected_seizures,173032,173122,90
Jensen_Eisai_groupA,2,6,ts-global_detected_seizures,173090,173122,32
Jensen_Eisai_groupA,2,6,ts-global_detected_seizures,173123,173152,29
Jensen_Eisai_groupA,1,5,ts-global_detected_seizures,173164,173188,24
Jensen_Eisai_groupA,2,6,ts-global_detected_seizures,173218,173371,153
Jensen_Eisai_groupA,1,5,ts-global_detected_seizures,173236,173261,25
Jensen_Eisai_groupA,1,5,ts-global_detected_seizures,173334,173370,36
Jensen_Eisai_groupA,2,6,ts-global_detected_seizures,173372,173540,168
Jensen_Eisai_groupA,1,5,ts-global_detected_seizures,173450,173485,35
Jensen_Eisai_groupA,2,6,ts-global_detected_seizures,173541,173568,27
Jensen_Eisai_groupA,1,5,ts-global_detected_seizures,173551,173590,39
Jensen_Eisai_groupA,2,6,ts-global_detected_seizures,173610,173645,35
Jensen_Eisai_groupA,2,6,ts-global_detected_seizures,173656,173683,27
Jensen_Eisai_groupA,2,6,ts-global_detected_seizures,173689,173734,45
Jensen_Eisai_groupA,1,5,ts-global_detected_seizures,173734,173765,31
Jensen_Eisai_groupA,2,6,ts-global_detected_seizures,173736,173764,28
Jensen_Eisai_groupA,1,5,ts-global_detected_seizures,173787,173810,23
Jensen_Eisai_groupA,2,6,ts-global_detected_seizures,173818,173854,36
Jensen_Eisai_groupA,2,6,ts-global_detected_seizures,173896,173932,36
Jensen_Eisai_groupA,1,5,ts-global_detected_seizures,173920,173945,25
Jensen_Eisai_groupA,1,5,ts-global_detected_seizures,173946,173977,31
Jensen_Eisai_groupA,1,5,ts-global_detected_seizures,173985,174015,30
Jensen_Eisai_groupA,2,6,ts-global_detected_seizures,173990,174031,41
Jensen_Eisai_groupA,1,5,ts-global_detected_seizures,174017,174049,32
Jensen_Eisai_groupA,1,5,ts-global_detected_seizures,174075,174107,32
Jensen_Eisai_groupA,1,5,ts-global_detected_seizures,174108,174138,30
Jensen_Eisai_groupA,2,6,ts-global_detected_seizures,174134,174199,65
Jensen_Eisai_groupA,1,5,ts-global_detected_seizures,174179,174205,26
Jensen_Eisai_groupA,2,6,ts-global_detected_seizures,174220,174248,28
Jensen_Eisai_groupA,1,5,ts-global_detected_seizures,174232,174274,42
Jensen_Eisai_groupA,2,6,ts-global_detected_seizures,174288,174316,28
Jensen_Eisai_groupA,1,5,ts-global_detected_seizures,174308,174340,32
Jensen_Eisai_groupA,1,5,ts-global_detected_seizures,174359,174427,68
Jensen_Eisai_groupA,2,6,ts-global_detected_seizures,174361,174390,29
Jensen_Eisai_groupA,2,6,ts-global_detected_seizures,174426,174477,51
Jensen_Eisai_groupA,1,5,ts-global_detected_seizures,174521,174550,29
Jensen_Eisai_groupA,2,6,ts-global_detected_seizures,174552,174578,26
Jensen_Eisai_groupA,1,5,ts-global_detected_seizures,174585,174612,27
Jensen_Eisai_groupA,1,5,ts-global_detected_seizures,174637,174671,34
Jensen_Eisai_groupA,2,6,ts-global_detected_seizures,174680,174767,87
Jensen_Eisai_groupA,1,5,ts-global_detected_seizures,174685,174736,51
Jensen_Eisai_groupA,1,5,ts-global_detected_seizures,174776,174832,56
Jensen_Eisai_groupA,2,6,ts-global_detected_seizures,174790,174825,35
Jensen_Eisai_groupA,2,6,ts-global_detected_seizures,174848,174883,35
Jensen_Eisai_groupA,1,5,ts-global_detected_seizures,174887,174920,33
Jensen_Eisai_groupA,1,5,ts-global_detected_seizures,174946,175005,59
Jensen_Eisai_groupA,2,6,ts-global_detected_seizures,174957,174981,24
Jensen_Eisai_groupA,2,6,ts-global_detected_seizures,175018,175092,74
Jensen_Eisai_groupA,1,5,ts-global_detected_seizures,175019,175050,31
Jensen_Eisai_groupA,1,5,ts-global_detected_seizures,175055,175078,23
Jensen_Eisai_groupA,2,6,ts-global_detected_seizures,175094,175122,28
Jensen_Eisai_groupA,1,5,ts-global_detected_seizures,175113,175146,33
Jensen_Eisai_groupA,1,5,ts-global_detected_seizures,175164,175194,30
Jensen_Eisai_groupA,2,6,ts-global_detected_seizures,175174,175205,31
Jensen_Eisai_groupA,1,5,ts-global_detected_seizures,175195,175250,55
Jensen_Eisai_groupA,2,6,ts-global_detected_seizures,175214,175263,49
Jensen_Eisai_groupA,2,6,ts-global_detected_seizures,175275,175317,42
Jensen_Eisai_groupA,1,5,ts-global_detected_seizures,175300,175345,45
Jensen_Eisai_groupA,1,5,ts-global_detected_seizures,175300,175345,45
Jensen_Eisai_groupA,1,5,ts-global_detected_seizures,175346,175391,45
Jensen_Eisai_groupA,2,6,ts-global_detected_seizures,175374,175399,25
Jensen_Eisai_groupA,2,6,ts-global_detected_seizures,175409,175439,30
Jensen_Eisai_groupA,1,5,ts-global_detected_seizures,175420,175460,40
Jensen_Eisai_groupA,2,6,ts-global_detected_seizures,175442,175486,44
Jensen_Eisai_groupA,1,5,ts-global_detected_seizures,175477,175553,76
Jensen_Eisai_groupA,2,6,ts-global_detected_seizures,175492,175537,45
Jensen_Eisai_groupA,1,5,ts-global_detected_seizures,175554,175579,25
Jensen_Eisai_groupA,2,6,ts-global_detected_seizures,175557,175605,48
Jensen_Eisai_groupA,1,5,ts-global_detected_seizures,175606,175637,31
Jensen_Eisai_groupA,1,5,ts-global_detected_seizures,175675,175732,57
Jensen_Eisai_groupA,2,6,ts-global_detected_seizures,175723,175756,33
Jensen_Eisai_groupA,1,5,ts-global_detected_seizures,175735,175759,24
Jensen_Eisai_groupA,2,6,ts-global_detected_seizures,175809,175837,28
Jensen_Eisai_groupA,1,5,ts-global_detected_seizures,175814,175840,26
Jensen_Eisai_groupA,1,5,ts-global_detected_seizures,175842,175982,140
Jensen_Eisai_groupA,2,6,ts-global_detected_seizures,175864,175895,31
Jensen_Eisai_groupA,2,6,ts-global_detected_seizures,175896,175920,24
Jensen_Eisai_groupA,2,6,ts-global_detected_seizures,175943,175969,26
Jensen_Eisai_groupA,2,6,ts-global_detected_seizures,175971,175995,24
Jensen_Eisai_groupA,1,5,ts-global_detected_seizures,175983,176031,48
Jensen_Eisai_groupA,2,6,ts-global_detected_seizures,176037,176062,25
Jensen_Eisai_groupA,2,6,ts-global_detected_seizures,176037,176062,25
Jensen_Eisai_groupA,1,5,ts-global_detected_seizures,176065,176112,47
Jensen_Eisai_groupA,2,6,ts-global_detected_seizures,176070,176093,23
Jensen_Eisai_groupA,2,6,ts-global_detected_seizures,176114,176186,72
Jensen_Eisai_groupA,1,5,ts-global_detected_seizures,176145,176258,113
Jensen_Eisai_groupA,2,6,ts-global_detected_seizures,176248,176275,27
Jensen_Eisai_groupA,1,5,ts-global_detected_seizures,176307,176341,34
Jensen_Eisai_groupA,2,6,ts-global_detected_seizures,176308,176339,31
Jensen_Eisai_groupA,2,6,ts-global_detected_seizures,176354,176390,36
Jensen_Eisai_groupA,1,5,ts-global_detected_seizures,176375,176430,55
Jensen_Eisai_groupA,1,5,ts-global_detected_seizures,176431,176502,71
Jensen_Eisai_groupA,2,6,ts-global_detected_seizures,176450,176796,346
Jensen_Eisai_groupA,1,5,ts-global_detected_seizures,176504,176552,48
Jensen_Eisai_groupA,1,5,ts-global_detected_seizures,176553,177453,900
Jensen_Eisai_groupA,2,6,ts-global_detected_seizures,176797,177112,315
Jensen_Eisai_groupA,2,6,ts-global_detected_seizures,177113,177173,60
Jensen_Eisai_groupA,2,6,ts-global_detected_seizures,177174,177220,46
Jensen_Eisai_groupA,2,6,ts-global_detected_seizures,177227,177255,28
Jensen_Eisai_groupA,2,6,ts-global_detected_seizures,177258,177282,24
Jensen_Eisai_groupA,2,6,ts-global_detected_seizures,177288,177321,33
Jensen_Eisai_groupA,2,6,ts-global_detected_seizures,177333,177367,34
Jensen_Eisai_groupA,2,6,ts-global_detected_seizures,177423,177472,49
Jensen_Eisai_groupA,1,5,ts-global_detected_seizures,177454,178707,1253
Jensen_Eisai_groupA,2,6,ts-global_detected_seizures,177482,177505,23
Jensen_Eisai_groupA,2,6,ts-global_detected_seizures,177526,177557,31
Jensen_Eisai_groupA,2,6,ts-global_detected_seizures,177571,177636,65
Jensen_Eisai_groupA,2,6,ts-global_detected_seizures,177704,177736,32
Jensen_Eisai_groupA,2,6,ts-global_detected_seizures,177737,177786,49
Jensen_Eisai_groupA,2,6,ts-global_detected_seizures,177802,177830,28
Jensen_Eisai_groupA,2,6,ts-global_detected_seizures,177836,177864,28
Jensen_Eisai_groupA,2,6,ts-global_detected_seizures,177893,177915,22
Jensen_Eisai_groupA,2,6,ts-global_detected_seizures,177920,177961,41
Jensen_Eisai_groupA,2,6,ts-global_detected_seizures,177997,178023,26
Jensen_Eisai_groupA,2,6,ts-global_detected_seizures,178026,178057,31
Jensen_Eisai_groupA,2,6,ts-global_detected_seizures,178071,178117,46
Jensen_Eisai_groupA,2,6,ts-global_detected_seizures,178125,178148,23
Jensen_Eisai_groupA,2,6,ts-global_detected_seizures,178190,178244,54
Jensen_Eisai_groupA,2,6,ts-global_detected_seizures,178291,178322,31
Jensen_Eisai_groupA,2,6,ts-global_detected_seizures,178357,178403,46
Jensen_Eisai_groupA,2,6,ts-global_detected_seizures,178442,178495,53
Jensen_Eisai_groupA,2,6,ts-global_detected_seizures,178575,178630,55
Jensen_Eisai_groupA,2,6,ts-global_detected_seizures,178649,178737,88
Jensen_Eisai_groupA,1,5,ts-global_detected_seizures,178711,178768,57
Jensen_Eisai_groupA,2,6,ts-global_detected_seizures,178738,178761,23
Jensen_Eisai_groupA,2,6,ts-global_detected_seizures,178763,178797,34
Jensen_Eisai_groupA,1,5,ts-global_detected_seizures,178774,178797,23
Jensen_Eisai_groupA,2,6,ts-global_detected_seizures,178804,178852,48
Jensen_Eisai_groupA,1,5,ts-global_detected_seizures,178843,178894,51
Jensen_Eisai_groupA,2,6,ts-global_detected_seizures,178864,178887,23
Jensen_Eisai_groupA,2,6,ts-global_detected_seizures,178899,178932,33
Jensen_Eisai_groupA,1,5,ts-global_detected_seizures,178931,178967,36
Jensen_Eisai_groupA,2,6,ts-global_detected_seizures,178945,178968,23
Jensen_Eisai_groupA,2,6,ts-global_detected_seizures,178986,179020,34
Jensen_Eisai_groupA,2,6,ts-global_detected_seizures,179047,179074,27
Jensen_Eisai_groupA,1,5,ts-global_detected_seizures,179082,179110,28
Jensen_Eisai_groupA,2,6,ts-global_detected_seizures,179094,179117,23
Jensen_Eisai_groupA,2,6,ts-global_detected_seizures,179160,179233,73
Jensen_Eisai_groupA,1,5,ts-global_detected_seizures,179167,179212,45
Jensen_Eisai_groupA,2,6,ts-global_detected_seizures,179255,179283,28
Jensen_Eisai_groupA,1,5,ts-global_detected_seizures,179264,179320,56
Jensen_Eisai_groupA,2,6,ts-global_detected_seizures,179353,179399,46
Jensen_Eisai_groupA,2,6,ts-global_detected_seizures,179400,179437,37
Jensen_Eisai_groupA,1,5,ts-global_detected_seizures,179436,179503,67
Jensen_Eisai_groupA,2,6,ts-global_detected_seizures,179447,179492,45
Jensen_Eisai_groupA,1,5,ts-global_detected_seizures,179504,179549,45
Jensen_Eisai_groupA,2,6,ts-global_detected_seizures,179530,179641,111
Jensen_Eisai_groupA,1,5,ts-global_detected_seizures,179564,179597,33
Jensen_Eisai_groupA,1,5,ts-global_detected_seizures,179601,179661,60
Jensen_Eisai_groupA,2,6,ts-global_detected_seizures,179649,179681,32
Jensen_Eisai_groupA,1,5,ts-global_detected_seizures,179665,179711,46
Jensen_Eisai_groupA,2,6,ts-global_detected_seizures,179740,179773,33
Jensen_Eisai_groupA,1,5,ts-global_detected_seizures,179749,179785,36
Jensen_Eisai_groupA,2,6,ts-global_detected_seizures,179779,179826,47
Jensen_Eisai_groupA,1,5,ts-global_detected_seizures,179813,179857,44
Jensen_Eisai_groupA,2,6,ts-global_detected_seizures,179841,179866,25
Jensen_Eisai_groupA,2,6,ts-global_detected_seizures,179879,179924,45
Jensen_Eisai_groupA,1,5,ts-global_detected_seizures,179920,179985,65
Jensen_Eisai_groupA,2,6,ts-global_detected_seizures,179941,179963,22
Jensen_Eisai_groupA,2,6,ts-global_detected_seizures,179981,180026,45
Jensen_Eisai_groupA,1,5,ts-global_detected_seizures,180002,180091,89
Jensen_Eisai_groupA,2,6,ts-global_detected_seizures,180027,180050,23
Jensen_Eisai_groupA,2,6,ts-global_detected_seizures,180052,180238,186
Jensen_Eisai_groupA,1,5,ts-global_detected_seizures,180145,180233,88
Jensen_Eisai_groupA,1,5,ts-global_detected_seizures,180235,180345,110
Jensen_Eisai_groupA,2,6,ts-global_detected_seizures,180239,180305,66
Jensen_Eisai_groupA,2,6,ts-global_detected_seizures,180309,180357,48
Jensen_Eisai_groupA,2,6,ts-global_detected_seizures,180358,180442,84
Jensen_Eisai_groupA,1,5,ts-global_detected_seizures,180367,180430,63
Jensen_Eisai_groupA,2,6,ts-global_detected_seizures,180490,181110,620
Jensen_Eisai_groupA,1,5,ts-global_detected_seizures,180507,180600,93
Jensen_Eisai_groupA,1,5,ts-global_detected_seizures,180603,180647,44
Jensen_Eisai_groupA,1,5,ts-global_detected_seizures,180648,180694,46
Jensen_Eisai_groupA,1,5,ts-global_detected_seizures,180705,180755,50
Jensen_Eisai_groupA,1,5,ts-global_detected_seizures,180757,180805,48
Jensen_Eisai_groupA,1,5,ts-global_detected_seizures,180827,180867,40
Jensen_Eisai_groupA,1,5,ts-global_detected_seizures,180882,180925,43
Jensen_Eisai_groupA,1,5,ts-global_detected_seizures,180926,180988,62
Jensen_Eisai_groupA,1,5,ts-global_detected_seizures,181012,181065,53
Jensen_Eisai_groupA,1,5,ts-global_detected_seizures,181066,181110,44
Jensen_Eisai_groupA,1,5,ts-global_detected_seizures,181114,181153,39
Jensen_Eisai_groupA,2,6,ts-global_detected_seizures,181119,181224,105
Jensen_Eisai_groupA,1,5,ts-global_detected_seizures,181163,181255,92
Jensen_Eisai_groupA,2,6,ts-global_detected_seizures,181225,181252,27
Jensen_Eisai_groupA,1,5,ts-global_detected_seizures,181256,181369,113
Jensen_Eisai_groupA,2,6,ts-global_detected_seizures,181262,181381,119
Jensen_Eisai_groupA,1,5,ts-global_detected_seizures,181380,181455,75
Jensen_Eisai_groupA,2,6,ts-global_detected_seizures,181382,181419,37
Jensen_Eisai_groupA,2,6,ts-global_detected_seizures,181420,181589,169
Jensen_Eisai_groupA,1,5,ts-global_detected_seizures,181456,181541,85
Jensen_Eisai_groupA,1,5,ts-global_detected_seizures,181542,181598,56
Jensen_Eisai_groupA,2,6,ts-global_detected_seizures,181616,181660,44
Jensen_Eisai_groupA,1,5,ts-global_detected_seizures,181618,181943,325
Jensen_Eisai_groupA,2,6,ts-global_detected_seizures,181695,181741,46
Jensen_Eisai_groupA,2,6,ts-global_detected_seizures,181756,181788,32
Jensen_Eisai_groupA,2,6,ts-global_detected_seizures,181800,181827,27
Jensen_Eisai_groupA,2,6,ts-global_detected_seizures,181841,181863,22
Jensen_Eisai_groupA,2,6,ts-global_detected_seizures,181965,182011,46
Jensen_Eisai_groupA,1,5,ts-global_detected_seizures,181982,183962,1980
Jensen_Eisai_groupA,2,6,ts-global_detected_seizures,182070,182137,67
Jensen_Eisai_groupA,2,6,ts-global_detected_seizures,182179,182208,29
Jensen_Eisai_groupA,2,6,ts-global_detected_seizures,182218,182263,45
Jensen_Eisai_groupA,2,6,ts-global_detected_seizures,182270,182293,23
Jensen_Eisai_groupA,2,6,ts-global_detected_seizures,182306,182345,39
Jensen_Eisai_groupA,2,6,ts-global_detected_seizures,182374,182429,55
Jensen_Eisai_groupA,2,6,ts-global_detected_seizures,182471,182511,40
Jensen_Eisai_groupA,2,6,ts-global_detected_seizures,182524,182652,128
Jensen_Eisai_groupA,2,6,ts-global_detected_seizures,182653,183269,616
Jensen_Eisai_groupA,2,6,ts-global_detected_seizures,183289,183327,38
Jensen_Eisai_groupA,2,6,ts-global_detected_seizures,183328,183351,23
Jensen_Eisai_groupA,2,6,ts-global_detected_seizures,183352,183389,37
Jensen_Eisai_groupA,2,6,ts-global_detected_seizures,183443,183508,65
Jensen_Eisai_groupA,2,6,ts-global_detected_seizures,183510,183539,29
Jensen_Eisai_groupA,2,6,ts-global_detected_seizures,183581,183606,25
Jensen_Eisai_groupA,2,6,ts-global_detected_seizures,183617,183652,35
Jensen_Eisai_groupA,2,6,ts-global_detected_seizures,183664,183686,22
Jensen_Eisai_groupA,2,6,ts-global_detected_seizures,183771,183809,38
Jensen_Eisai_groupA,2,6,ts-global_detected_seizures,183855,183900,45
Jensen_Eisai_groupA,2,6,ts-global_detected_seizures,183912,183948,36
Jensen_Eisai_groupA,1,5,ts-global_detected_seizures,184012,184048,36
Jensen_Eisai_groupA,2,6,ts-global_detected_seizures,184021,184053,32
Jensen_Eisai_groupA,1,5,ts-global_detected_seizures,184058,184092,34
Jensen_Eisai_groupA,2,6,ts-global_detected_seizures,184085,184137,52
Jensen_Eisai_groupA,1,5,ts-global_detected_seizures,184146,184210,64
Jensen_Eisai_groupA,2,6,ts-global_detected_seizures,184182,184229,47
Jensen_Eisai_groupA,2,6,ts-global_detected_seizures,184236,184258,22
Jensen_Eisai_groupA,1,5,ts-global_detected_seizures,184283,184332,49
Jensen_Eisai_groupA,2,6,ts-global_detected_seizures,184313,184352,39
Jensen_Eisai_groupA,1,5,ts-global_detected_seizures,184335,184371,36
Jensen_Eisai_groupA,2,6,ts-global_detected_seizures,184358,184397,39
Jensen_Eisai_groupA,1,5,ts-global_detected_seizures,184400,184429,29
Jensen_Eisai_groupA,2,6,ts-global_detected_seizures,184414,184453,39
Jensen_Eisai_groupA,2,6,ts-global_detected_seizures,184466,184514,48
Jensen_Eisai_groupA,1,5,ts-global_detected_seizures,184495,184550,55
Jensen_Eisai_groupA,1,5,ts-global_detected_seizures,184564,184595,31
Jensen_Eisai_groupA,2,6,ts-global_detected_seizures,184582,184631,49
Jensen_Eisai_groupA,1,5,ts-global_detected_seizures,184599,184638,39
Jensen_Eisai_groupA,1,5,ts-global_detected_seizures,184712,184754,42
Jensen_Eisai_groupA,2,6,ts-global_detected_seizures,184722,184751,29
Jensen_Eisai_groupA,2,6,ts-global_detected_seizures,184752,184804,52
Jensen_Eisai_groupA,2,6,ts-global_detected_seizures,184805,184828,23
Jensen_Eisai_groupA,1,5,ts-global_detected_seizures,184822,184898,76
Jensen_Eisai_groupA,2,6,ts-global_detected_seizures,184885,184946,61
Jensen_Eisai_groupA,1,5,ts-global_detected_seizures,184905,185035,130
Jensen_Eisai_groupA,2,6,ts-global_detected_seizures,184968,185014,46
Jensen_Eisai_groupA,2,6,ts-global_detected_seizures,185021,185065,44
Jensen_Eisai_groupA,1,5,ts-global_detected_seizures,185036,185064,28
Jensen_Eisai_groupA,2,6,ts-global_detected_seizures,185068,185099,31
Jensen_Eisai_groupA,1,5,ts-global_detected_seizures,185072,185105,33
Jensen_Eisai_groupA,2,6,ts-global_detected_seizures,185100,185124,24
Jensen_Eisai_groupA,1,5,ts-global_detected_seizures,185121,185188,67
Jensen_Eisai_groupA,2,6,ts-global_detected_seizures,185127,185180,53
Jensen_Eisai_groupA,2,6,ts-global_detected_seizures,185213,185242,29
Jensen_Eisai_groupA,1,5,ts-global_detected_seizures,185226,185269,43
Jensen_Eisai_groupA,1,5,ts-global_detected_seizures,185314,185358,44
Jensen_Eisai_groupA,2,6,ts-global_detected_seizures,185326,185824,498
Jensen_Eisai_groupA,1,5,ts-global_detected_seizures,185385,185409,24
Jensen_Eisai_groupA,1,5,ts-global_detected_seizures,185410,185650,240
Jensen_Eisai_groupA,1,5,ts-global_detected_seizures,185655,185689,34
Jensen_Eisai_groupA,1,5,ts-global_detected_seizures,185691,185749,58
Jensen_Eisai_groupA,1,5,ts-global_detected_seizures,185758,185804,46
Jensen_Eisai_groupA,1,5,ts-global_detected_seizures,185805,185836,31
Jensen_Eisai_groupA,2,6,ts-global_detected_seizures,185848,185891,43
Jensen_Eisai_groupA,1,5,ts-global_detected_seizures,185879,185933,54
Jensen_Eisai_groupA,2,6,ts-global_detected_seizures,185901,185931,30
Jensen_Eisai_groupA,1,5,ts-global_detected_seizures,185934,185958,24
Jensen_Eisai_groupA,1,5,ts-global_detected_seizures,185959,186017,58
Jensen_Eisai_groupA,2,6,ts-global_detected_seizures,186009,186043,34
Jensen_Eisai_groupA,1,5,ts-global_detected_seizures,186018,186127,109
Jensen_Eisai_groupA,2,6,ts-global_detected_seizures,186076,186099,23
Jensen_Eisai_groupA,2,6,ts-global_detected_seizures,186101,186158,57
Jensen_Eisai_groupA,1,5,ts-global_detected_seizures,186128,186259,131
Jensen_Eisai_groupA,2,6,ts-global_detected_seizures,186160,186183,23
Jensen_Eisai_groupA,2,6,ts-global_detected_seizures,186216,186239,23
Jensen_Eisai_groupA,2,6,ts-global_detected_seizures,186244,186278,34
Jensen_Eisai_groupA,1,5,ts-global_detected_seizures,186260,186300,40
Jensen_Eisai_groupA,2,6,ts-global_detected_seizures,186292,186324,32
Jensen_Eisai_groupA,1,5,ts-global_detected_seizures,186316,186346,30
Jensen_Eisai_groupA,2,6,ts-global_detected_seizures,186338,186368,30
Jensen_Eisai_groupA,2,6,ts-global_detected_seizures,186389,186415,26
Jensen_Eisai_groupA,1,5,ts-global_detected_seizures,186404,186451,47
Jensen_Eisai_groupA,2,6,ts-global_detected_seizures,186423,186475,52
Jensen_Eisai_groupA,2,6,ts-global_detected_seizures,186476,186566,90
Jensen_Eisai_groupA,1,5,ts-global_detected_seizures,186483,186574,91
Jensen_Eisai_groupA,2,6,ts-global_detected_seizures,186568,186597,29
Jensen_Eisai_groupA,2,6,ts-global_detected_seizures,186598,186631,33
Jensen_Eisai_groupA,2,6,ts-global_detected_seizures,186636,186668,32
Jensen_Eisai_groupA,1,5,ts-global_detected_seizures,186653,186678,25
Jensen_Eisai_groupA,1,5,ts-global_detected_seizures,186679,186745,66
Jensen_Eisai_groupA,2,6,ts-global_detected_seizures,186689,186726,37
Jensen_Eisai_groupA,2,6,ts-global_detected_seizures,186734,186767,33
Jensen_Eisai_groupA,1,5,ts-global_detected_seizures,186746,187027,281
Jensen_Eisai_groupA,2,6,ts-global_detected_seizures,186781,187477,696
Jensen_Eisai_groupA,1,5,ts-global_detected_seizures,187040,187075,35
Jensen_Eisai_groupA,1,5,ts-global_detected_seizures,187103,187134,31
Jensen_Eisai_groupA,1,5,ts-global_detected_seizures,187150,187175,25
Jensen_Eisai_groupA,1,5,ts-global_detected_seizures,187194,187237,43
Jensen_Eisai_groupA,1,5,ts-global_detected_seizures,187261,187292,31
Jensen_Eisai_groupA,1,5,ts-global_detected_seizures,187342,187383,41
Jensen_Eisai_groupA,1,5,ts-global_detected_seizures,187456,187532,76
Jensen_Eisai_groupA,2,6,ts-global_detected_seizures,187478,187548,70
Jensen_Eisai_groupA,1,5,ts-global_detected_seizures,187534,187587,53
Jensen_Eisai_groupA,2,6,ts-global_detected_seizures,187549,187613,64
Jensen_Eisai_groupA,1,5,ts-global_detected_seizures,187596,187636,40
Jensen_Eisai_groupA,2,6,ts-global_detected_seizures,187621,187647,26
Jensen_Eisai_groupA,1,5,ts-global_detected_seizures,187655,187795,140
Jensen_Eisai_groupA,2,6,ts-global_detected_seizures,187666,187692,26
Jensen_Eisai_groupA,2,6,ts-global_detected_seizures,187725,187754,29
Jensen_Eisai_groupA,2,6,ts-global_detected_seizures,187764,187791,27
Jensen_Eisai_groupA,2,6,ts-global_detected_seizures,187811,187856,45
Jensen_Eisai_groupA,1,5,ts-global_detected_seizures,187817,187925,108
Jensen_Eisai_groupA,2,6,ts-global_detected_seizures,187889,187918,29
Jensen_Eisai_groupA,2,6,ts-global_detected_seizures,187925,187960,35
Jensen_Eisai_groupA,1,5,ts-global_detected_seizures,187956,188030,74
Jensen_Eisai_groupA,2,6,ts-global_detected_seizures,187969,187997,28
Jensen_Eisai_groupA,2,6,ts-global_detected_seizures,188005,188030,25
Jensen_Eisai_groupA,1,5,ts-global_detected_seizures,188043,188098,55
Jensen_Eisai_groupA,2,6,ts-global_detected_seizures,188058,188087,29
Jensen_Eisai_groupA,1,5,ts-global_detected_seizures,188107,188131,24
Jensen_Eisai_groupA,1,5,ts-global_detected_seizures,188142,188216,74
Jensen_Eisai_groupA,2,6,ts-global_detected_seizures,188147,188212,65
Jensen_Eisai_groupA,2,6,ts-global_detected_seizures,188213,188246,33
Jensen_Eisai_groupA,1,5,ts-global_detected_seizures,188232,188283,51
Jensen_Eisai_groupA,2,6,ts-global_detected_seizures,188274,188309,35
Jensen_Eisai_groupA,1,5,ts-global_detected_seizures,188301,188332,31
Jensen_Eisai_groupA,2,6,ts-global_detected_seizures,188311,188346,35
Jensen_Eisai_groupA,1,5,ts-global_detected_seizures,188333,188701,368
Jensen_Eisai_groupA,2,6,ts-global_detected_seizures,188413,188455,42
Jensen_Eisai_groupA,2,6,ts-global_detected_seizures,188510,188545,35
Jensen_Eisai_groupA,2,6,ts-global_detected_seizures,188556,188614,58
Jensen_Eisai_groupA,2,6,ts-global_detected_seizures,188616,188683,67
Jensen_Eisai_groupA,2,6,ts-global_detected_seizures,188684,188713,29
Jensen_Eisai_groupA,1,5,ts-global_detected_seizures,188702,188748,46
Jensen_Eisai_groupA,2,6,ts-global_detected_seizures,188770,188934,164
Jensen_Eisai_groupA,1,5,ts-global_detected_seizures,188797,188871,74
Jensen_Eisai_groupA,1,5,ts-global_detected_seizures,188893,188925,32
Jensen_Eisai_groupA,1,5,ts-global_detected_seizures,188933,188979,46
Jensen_Eisai_groupA,2,6,ts-global_detected_seizures,188935,188960,25
Jensen_Eisai_groupA,2,6,ts-global_detected_seizures,188961,188986,25
Jensen_Eisai_groupA,1,5,ts-global_detected_seizures,188980,189178,198
Jensen_Eisai_groupA,2,6,ts-global_detected_seizures,188992,189069,77
Jensen_Eisai_groupA,2,6,ts-global_detected_seizures,189186,189216,30
Jensen_Eisai_groupA,2,6,ts-global_detected_seizures,189237,189263,26
Jensen_Eisai_groupA,1,5,ts-global_detected_seizures,189249,189289,40
Jensen_Eisai_groupA,2,6,ts-global_detected_seizures,189270,189310,40
Jensen_Eisai_groupA,1,5,ts-global_detected_seizures,189320,189368,48
Jensen_Eisai_groupA,2,6,ts-global_detected_seizures,189358,189381,23
Jensen_Eisai_groupA,1,5,ts-global_detected_seizures,189424,189536,112
Jensen_Eisai_groupA,2,6,ts-global_detected_seizures,189476,189524,48
Jensen_Eisai_groupA,1,5,ts-global_detected_seizures,189537,189582,45
Jensen_Eisai_groupA,2,6,ts-global_detected_seizures,189551,189590,39
Jensen_Eisai_groupA,1,5,ts-global_detected_seizures,189583,189645,62
Jensen_Eisai_groupA,2,6,ts-global_detected_seizures,189621,189643,22
Jensen_Eisai_groupA,1,5,ts-global_detected_seizures,189650,189711,61
Jensen_Eisai_groupA,2,6,ts-global_detected_seizures,189659,189707,48
Jensen_Eisai_groupA,1,5,ts-global_detected_seizures,189712,189814,102
Jensen_Eisai_groupA,2,6,ts-global_detected_seizures,189720,189783,63
Jensen_Eisai_groupA,2,6,ts-global_detected_seizures,189784,189862,78
Jensen_Eisai_groupA,1,5,ts-global_detected_seizures,189840,190534,694
Jensen_Eisai_groupA,2,6,ts-global_detected_seizures,189873,189910,37
Jensen_Eisai_groupA,2,6,ts-global_detected_seizures,189935,189963,28
Jensen_Eisai_groupA,2,6,ts-global_detected_seizures,189978,190066,88
Jensen_Eisai_groupA,2,6,ts-global_detected_seizures,190079,190103,24
Jensen_Eisai_groupA,2,6,ts-global_detected_seizures,190257,190283,26
Jensen_Eisai_groupA,2,6,ts-global_detected_seizures,190312,190367,55
Jensen_Eisai_groupA,2,6,ts-global_detected_seizures,190408,190433,25
Jensen_Eisai_groupA,2,6,ts-global_detected_seizures,190459,190486,27
Jensen_Eisai_groupA,2,6,ts-global_detected_seizures,190487,190510,23
Jensen_Eisai_groupA,1,5,ts-global_detected_seizures,190535,191945,1410
Jensen_Eisai_groupA,2,6,ts-global_detected_seizures,190545,190584,39
Jensen_Eisai_groupA,2,6,ts-global_detected_seizures,190635,190772,137
Jensen_Eisai_groupA,2,6,ts-global_detected_seizures,190838,190871,33
Jensen_Eisai_groupA,2,6,ts-global_detected_seizures,190877,190901,24
Jensen_Eisai_groupA,2,6,ts-global_detected_seizures,190928,190956,28
Jensen_Eisai_groupA,2,6,ts-global_detected_seizures,190979,191028,49
Jensen_Eisai_groupA,2,6,ts-global_detected_seizures,191054,191694,640
Jensen_Eisai_groupA,2,6,ts-global_detected_seizures,191769,191797,28
Jensen_Eisai_groupA,2,6,ts-global_detected_seizures,191802,191825,23
Jensen_Eisai_groupA,2,6,ts-global_detected_seizures,191828,191851,23
Jensen_Eisai_groupA,2,6,ts-global_detected_seizures,191863,191901,38
Jensen_Eisai_groupA,2,6,ts-global_detected_seizures,191913,191947,34
Jensen_Eisai_groupA,1,5,ts-global_detected_seizures,191946,192388,442
Jensen_Eisai_groupA,2,6,ts-global_detected_seizures,191991,192047,56
Jensen_Eisai_groupA,2,6,ts-global_detected_seizures,192144,192201,57
Jensen_Eisai_groupA,2,6,ts-global_detected_seizures,192220,192252,32
Jensen_Eisai_groupA,2,6,ts-global_detected_seizures,192280,192308,28
Jensen_Eisai_groupA,2,6,ts-global_detected_seizures,192361,192407,46
Jensen_Eisai_groupA,1,5,ts-global_detected_seizures,192389,192464,75
Jensen_Eisai_groupA,2,6,ts-global_detected_seizures,192429,192458,29
Jensen_Eisai_groupA,2,6,ts-global_detected_seizures,192488,192526,38
Jensen_Eisai_groupA,2,6,ts-global_detected_seizures,192532,192557,25
Jensen_Eisai_groupA,1,5,ts-global_detected_seizures,192559,192614,55
Jensen_Eisai_groupA,2,6,ts-global_detected_seizures,192562,192645,83
Jensen_Eisai_groupA,1,5,ts-global_detected_seizures,192625,192674,49
Jensen_Eisai_groupA,2,6,ts-global_detected_seizures,192695,192721,26
Jensen_Eisai_groupA,1,5,ts-global_detected_seizures,192725,192763,38
Jensen_Eisai_groupA,1,5,ts-global_detected_seizures,192765,192802,37
Jensen_Eisai_groupA,2,6,ts-global_detected_seizures,192786,192821,35
Jensen_Eisai_groupA,1,5,ts-global_detected_seizures,192835,192868,33
Jensen_Eisai_groupA,2,6,ts-global_detected_seizures,192844,192914,70
Jensen_Eisai_groupA,1,5,ts-global_detected_seizures,192887,192931,44
Jensen_Eisai_groupA,2,6,ts-global_detected_seizures,192915,193035,120
Jensen_Eisai_groupA,2,6,ts-global_detected_seizures,193036,193060,24
Jensen_Eisai_groupA,1,5,ts-global_detected_seizures,193058,193098,40
Jensen_Eisai_groupA,2,6,ts-global_detected_seizures,193070,193101,31
Jensen_Eisai_groupA,1,5,ts-global_detected_seizures,193103,193208,105
Jensen_Eisai_groupA,2,6,ts-global_detected_seizures,193105,193144,39
Jensen_Eisai_groupA,2,6,ts-global_detected_seizures,193193,193234,41
Jensen_Eisai_groupA,1,5,ts-global_detected_seizures,193214,193290,76
Jensen_Eisai_groupA,2,6,ts-global_detected_seizures,193266,193300,34
Jensen_Eisai_groupA,1,5,ts-global_detected_seizures,193307,193343,36
Jensen_Eisai_groupA,2,6,ts-global_detected_seizures,193318,193348,30
Jensen_Eisai_groupA,1,5,ts-global_detected_seizures,193356,193397,41
Jensen_Eisai_groupA,2,6,ts-global_detected_seizures,193367,193409,42
Jensen_Eisai_groupA,1,5,ts-global_detected_seizures,193398,193442,44
Jensen_Eisai_groupA,2,6,ts-global_detected_seizures,193427,193451,24
Jensen_Eisai_groupA,1,5,ts-global_detected_seizures,193462,193511,49
Jensen_Eisai_groupA,2,6,ts-global_detected_seizures,193486,193524,38
Jensen_Eisai_groupA,2,6,ts-global_detected_seizures,193562,193606,44
Jensen_Eisai_groupA,1,5,ts-global_detected_seizures,193603,193672,69
Jensen_Eisai_groupA,2,6,ts-global_detected_seizures,193640,193674,34
Jensen_Eisai_groupA,2,6,ts-global_detected_seizures,193705,193730,25
Jensen_Eisai_groupA,1,5,ts-global_detected_seizures,193725,193788,63
Jensen_Eisai_groupA,2,6,ts-global_detected_seizures,193731,193760,29
Jensen_Eisai_groupA,2,6,ts-global_detected_seizures,193779,193816,37
Jensen_Eisai_groupA,1,5,ts-global_detected_seizures,193789,193812,23
Jensen_Eisai_groupA,1,5,ts-global_detected_seizures,193813,193878,65
Jensen_Eisai_groupA,2,6,ts-global_detected_seizures,193839,193911,72
Jensen_Eisai_groupA,1,5,ts-global_detected_seizures,193882,193910,28
Jensen_Eisai_groupA,1,5,ts-global_detected_seizures,193921,193955,34
Jensen_Eisai_groupA,2,6,ts-global_detected_seizures,193967,193994,27
Jensen_Eisai_groupA,1,5,ts-global_detected_seizures,193989,194012,23
Jensen_Eisai_groupA,2,6,ts-global_detected_seizures,194038,194471,433
Jensen_Eisai_groupA,1,5,ts-global_detected_seizures,194052,194131,79
Jensen_Eisai_groupA,1,5,ts-global_detected_seizures,194194,194244,50
Jensen_Eisai_groupA,1,5,ts-global_detected_seizures,194303,194346,43
Jensen_Eisai_groupA,1,5,ts-global_detected_seizures,194382,194413,31
Jensen_Eisai_groupA,1,5,ts-global_detected_seizures,194414,194436,22
Jensen_Eisai_groupA,1,5,ts-global_detected_seizures,194437,194520,83
Jensen_Eisai_groupA,2,6,ts-global_detected_seizures,194472,194519,47
Jensen_Eisai_groupA,2,6,ts-global_detected_seizures,194520,194566,46
Jensen_Eisai_groupA,1,5,ts-global_detected_seizures,194552,194583,31
Jensen_Eisai_groupA,2,6,ts-global_detected_seizures,194590,194642,52
Jensen_Eisai_groupA,1,5,ts-global_detected_seizures,194592,194647,55
Jensen_Eisai_groupA,1,5,ts-global_detected_seizures,194668,194733,65
Jensen_Eisai_groupA,2,6,ts-global_detected_seizures,194690,194715,25
Jensen_Eisai_groupA,2,6,ts-global_detected_seizures,194753,194820,67
Jensen_Eisai_groupA,1,5,ts-global_detected_seizures,194759,194795,36
Jensen_Eisai_groupA,1,5,ts-global_detected_seizures,194796,194975,179
Jensen_Eisai_groupA,2,6,ts-global_detected_seizures,194850,194890,40
Jensen_Eisai_groupA,1,5,ts-global_detected_seizures,194976,195014,38
Jensen_Eisai_groupA,2,6,ts-global_detected_seizures,194979,195011,32
Jensen_Eisai_groupA,2,6,ts-global_detected_seizures,195012,195071,59
Jensen_Eisai_groupA,1,5,ts-global_detected_seizures,195026,195093,67
Jensen_Eisai_groupA,2,6,ts-global_detected_seizures,195106,195140,34
Jensen_Eisai_groupA,1,5,ts-global_detected_seizures,195109,195172,63
Jensen_Eisai_groupA,2,6,ts-global_detected_seizures,195155,195195,40
Jensen_Eisai_groupA,1,5,ts-global_detected_seizures,195174,195207,33
Jensen_Eisai_groupA,2,6,ts-global_detected_seizures,195230,195266,36
Jensen_Eisai_groupA,2,6,ts-global_detected_seizures,195302,195370,68
Jensen_Eisai_groupA,1,5,ts-global_detected_seizures,195304,195439,135
Jensen_Eisai_groupA,2,6,ts-global_detected_seizures,195436,195460,24
Jensen_Eisai_groupA,1,5,ts-global_detected_seizures,195465,195491,26
Jensen_Eisai_groupA,1,5,ts-global_detected_seizures,195508,195555,47
Jensen_Eisai_groupA,2,6,ts-global_detected_seizures,195552,195612,60
Jensen_Eisai_groupA,1,5,ts-global_detected_seizures,195583,195662,79
Jensen_Eisai_groupA,2,6,ts-global_detected_seizures,195613,195636,23
Jensen_Eisai_groupA,2,6,ts-global_detected_seizures,195663,195723,60
Jensen_Eisai_groupA,1,5,ts-global_detected_seizures,195669,195708,39
Jensen_Eisai_groupA,1,5,ts-global_detected_seizures,195724,195800,76
Jensen_Eisai_groupA,2,6,ts-global_detected_seizures,195732,195783,51
Jensen_Eisai_groupA,1,5,ts-global_detected_seizures,195807,195846,39
Jensen_Eisai_groupA,2,6,ts-global_detected_seizures,195824,195872,48
Jensen_Eisai_groupA,1,5,ts-global_detected_seizures,195870,195956,86
Jensen_Eisai_groupA,2,6,ts-global_detected_seizures,195924,195951,27
Jensen_Eisai_groupA,2,6,ts-global_detected_seizures,195957,195989,32
Jensen_Eisai_groupA,1,5,ts-global_detected_seizures,195999,196038,39
Jensen_Eisai_groupA,2,6,ts-global_detected_seizures,196038,196086,48
Jensen_Eisai_groupA,1,5,ts-global_detected_seizures,196070,196149,79
Jensen_Eisai_groupA,2,6,ts-global_detected_seizures,196116,196140,24
Jensen_Eisai_groupA,2,6,ts-global_detected_seizures,196169,196205,36
Jensen_Eisai_groupA,1,5,ts-global_detected_seizures,196173,196205,32
Jensen_Eisai_groupA,1,5,ts-global_detected_seizures,196216,196289,73
Jensen_Eisai_groupA,2,6,ts-global_detected_seizures,196251,196273,22
Jensen_Eisai_groupA,1,5,ts-global_detected_seizures,196294,196366,72
Jensen_Eisai_groupA,2,6,ts-global_detected_seizures,196299,196327,28
Jensen_Eisai_groupA,2,6,ts-global_detected_seizures,196371,196425,54
Jensen_Eisai_groupA,1,5,ts-global_detected_seizures,196378,196409,31
Jensen_Eisai_groupA,1,5,ts-global_detected_seizures,196413,196483,70
Jensen_Eisai_groupA,2,6,ts-global_detected_seizures,196440,196471,31
Jensen_Eisai_groupA,2,6,ts-global_detected_seizures,196486,196516,30
Jensen_Eisai_groupA,1,5,ts-global_detected_seizures,196487,196515,28
Jensen_Eisai_groupA,1,5,ts-global_detected_seizures,196520,196553,33
Jensen_Eisai_groupA,2,6,ts-global_detected_seizures,196550,196579,29
Jensen_Eisai_groupA,1,5,ts-global_detected_seizures,196561,196605,44
Jensen_Eisai_groupA,2,6,ts-global_detected_seizures,196601,196646,45
Jensen_Eisai_groupA,1,5,ts-global_detected_seizures,196609,196682,73
Jensen_Eisai_groupA,2,6,ts-global_detected_seizures,196659,196684,25
Jensen_Eisai_groupA,1,5,ts-global_detected_seizures,196724,196770,46
Jensen_Eisai_groupA,2,6,ts-global_detected_seizures,196744,196779,35
Jensen_Eisai_groupA,1,5,ts-global_detected_seizures,196795,196918,123
Jensen_Eisai_groupA,2,6,ts-global_detected_seizures,196919,196961,42
Jensen_Eisai_groupA,2,6,ts-global_detected_seizures,196997,197027,30
Jensen_Eisai_groupA,1,5,ts-global_detected_seizures,197003,197060,57
Jensen_Eisai_groupA,2,6,ts-global_detected_seizures,197028,197059,31
Jensen_Eisai_groupA,1,5,ts-global_detected_seizures,197074,197166,92
Jensen_Eisai_groupA,2,6,ts-global_detected_seizures,197085,197515,430
Jensen_Eisai_groupA,1,5,ts-global_detected_seizures,197170,197246,76
Jensen_Eisai_groupA,1,5,ts-global_detected_seizures,197257,197316,59
Jensen_Eisai_groupA,1,5,ts-global_detected_seizures,197332,197451,119
Jensen_Eisai_groupA,1,5,ts-global_detected_seizures,197494,199337,1843
Jensen_Eisai_groupA,2,6,ts-global_detected_seizures,197519,197557,38
Jensen_Eisai_groupA,2,6,ts-global_detected_seizures,197558,197683,125
Jensen_Eisai_groupA,2,6,ts-global_detected_seizures,197694,197726,32
Jensen_Eisai_groupA,2,6,ts-global_detected_seizures,197750,197787,37
Jensen_Eisai_groupA,2,6,ts-global_detected_seizures,197823,197847,24
Jensen_Eisai_groupA,2,6,ts-global_detected_seizures,197872,197902,30
Jensen_Eisai_groupA,2,6,ts-global_detected_seizures,197971,197999,28
Jensen_Eisai_groupA,2,6,ts-global_detected_seizures,198056,198083,27
Jensen_Eisai_groupA,2,6,ts-global_detected_seizures,198084,198111,27
Jensen_Eisai_groupA,2,6,ts-global_detected_seizures,198170,198194,24
Jensen_Eisai_groupA,2,6,ts-global_detected_seizures,198196,198231,35
Jensen_Eisai_groupA,2,6,ts-global_detected_seizures,198260,198383,123
Jensen_Eisai_groupA,2,6,ts-global_detected_seizures,198384,198413,29
Jensen_Eisai_groupA,2,6,ts-global_detected_seizures,198445,198469,24
Jensen_Eisai_groupA,2,6,ts-global_detected_seizures,198494,198518,24
Jensen_Eisai_groupA,2,6,ts-global_detected_seizures,198537,198571,34
Jensen_Eisai_groupA,2,6,ts-global_detected_seizures,198572,198697,125
Jensen_Eisai_groupA,2,6,ts-global_detected_seizures,198702,198846,144
Jensen_Eisai_groupA,2,6,ts-global_detected_seizures,198847,198875,28
Jensen_Eisai_groupA,2,6,ts-global_detected_seizures,198899,198939,40
Jensen_Eisai_groupA,2,6,ts-global_detected_seizures,198980,199007,27
Jensen_Eisai_groupA,2,6,ts-global_detected_seizures,199089,199135,46
Jensen_Eisai_groupA,2,6,ts-global_detected_seizures,199175,199218,43
Jensen_Eisai_groupA,2,6,ts-global_detected_seizures,199244,199337,93
Jensen_Eisai_groupA,1,5,ts-global_detected_seizures,199338,199407,69
Jensen_Eisai_groupA,2,6,ts-global_detected_seizures,199370,199413,43
Jensen_Eisai_groupA,1,5,ts-global_detected_seizures,199408,199872,464
Jensen_Eisai_groupA,2,6,ts-global_detected_seizures,199455,199480,25
Jensen_Eisai_groupA,2,6,ts-global_detected_seizures,199491,199533,42
Jensen_Eisai_groupA,2,6,ts-global_detected_seizures,199659,199688,29
Jensen_Eisai_groupA,2,6,ts-global_detected_seizures,199689,199724,35
Jensen_Eisai_groupA,2,6,ts-global_detected_seizures,199725,199769,44
Jensen_Eisai_groupA,2,6,ts-global_detected_seizures,199770,200001,231
Jensen_Eisai_groupA,1,5,ts-global_detected_seizures,199874,199897,23
Jensen_Eisai_groupA,1,5,ts-global_detected_seizures,199898,199931,33
Jensen_Eisai_groupA,1,5,ts-global_detected_seizures,199932,199969,37
Jensen_Eisai_groupA,1,5,ts-global_detected_seizures,199973,200004,31
Jensen_Eisai_groupA,2,6,ts-global_detected_seizures,200002,200032,30
Jensen_Eisai_groupA,1,5,ts-global_detected_seizures,200005,200053,48
Jensen_Eisai_groupA,2,6,ts-global_detected_seizures,200074,200099,25
Jensen_Eisai_groupA,1,5,ts-global_detected_seizures,200107,200219,112
Jensen_Eisai_groupA,2,6,ts-global_detected_seizures,200109,200155,46
Jensen_Eisai_groupA,2,6,ts-global_detected_seizures,200214,200247,33
Jensen_Eisai_groupA,2,6,ts-global_detected_seizures,200252,200282,30
Jensen_Eisai_groupA,2,6,ts-global_detected_seizures,200338,200803,465
Jensen_Eisai_groupA,1,5,ts-global_detected_seizures,200377,200464,87
Jensen_Eisai_groupA,1,5,ts-global_detected_seizures,200465,200506,41
Jensen_Eisai_groupA,1,5,ts-global_detected_seizures,200523,200585,62
Jensen_Eisai_groupA,1,5,ts-global_detected_seizures,200587,200613,26
Jensen_Eisai_groupA,1,5,ts-global_detected_seizures,200645,200683,38
Jensen_Eisai_groupA,1,5,ts-global_detected_seizures,200702,200724,22
Jensen_Eisai_groupA,1,5,ts-global_detected_seizures,200778,200802,24
Jensen_Eisai_groupA,2,6,ts-global_detected_seizures,200804,201159,355
Jensen_Eisai_groupA,1,5,ts-global_detected_seizures,200815,200843,28
Jensen_Eisai_groupA,1,5,ts-global_detected_seizures,200909,201226,317
Jensen_Eisai_groupA,2,6,ts-global_detected_seizures,201162,201227,65
Jensen_Eisai_groupA,1,5,ts-global_detected_seizures,201248,201272,24
Jensen_Eisai_groupA,2,6,ts-global_detected_seizures,201286,201324,38
Jensen_Eisai_groupA,1,5,ts-global_detected_seizures,201288,201310,22
Jensen_Eisai_groupA,2,6,ts-global_detected_seizures,201354,201388,34
Jensen_Eisai_groupA,1,5,ts-global_detected_seizures,201381,201428,47
Jensen_Eisai_groupA,2,6,ts-global_detected_seizures,201428,201504,76
Jensen_Eisai_groupA,1,5,ts-global_detected_seizures,201431,201474,43
Jensen_Eisai_groupA,1,5,ts-global_detected_seizures,201486,201535,49
Jensen_Eisai_groupA,2,6,ts-global_detected_seizures,201507,201596,89
Jensen_Eisai_groupA,1,5,ts-global_detected_seizures,201537,201560,23
Jensen_Eisai_groupA,2,6,ts-global_detected_seizures,201630,201691,61
Jensen_Eisai_groupA,1,5,ts-global_detected_seizures,201653,201690,37
Jensen_Eisai_groupA,2,6,ts-global_detected_seizures,201692,201759,67
Jensen_Eisai_groupA,1,5,ts-global_detected_seizures,201695,201768,73
Jensen_Eisai_groupA,2,6,ts-global_detected_seizures,201761,201790,29
Jensen_Eisai_groupA,1,5,ts-global_detected_seizures,201773,201870,97
Jensen_Eisai_groupA,2,6,ts-global_detected_seizures,201803,201831,28
Jensen_Eisai_groupA,2,6,ts-global_detected_seizures,201851,201882,31
Jensen_Eisai_groupA,1,5,ts-global_detected_seizures,201974,202031,57
Jensen_Eisai_groupA,2,6,ts-global_detected_seizures,201991,202031,40
Jensen_Eisai_groupA,1,5,ts-global_detected_seizures,202032,202059,27
Jensen_Eisai_groupA,2,6,ts-global_detected_seizures,202037,202060,23
Jensen_Eisai_groupA,1,5,ts-global_detected_seizures,202060,202111,51
Jensen_Eisai_groupA,2,6,ts-global_detected_seizures,202115,202151,36
Jensen_Eisai_groupA,1,5,ts-global_detected_seizures,202123,202222,99
Jensen_Eisai_groupA,2,6,ts-global_detected_seizures,202195,202231,36
Jensen_Eisai_groupA,1,5,ts-global_detected_seizures,202243,202273,30
Jensen_Eisai_groupA,2,6,ts-global_detected_seizures,202276,202324,48
Jensen_Eisai_groupA,1,5,ts-global_detected_seizures,202315,202387,72
Jensen_Eisai_groupA,2,6,ts-global_detected_seizures,202349,202376,27
Jensen_Eisai_groupA,1,5,ts-global_detected_seizures,202402,202433,31
Jensen_Eisai_groupA,2,6,ts-global_detected_seizures,202409,202434,25
Jensen_Eisai_groupA,2,6,ts-global_detected_seizures,202451,202483,32
Jensen_Eisai_groupA,1,5,ts-global_detected_seizures,202452,202499,47
Jensen_Eisai_groupA,1,5,ts-global_detected_seizures,202500,202524,24
Jensen_Eisai_groupA,2,6,ts-global_detected_seizures,202513,202555,42
Jensen_Eisai_groupA,1,5,ts-global_detected_seizures,202525,202565,40
Jensen_Eisai_groupA,2,6,ts-global_detected_seizures,202556,202583,27
Jensen_Eisai_groupA,1,5,ts-global_detected_seizures,202573,202732,159
Jensen_Eisai_groupA,2,6,ts-global_detected_seizures,202672,202697,25
Jensen_Eisai_groupA,2,6,ts-global_detected_seizures,202719,202741,22
Jensen_Eisai_groupA,1,5,ts-global_detected_seizures,202733,202973,240
Jensen_Eisai_groupA,2,6,ts-global_detected_seizures,202743,202770,27
Jensen_Eisai_groupA,2,6,ts-global_detected_seizures,202771,202907,136
Jensen_Eisai_groupA,2,6,ts-global_detected_seizures,202921,202947,26
Jensen_Eisai_groupA,2,6,ts-global_detected_seizures,202970,202992,22
Jensen_Eisai_groupA,1,5,ts-global_detected_seizures,202974,203013,39
Jensen_Eisai_groupA,1,5,ts-global_detected_seizures,203014,203041,27
Jensen_Eisai_groupA,1,5,ts-global_detected_seizures,203062,203093,31
Jensen_Eisai_groupA,1,5,ts-global_detected_seizures,203114,203169,55
Jensen_Eisai_groupA,2,6,ts-global_detected_seizures,203115,203146,31
Jensen_Eisai_groupA,1,5,ts-global_detected_seizures,203170,203192,22
Jensen_Eisai_groupA,2,6,ts-global_detected_seizures,203171,203195,24
Jensen_Eisai_groupA,2,6,ts-global_detected_seizures,203225,203261,36
Jensen_Eisai_groupA,2,6,ts-global_detected_seizures,203295,203331,36
Jensen_Eisai_groupA,2,6,ts-global_detected_seizures,203409,203461,52
Jensen_Eisai_groupA,2,6,ts-global_detected_seizures,203462,203488,26
Jensen_Eisai_groupA,1,5,ts-global_detected_seizures,203475,203567,92
Jensen_Eisai_groupA,2,6,ts-global_detected_seizures,203495,203537,42
Jensen_Eisai_groupA,1,5,ts-global_detected_seizures,203568,203609,41
Jensen_Eisai_groupA,2,6,ts-global_detected_seizures,203577,203615,38
Jensen_Eisai_groupA,1,5,ts-global_detected_seizures,203616,203701,85
Jensen_Eisai_groupA,2,6,ts-global_detected_seizures,203638,203696,58
Jensen_Eisai_groupA,1,5,ts-global_detected_seizures,203707,203737,30
Jensen_Eisai_groupA,2,6,ts-global_detected_seizures,203715,203756,41
Jensen_Eisai_groupA,1,5,ts-global_detected_seizures,203756,203785,29
Jensen_Eisai_groupA,2,6,ts-global_detected_seizures,203773,203799,26
Jensen_Eisai_groupA,1,5,ts-global_detected_seizures,203786,203822,36
Jensen_Eisai_groupA,2,6,ts-global_detected_seizures,203837,203874,37
Jensen_Eisai_groupA,1,5,ts-global_detected_seizures,203838,203869,31
Jensen_Eisai_groupA,1,5,ts-global_detected_seizures,203870,203897,27
Jensen_Eisai_groupA,2,6,ts-global_detected_seizures,203875,203915,40
Jensen_Eisai_groupA,1,5,ts-global_detected_seizures,203898,203926,28
Jensen_Eisai_groupA,2,6,ts-global_detected_seizures,203916,203942,26
Jensen_Eisai_groupA,1,5,ts-global_detected_seizures,203940,204007,67
Jensen_Eisai_groupA,2,6,ts-global_detected_seizures,203944,203987,43
Jensen_Eisai_groupA,2,6,ts-global_detected_seizures,203999,204034,35
Jensen_Eisai_groupA,1,5,ts-global_detected_seizures,204010,204074,64
Jensen_Eisai_groupA,2,6,ts-global_detected_seizures,204056,204082,26
Jensen_Eisai_groupA,2,6,ts-global_detected_seizures,204096,204137,41
Jensen_Eisai_groupA,1,5,ts-global_detected_seizures,204104,204128,24
Jensen_Eisai_groupA,1,5,ts-global_detected_seizures,204182,204227,45
Jensen_Eisai_groupA,2,6,ts-global_detected_seizures,204216,204854,638
Jensen_Eisai_groupA,1,5,ts-global_detected_seizures,204229,204336,107
Jensen_Eisai_groupA,1,5,ts-global_detected_seizures,204338,204404,66
Jensen_Eisai_groupA,1,5,ts-global_detected_seizures,204405,204466,61
Jensen_Eisai_groupA,1,5,ts-global_detected_seizures,204467,204594,127
Jensen_Eisai_groupA,1,5,ts-global_detected_seizures,204595,204663,68
Jensen_Eisai_groupA,1,5,ts-global_detected_seizures,204674,204735,61
Jensen_Eisai_groupA,1,5,ts-global_detected_seizures,204795,204896,101
Jensen_Eisai_groupA,2,6,ts-global_detected_seizures,204855,204937,82
Jensen_Eisai_groupA,1,5,ts-global_detected_seizures,204897,205806,909
Jensen_Eisai_groupA,2,6,ts-global_detected_seizures,204938,205411,473
Jensen_Eisai_groupA,2,6,ts-global_detected_seizures,205412,205447,35
Jensen_Eisai_groupA,2,6,ts-global_detected_seizures,205465,205489,24
Jensen_Eisai_groupA,2,6,ts-global_detected_seizures,205561,205607,46
Jensen_Eisai_groupA,2,6,ts-global_detected_seizures,205627,205671,44
Jensen_Eisai_groupA,2,6,ts-global_detected_seizures,205714,205753,39
Jensen_Eisai_groupA,2,6,ts-global_detected_seizures,205757,205787,30
Jensen_Eisai_groupA,2,6,ts-global_detected_seizures,205798,205830,32
Jensen_Eisai_groupA,1,5,ts-global_detected_seizures,205818,205914,96
Jensen_Eisai_groupA,2,6,ts-global_detected_seizures,205862,205892,30
Jensen_Eisai_groupA,2,6,ts-global_detected_seizures,205913,205949,36
Jensen_Eisai_groupA,1,5,ts-global_detected_seizures,205916,205972,56
Jensen_Eisai_groupA,1,5,ts-global_detected_seizures,205973,206014,41
Jensen_Eisai_groupA,2,6,ts-global_detected_seizures,206005,206072,67
Jensen_Eisai_groupA,1,5,ts-global_detected_seizures,206064,206147,83
Jensen_Eisai_groupA,2,6,ts-global_detected_seizures,206082,206243,161
Jensen_Eisai_groupA,2,6,ts-global_detected_seizures,206248,206300,52
Jensen_Eisai_groupA,1,5,ts-global_detected_seizures,206290,206330,40
Jensen_Eisai_groupA,2,6,ts-global_detected_seizures,206324,206366,42
Jensen_Eisai_groupA,1,5,ts-global_detected_seizures,206353,206379,26
Jensen_Eisai_groupA,1,5,ts-global_detected_seizures,206381,206405,24
Jensen_Eisai_groupA,1,5,ts-global_detected_seizures,206437,206477,40
Jensen_Eisai_groupA,2,6,ts-global_detected_seizures,206446,206496,50
Jensen_Eisai_groupA,1,5,ts-global_detected_seizures,206494,206708,214
Jensen_Eisai_groupA,2,6,ts-global_detected_seizures,206497,206896,399
Jensen_Eisai_groupA,1,5,ts-global_detected_seizures,206734,206779,45
Jensen_Eisai_groupA,1,5,ts-global_detected_seizures,206807,206840,33
Jensen_Eisai_groupA,2,6,ts-global_detected_seizures,206897,206949,52
Jensen_Eisai_groupA,1,5,ts-global_detected_seizures,206960,207019,59
Jensen_Eisai_groupA,2,6,ts-global_detected_seizures,206963,207003,40
Jensen_Eisai_groupA,1,5,ts-global_detected_seizures,207035,207072,37
Jensen_Eisai_groupA,2,6,ts-global_detected_seizures,207064,207086,22
Jensen_Eisai_groupA,1,5,ts-global_detected_seizures,207092,207133,41
Jensen_Eisai_groupA,2,6,ts-global_detected_seizures,207155,207252,97
Jensen_Eisai_groupA,1,5,ts-global_detected_seizures,207191,207349,158
Jensen_Eisai_groupA,2,6,ts-global_detected_seizures,207254,207279,25
Jensen_Eisai_groupA,2,6,ts-global_detected_seizures,207315,207356,41
Jensen_Eisai_groupA,1,5,ts-global_detected_seizures,207350,207512,162
Jensen_Eisai_groupA,2,6,ts-global_detected_seizures,207426,207460,34
Jensen_Eisai_groupA,2,6,ts-global_detected_seizures,207492,207523,31
Jensen_Eisai_groupA,1,5,ts-global_detected_seizures,207513,207580,67
Jensen_Eisai_groupA,2,6,ts-global_detected_seizures,207561,207588,27
Jensen_Eisai_groupA,1,5,ts-global_detected_seizures,207590,207643,53
Jensen_Eisai_groupA,2,6,ts-global_detected_seizures,207622,207645,23
Jensen_Eisai_groupA,2,6,ts-global_detected_seizures,207707,207739,32
Jensen_Eisai_groupA,2,6,ts-global_detected_seizures,207740,207770,30
Jensen_Eisai_groupA,1,5,ts-global_detected_seizures,207745,207785,40
Jensen_Eisai_groupA,2,6,ts-global_detected_seizures,207804,207828,24
Jensen_Eisai_groupA,1,5,ts-global_detected_seizures,207810,207842,32
Jensen_Eisai_groupA,2,6,ts-global_detected_seizures,207830,207914,84
Jensen_Eisai_groupA,1,5,ts-global_detected_seizures,207877,207951,74
Jensen_Eisai_groupA,2,6,ts-global_detected_seizures,207915,208011,96
Jensen_Eisai_groupA,1,5,ts-global_detected_seizures,207952,207980,28
Jensen_Eisai_groupA,1,5,ts-global_detected_seizures,207999,208030,31
Jensen_Eisai_groupA,1,5,ts-global_detected_seizures,208032,208081,49
Jensen_Eisai_groupA,1,5,ts-global_detected_seizures,208098,208164,66
Jensen_Eisai_groupA,2,6,ts-global_detected_seizures,208111,208151,40
Jensen_Eisai_groupA,1,5,ts-global_detected_seizures,208165,208191,26
Jensen_Eisai_groupA,1,5,ts-global_detected_seizures,208196,208302,106
Jensen_Eisai_groupA,2,6,ts-global_detected_seizures,208204,208226,22
Jensen_Eisai_groupA,2,6,ts-global_detected_seizures,208286,208309,23
Jensen_Eisai_groupA,1,5,ts-global_detected_seizures,208311,208382,71
Jensen_Eisai_groupA,2,6,ts-global_detected_seizures,208384,208419,35
Jensen_Eisai_groupA,1,5,ts-global_detected_seizures,208392,208471,79
Jensen_Eisai_groupA,2,6,ts-global_detected_seizures,208450,208500,50
Jensen_Eisai_groupA,2,6,ts-global_detected_seizures,208533,208556,23
Jensen_Eisai_groupA,1,5,ts-global_detected_seizures,208536,208646,110
Jensen_Eisai_groupA,2,6,ts-global_detected_seizures,208580,208618,38
Jensen_Eisai_groupA,2,6,ts-global_detected_seizures,208661,208689,28
Jensen_Eisai_groupA,1,5,ts-global_detected_seizures,208676,208719,43
Jensen_Eisai_groupA,2,6,ts-global_detected_seizures,208745,208800,55
Jensen_Eisai_groupA,2,6,ts-global_detected_seizures,208852,208900,48
Jensen_Eisai_groupA,1,5,ts-global_detected_seizures,208880,209024,144
Jensen_Eisai_groupA,2,6,ts-global_detected_seizures,208901,208923,22
Jensen_Eisai_groupA,2,6,ts-global_detected_seizures,208993,209021,28
Jensen_Eisai_groupA,2,6,ts-global_detected_seizures,209022,209050,28
Jensen_Eisai_groupA,1,5,ts-global_detected_seizures,209025,209048,23
Jensen_Eisai_groupA,1,5,ts-global_detected_seizures,209049,209102,53
Jensen_Eisai_groupA,2,6,ts-global_detected_seizures,209082,209112,30
Jensen_Eisai_groupA,1,5,ts-global_detected_seizures,209103,209150,47
Jensen_Eisai_groupA,2,6,ts-global_detected_seizures,209133,209158,25
Jensen_Eisai_groupA,1,5,ts-global_detected_seizures,209191,209957,766
Jensen_Eisai_groupA,2,6,ts-global_detected_seizures,209193,209249,56
Jensen_Eisai_groupA,2,6,ts-global_detected_seizures,209268,209344,76
Jensen_Eisai_groupA,2,6,ts-global_detected_seizures,209361,210311,950
Jensen_Eisai_groupA,1,5,ts-global_detected_seizures,209958,210008,50
Jensen_Eisai_groupA,1,5,ts-global_detected_seizures,210017,210039,22
Jensen_Eisai_groupA,1,5,ts-global_detected_seizures,210062,210085,23
Jensen_Eisai_groupA,1,5,ts-global_detected_seizures,210110,210145,35
Jensen_Eisai_groupA,1,5,ts-global_detected_seizures,210146,210176,30
Jensen_Eisai_groupA,1,5,ts-global_detected_seizures,210237,210303,66
Jensen_Eisai_groupA,2,6,ts-global_detected_seizures,210312,210361,49
Jensen_Eisai_groupA,1,5,ts-global_detected_seizures,210324,210365,41
Jensen_Eisai_groupA,2,6,ts-global_detected_seizures,210401,210436,35
Jensen_Eisai_groupA,1,5,ts-global_detected_seizures,210409,210438,29
Jensen_Eisai_groupA,2,6,ts-global_detected_seizures,210447,210471,24
Jensen_Eisai_groupA,1,5,ts-global_detected_seizures,210461,210495,34
Jensen_Eisai_groupA,2,6,ts-global_detected_seizures,210492,210527,35
Jensen_Eisai_groupA,1,5,ts-global_detected_seizures,210523,211511,988
Jensen_Eisai_groupA,2,6,ts-global_detected_seizures,210543,210566,23
Jensen_Eisai_groupA,2,6,ts-global_detected_seizures,210588,210643,55
Jensen_Eisai_groupA,2,6,ts-global_detected_seizures,210678,210720,42
Jensen_Eisai_groupA,2,6,ts-global_detected_seizures,210794,210831,37
Jensen_Eisai_groupA,2,6,ts-global_detected_seizures,210892,210928,36
Jensen_Eisai_groupA,2,6,ts-global_detected_seizures,210977,211004,27
Jensen_Eisai_groupA,2,6,ts-global_detected_seizures,211048,211077,29
Jensen_Eisai_groupA,2,6,ts-global_detected_seizures,211110,211160,50
Jensen_Eisai_groupA,2,6,ts-global_detected_seizures,211161,211183,22
Jensen_Eisai_groupA,2,6,ts-global_detected_seizures,211188,211212,24
Jensen_Eisai_groupA,2,6,ts-global_detected_seizures,211255,211279,24
Jensen_Eisai_groupA,2,6,ts-global_detected_seizures,211364,211408,44
Jensen_Eisai_groupA,2,6,ts-global_detected_seizures,211439,211463,24
Jensen_Eisai_groupA,2,6,ts-global_detected_seizures,211521,211548,27
Jensen_Eisai_groupA,1,5,ts-global_detected_seizures,211534,211579,45
Jensen_Eisai_groupA,2,6,ts-global_detected_seizures,211569,211593,24
Jensen_Eisai_groupA,1,5,ts-global_detected_seizures,211593,211623,30
Jensen_Eisai_groupA,1,5,ts-global_detected_seizures,211624,211650,26
Jensen_Eisai_groupA,1,5,ts-global_detected_seizures,211689,211729,40
Jensen_Eisai_groupA,2,6,ts-global_detected_seizures,211708,211743,35
Jensen_Eisai_groupA,1,5,ts-global_detected_seizures,211732,211763,31
Jensen_Eisai_groupA,2,6,ts-global_detected_seizures,211761,211806,45
Jensen_Eisai_groupA,1,5,ts-global_detected_seizures,211797,211823,26
Jensen_Eisai_groupA,1,5,ts-global_detected_seizures,211838,211861,23
Jensen_Eisai_groupA,1,5,ts-global_detected_seizures,211862,211885,23
Jensen_Eisai_groupA,1,5,ts-global_detected_seizures,211886,211909,23
Jensen_Eisai_groupA,1,5,ts-global_detected_seizures,211914,211951,37
Jensen_Eisai_groupA,2,6,ts-global_detected_seizures,211924,211948,24
Jensen_Eisai_groupA,2,6,ts-global_detected_seizures,211975,212014,39
Jensen_Eisai_groupA,2,6,ts-global_detected_seizures,212019,212047,28
Jensen_Eisai_groupA,2,6,ts-global_detected_seizures,212079,212105,26
Jensen_Eisai_groupA,1,5,ts-global_detected_seizures,212092,212147,55
Jensen_Eisai_groupA,2,6,ts-global_detected_seizures,212126,212153,27
Jensen_Eisai_groupA,1,5,ts-global_detected_seizures,212166,212217,51
Jensen_Eisai_groupA,2,6,ts-global_detected_seizures,212199,212222,23
Jensen_Eisai_groupA,1,5,ts-global_detected_seizures,212249,212288,39
Jensen_Eisai_groupA,2,6,ts-global_detected_seizures,212255,212283,28
Jensen_Eisai_groupA,2,6,ts-global_detected_seizures,212285,212309,24
Jensen_Eisai_groupA,1,5,ts-global_detected_seizures,212289,212368,79
Jensen_Eisai_groupA,1,5,ts-global_detected_seizures,212369,212392,23
Jensen_Eisai_groupA,1,5,ts-global_detected_seizures,212396,212438,42
Jensen_Eisai_groupA,2,6,ts-global_detected_seizures,212401,212488,87
Jensen_Eisai_groupA,1,5,ts-global_detected_seizures,212457,212487,30
Jensen_Eisai_groupA,1,5,ts-global_detected_seizures,212488,212537,49
Jensen_Eisai_groupA,2,6,ts-global_detected_seizures,212506,212530,24
Jensen_Eisai_groupA,1,5,ts-global_detected_seizures,212544,212570,26
Jensen_Eisai_groupA,2,6,ts-global_detected_seizures,212576,212605,29
Jensen_Eisai_groupA,1,5,ts-global_detected_seizures,212603,212642,39
Jensen_Eisai_groupA,2,6,ts-global_detected_seizures,212690,212732,42
Jensen_Eisai_groupA,1,5,ts-global_detected_seizures,212694,212726,32
Jensen_Eisai_groupA,2,6,ts-global_detected_seizures,212752,212835,83
Jensen_Eisai_groupA,1,5,ts-global_detected_seizures,212856,212899,43
Jensen_Eisai_groupA,2,6,ts-global_detected_seizures,212877,212913,36
Jensen_Eisai_groupA,1,5,ts-global_detected_seizures,212962,213015,53
Jensen_Eisai_groupA,1,5,ts-global_detected_seizures,213016,213051,35
Jensen_Eisai_groupA,1,5,ts-global_detected_seizures,213052,213249,197
Jensen_Eisai_groupA,2,6,ts-global_detected_seizures,213083,213117,34
Jensen_Eisai_groupA,2,6,ts-global_detected_seizures,213124,213147,23
Jensen_Eisai_groupA,2,6,ts-global_detected_seizures,213186,213210,24
Jensen_Eisai_groupA,1,5,ts-global_detected_seizures,213250,213288,38
Jensen_Eisai_groupA,2,6,ts-global_detected_seizures,213288,213322,34
Jensen_Eisai_groupA,1,5,ts-global_detected_seizures,213311,213336,25
Jensen_Eisai_groupA,1,5,ts-global_detected_seizures,213338,213437,99
Jensen_Eisai_groupA,2,6,ts-global_detected_seizures,213366,213405,39
Jensen_Eisai_groupA,2,6,ts-global_detected_seizures,213432,213466,34
Jensen_Eisai_groupA,1,5,ts-global_detected_seizures,213463,214136,673
Jensen_Eisai_groupA,2,6,ts-global_detected_seizures,213521,213551,30
Jensen_Eisai_groupA,2,6,ts-global_detected_seizures,213568,213590,22
Jensen_Eisai_groupA,2,6,ts-global_detected_seizures,213661,213701,40
Jensen_Eisai_groupA,2,6,ts-global_detected_seizures,213719,213750,31
Jensen_Eisai_groupA,2,6,ts-global_detected_seizures,213868,213940,72
Jensen_Eisai_groupA,2,6,ts-global_detected_seizures,213970,213994,24
Jensen_Eisai_groupA,2,6,ts-global_detected_seizures,213995,214023,28
Jensen_Eisai_groupA,2,6,ts-global_detected_seizures,214029,214053,24
Jensen_Eisai_groupA,2,6,ts-global_detected_seizures,214077,214105,28
Jensen_Eisai_groupA,2,6,ts-global_detected_seizures,214113,214400,287
Jensen_Eisai_groupA,1,5,ts-global_detected_seizures,214259,214284,25
Jensen_Eisai_groupA,1,5,ts-global_detected_seizures,214286,214331,45
Jensen_Eisai_groupA,1,5,ts-global_detected_seizures,214382,214452,70
Jensen_Eisai_groupA,2,6,ts-global_detected_seizures,214401,214542,141
Jensen_Eisai_groupA,1,5,ts-global_detected_seizures,214459,214486,27
Jensen_Eisai_groupA,4,8,ts-global_detected_seizures,214464,214637,173
Jensen_Eisai_groupA,1,5,ts-global_detected_seizures,214508,215439,931
Jensen_Eisai_groupA,2,6,ts-global_detected_seizures,214543,214568,25
Jensen_Eisai_groupA,2,6,ts-global_detected_seizures,214585,215380,795
Jensen_Eisai_groupA,4,8,ts-global_detected_seizures,214638,214665,27
Jensen_Eisai_groupA,4,8,ts-global_detected_seizures,214666,225231,10565
Jensen_Eisai_groupA,2,6,ts-global_detected_seizures,215397,215503,106
Jensen_Eisai_groupA,1,5,ts-global_detected_seizures,215440,216331,891
Jensen_Eisai_groupA,2,6,ts-global_detected_seizures,215562,215604,42
Jensen_Eisai_groupA,2,6,ts-global_detected_seizures,215605,215679,74
Jensen_Eisai_groupA,2,6,ts-global_detected_seizures,215683,215751,68
Jensen_Eisai_groupA,2,6,ts-global_detected_seizures,215774,215911,137
Jensen_Eisai_groupA,2,6,ts-global_detected_seizures,215926,215955,29
Jensen_Eisai_groupA,2,6,ts-global_detected_seizures,215956,215993,37
Jensen_Eisai_groupA,2,6,ts-global_detected_seizures,216008,216796,788
Jensen_Eisai_groupA,1,5,ts-global_detected_seizures,216332,216487,155
Jensen_Eisai_groupA,1,5,ts-global_detected_seizures,216488,216928,440
Jensen_Eisai_groupA,2,6,ts-global_detected_seizures,216797,217077,280
Jensen_Eisai_groupA,1,5,ts-global_detected_seizures,216929,217633,704
Jensen_Eisai_groupA,2,6,ts-global_detected_seizures,217078,217130,52
Jensen_Eisai_groupA,2,6,ts-global_detected_seizures,217142,217205,63
Jensen_Eisai_groupA,2,6,ts-global_detected_seizures,217241,217293,52
Jensen_Eisai_groupA,2,6,ts-global_detected_seizures,217315,217355,40
Jensen_Eisai_groupA,2,6,ts-global_detected_seizures,217360,217417,57
Jensen_Eisai_groupA,2,6,ts-global_detected_seizures,217419,217499,80
Jensen_Eisai_groupA,2,6,ts-global_detected_seizures,217500,217556,56
Jensen_Eisai_groupA,2,6,ts-global_detected_seizures,217557,218188,631
Jensen_Eisai_groupA,1,5,ts-global_detected_seizures,217634,218231,597
Jensen_Eisai_groupA,2,6,ts-global_detected_seizures,218194,218652,458
Jensen_Eisai_groupA,1,5,ts-global_detected_seizures,218234,218822,588
Jensen_Eisai_groupA,2,6,ts-global_detected_seizures,218653,218690,37
Jensen_Eisai_groupA,2,6,ts-global_detected_seizures,218692,218732,40
Jensen_Eisai_groupA,2,6,ts-global_detected_seizures,218743,218767,24
Jensen_Eisai_groupA,2,6,ts-global_detected_seizures,218771,218843,72
Jensen_Eisai_groupA,1,5,ts-global_detected_seizures,218823,218849,26
Jensen_Eisai_groupA,1,5,ts-global_detected_seizures,218850,219457,607
Jensen_Eisai_groupA,2,6,ts-global_detected_seizures,218867,218889,22
Jensen_Eisai_groupA,2,6,ts-global_detected_seizures,218917,218948,31
Jensen_Eisai_groupA,2,6,ts-global_detected_seizures,218988,219017,29
Jensen_Eisai_groupA,2,6,ts-global_detected_seizures,219019,219056,37
Jensen_Eisai_groupA,2,6,ts-global_detected_seizures,219057,219851,794
Jensen_Eisai_groupA,1,5,ts-global_detected_seizures,219458,222173,2715
Jensen_Eisai_groupA,2,6,ts-global_detected_seizures,219858,219940,82
Jensen_Eisai_groupA,2,6,ts-global_detected_seizures,219958,220018,60
Jensen_Eisai_groupA,2,6,ts-global_detected_seizures,220031,220055,24
Jensen_Eisai_groupA,2,6,ts-global_detected_seizures,220064,220096,32
Jensen_Eisai_groupA,2,6,ts-global_detected_seizures,220127,220159,32
Jensen_Eisai_groupA,2,6,ts-global_detected_seizures,220177,220215,38
Jensen_Eisai_groupA,2,6,ts-global_detected_seizures,220220,220248,28
Jensen_Eisai_groupA,2,6,ts-global_detected_seizures,220278,220321,43
Jensen_Eisai_groupA,2,6,ts-global_detected_seizures,220354,220378,24
Jensen_Eisai_groupA,2,6,ts-global_detected_seizures,220380,220405,25
Jensen_Eisai_groupA,2,6,ts-global_detected_seizures,220422,220451,29
Jensen_Eisai_groupA,2,6,ts-global_detected_seizures,220484,220507,23
Jensen_Eisai_groupA,2,6,ts-global_detected_seizures,220549,220869,320
Jensen_Eisai_groupA,2,6,ts-global_detected_seizures,220870,220947,77
Jensen_Eisai_groupA,2,6,ts-global_detected_seizures,220955,220998,43
Jensen_Eisai_groupA,2,6,ts-global_detected_seizures,221022,221047,25
Jensen_Eisai_groupA,2,6,ts-global_detected_seizures,221054,221548,494
Jensen_Eisai_groupA,2,6,ts-global_detected_seizures,221549,221581,32
Jensen_Eisai_groupA,2,6,ts-global_detected_seizures,221597,221661,64
Jensen_Eisai_groupA,2,6,ts-global_detected_seizures,221665,221740,75
Jensen_Eisai_groupA,2,6,ts-global_detected_seizures,221764,222230,466
Jensen_Eisai_groupA,1,5,ts-global_detected_seizures,222174,222199,25
Jensen_Eisai_groupA,1,5,ts-global_detected_seizures,222225,222261,36
Jensen_Eisai_groupA,2,6,ts-global_detected_seizures,222231,222273,42
Jensen_Eisai_groupA,2,6,ts-global_detected_seizures,222274,222330,56
Jensen_Eisai_groupA,1,5,ts-global_detected_seizures,222285,222317,32
Jensen_Eisai_groupA,1,5,ts-global_detected_seizures,222339,223311,972
Jensen_Eisai_groupA,2,6,ts-global_detected_seizures,222383,222461,78
Jensen_Eisai_groupA,2,6,ts-global_detected_seizures,222521,222554,33
Jensen_Eisai_groupA,2,6,ts-global_detected_seizures,222576,222608,32
Jensen_Eisai_groupA,2,6,ts-global_detected_seizures,222624,222675,51
Jensen_Eisai_groupA,2,6,ts-global_detected_seizures,222695,222723,28
Jensen_Eisai_groupA,2,6,ts-global_detected_seizures,222726,222763,37
Jensen_Eisai_groupA,2,6,ts-global_detected_seizures,222800,222874,74
Jensen_Eisai_groupA,2,6,ts-global_detected_seizures,222892,222953,61
Jensen_Eisai_groupA,2,6,ts-global_detected_seizures,222983,223042,59
Jensen_Eisai_groupA,2,6,ts-global_detected_seizures,222983,223042,59
Jensen_Eisai_groupA,2,6,ts-global_detected_seizures,223061,223744,683
Jensen_Eisai_groupA,1,5,ts-global_detected_seizures,223312,224140,828
Jensen_Eisai_groupA,2,6,ts-global_detected_seizures,223766,223849,83
Jensen_Eisai_groupA,2,6,ts-global_detected_seizures,223850,223872,22
Jensen_Eisai_groupA,2,6,ts-global_detected_seizures,223875,223905,30
Jensen_Eisai_groupA,2,6,ts-global_detected_seizures,223956,223998,42
Jensen_Eisai_groupA,2,6,ts-global_detected_seizures,224007,224052,45
Jensen_Eisai_groupA,2,6,ts-global_detected_seizures,224122,224156,34
Jensen_Eisai_groupA,1,5,ts-global_detected_seizures,224141,224432,291
Jensen_Eisai_groupA,2,6,ts-global_detected_seizures,224188,224236,48
Jensen_Eisai_groupA,2,6,ts-global_detected_seizures,224260,224286,26
Jensen_Eisai_groupA,2,6,ts-global_detected_seizures,224293,224836,543
Jensen_Eisai_groupA,1,5,ts-global_detected_seizures,224433,225184,751
Jensen_Eisai_groupA,2,6,ts-global_detected_seizures,224855,224901,46
Jensen_Eisai_groupA,2,6,ts-global_detected_seizures,224911,225002,91
Jensen_Eisai_groupA,2,6,ts-global_detected_seizures,225010,225106,96
Jensen_Eisai_groupA,2,6,ts-global_detected_seizures,225162,225190,28
Jensen_Eisai_groupA,1,5,ts-global_detected_seizures,225185,225981,796
Jensen_Eisai_groupA,2,6,ts-global_detected_seizures,225191,225215,24
Jensen_Eisai_groupA,2,6,ts-global_detected_seizures,225228,225255,27
Jensen_Eisai_groupA,4,8,ts-global_detected_seizures,225232,225269,37
Jensen_Eisai_groupA,4,8,ts-global_detected_seizures,225270,227629,2359
Jensen_Eisai_groupA,2,6,ts-global_detected_seizures,225303,225363,60
Jensen_Eisai_groupA,2,6,ts-global_detected_seizures,225365,225408,43
Jensen_Eisai_groupA,2,6,ts-global_detected_seizures,225419,225456,37
Jensen_Eisai_groupA,2,6,ts-global_detected_seizures,225471,225540,69
Jensen_Eisai_groupA,2,6,ts-global_detected_seizures,225550,225632,82
Jensen_Eisai_groupA,2,6,ts-global_detected_seizures,225635,225660,25
Jensen_Eisai_groupA,2,6,ts-global_detected_seizures,225687,225709,22
Jensen_Eisai_groupA,2,6,ts-global_detected_seizures,225730,225762,32
Jensen_Eisai_groupA,2,6,ts-global_detected_seizures,225764,225803,39
Jensen_Eisai_groupA,2,6,ts-global_detected_seizures,225808,225842,34
Jensen_Eisai_groupA,2,6,ts-global_detected_seizures,225895,225922,27
Jensen_Eisai_groupA,2,6,ts-global_detected_seizures,225958,225986,28
Jensen_Eisai_groupA,1,5,ts-global_detected_seizures,225995,226254,259
Jensen_Eisai_groupA,2,6,ts-global_detected_seizures,226026,226077,51
Jensen_Eisai_groupA,2,6,ts-global_detected_seizures,226128,226167,39
Jensen_Eisai_groupA,2,6,ts-global_detected_seizures,226191,226606,415
Jensen_Eisai_groupA,1,5,ts-global_detected_seizures,226265,226602,337
Jensen_Eisai_groupA,1,5,ts-global_detected_seizures,226603,226749,146
Jensen_Eisai_groupA,2,6,ts-global_detected_seizures,226608,226642,34
Jensen_Eisai_groupA,2,6,ts-global_detected_seizures,226647,227117,470
Jensen_Eisai_groupA,1,5,ts-global_detected_seizures,226750,227102,352
Jensen_Eisai_groupA,1,5,ts-global_detected_seizures,227103,227146,43
Jensen_Eisai_groupA,1,5,ts-global_detected_seizures,227147,227714,567
Jensen_Eisai_groupA,2,6,ts-global_detected_seizures,227165,227188,23
Jensen_Eisai_groupA,2,6,ts-global_detected_seizures,227210,227246,36
Jensen_Eisai_groupA,2,6,ts-global_detected_seizures,227260,227284,24
Jensen_Eisai_groupA,2,6,ts-global_detected_seizures,227304,227343,39
Jensen_Eisai_groupA,2,6,ts-global_detected_seizures,227348,227373,25
Jensen_Eisai_groupA,2,6,ts-global_detected_seizures,227437,227481,44
Jensen_Eisai_groupA,2,6,ts-global_detected_seizures,227482,227507,25
Jensen_Eisai_groupA,2,6,ts-global_detected_seizures,227517,227551,34
Jensen_Eisai_groupA,2,6,ts-global_detected_seizures,227568,227592,24
Jensen_Eisai_groupA,4,8,ts-global_detected_seizures,227630,233751,6121
Jensen_Eisai_groupA,2,6,ts-global_detected_seizures,227662,227685,23
Jensen_Eisai_groupA,2,6,ts-global_detected_seizures,227703,227739,36
Jensen_Eisai_groupA,1,5,ts-global_detected_seizures,227715,228359,644
Jensen_Eisai_groupA,2,6,ts-global_detected_seizures,227740,227775,35
Jensen_Eisai_groupA,2,6,ts-global_detected_seizures,227792,227824,32
Jensen_Eisai_groupA,2,6,ts-global_detected_seizures,227825,227850,25
Jensen_Eisai_groupA,2,6,ts-global_detected_seizures,227879,227912,33
Jensen_Eisai_groupA,2,6,ts-global_detected_seizures,227945,227977,32
Jensen_Eisai_groupA,2,6,ts-global_detected_seizures,228011,228038,27
Jensen_Eisai_groupA,2,6,ts-global_detected_seizures,228080,228114,34
Jensen_Eisai_groupA,2,6,ts-global_detected_seizures,228161,228205,44
Jensen_Eisai_groupA,2,6,ts-global_detected_seizures,228217,228829,612
Jensen_Eisai_groupA,1,5,ts-global_detected_seizures,228360,228935,575
Jensen_Eisai_groupA,2,6,ts-global_detected_seizures,228830,228883,53
Jensen_Eisai_groupA,2,6,ts-global_detected_seizures,228933,228988,55
Jensen_Eisai_groupA,1,5,ts-global_detected_seizures,228936,229490,554
Jensen_Eisai_groupA,2,6,ts-global_detected_seizures,228998,229042,44
Jensen_Eisai_groupA,2,6,ts-global_detected_seizures,229046,229072,26
Jensen_Eisai_groupA,2,6,ts-global_detected_seizures,229081,229117,36
Jensen_Eisai_groupA,2,6,ts-global_detected_seizures,229174,229199,25
Jensen_Eisai_groupA,2,6,ts-global_detected_seizures,229218,229286,68
Jensen_Eisai_groupA,2,6,ts-global_detected_seizures,229301,229345,44
Jensen_Eisai_groupA,2,6,ts-global_detected_seizures,229385,229410,25
Jensen_Eisai_groupA,2,6,ts-global_detected_seizures,229450,229482,32
Jensen_Eisai_groupA,1,5,ts-global_detected_seizures,229491,229602,111
Jensen_Eisai_groupA,1,5,ts-global_detected_seizures,229603,229947,344
Jensen_Eisai_groupA,2,6,ts-global_detected_seizures,229606,229677,71
Jensen_Eisai_groupA,2,6,ts-global_detected_seizures,229678,229731,53
Jensen_Eisai_groupA,2,6,ts-global_detected_seizures,229787,229815,28
Jensen_Eisai_groupA,2,6,ts-global_detected_seizures,229875,229902,27
Jensen_Eisai_groupA,2,6,ts-global_detected_seizures,229923,229954,31
Jensen_Eisai_groupA,1,5,ts-global_detected_seizures,229948,231461,1513
Jensen_Eisai_groupA,2,6,ts-global_detected_seizures,229973,230009,36
Jensen_Eisai_groupA,2,6,ts-global_detected_seizures,230019,230049,30
Jensen_Eisai_groupA,2,6,ts-global_detected_seizures,230151,230178,27
Jensen_Eisai_groupA,2,6,ts-global_detected_seizures,230312,230344,32
Jensen_Eisai_groupA,2,6,ts-global_detected_seizures,230370,230401,31
Jensen_Eisai_groupA,2,6,ts-global_detected_seizures,230407,230525,118
Jensen_Eisai_groupA,2,6,ts-global_detected_seizures,230567,231227,660
Jensen_Eisai_groupA,2,6,ts-global_detected_seizures,231228,231802,574
Jensen_Eisai_groupA,1,5,ts-global_detected_seizures,231466,231497,31
Jensen_Eisai_groupA,1,5,ts-global_detected_seizures,231498,231541,43
Jensen_Eisai_groupA,1,5,ts-global_detected_seizures,231548,231989,441
Jensen_Eisai_groupA,2,6,ts-global_detected_seizures,231807,231851,44
Jensen_Eisai_groupA,2,6,ts-global_detected_seizures,231854,231879,25
Jensen_Eisai_groupA,2,6,ts-global_detected_seizures,231913,232086,173
Jensen_Eisai_groupA,1,5,ts-global_detected_seizures,231990,232506,516
Jensen_Eisai_groupA,2,6,ts-global_detected_seizures,232088,232118,30
Jensen_Eisai_groupA,2,6,ts-global_detected_seizures,232119,232214,95
Jensen_Eisai_groupA,2,6,ts-global_detected_seizures,232284,232321,37
Jensen_Eisai_groupA,2,6,ts-global_detected_seizures,232330,232651,321
Jensen_Eisai_groupA,1,5,ts-global_detected_seizures,232507,233899,1392
Jensen_Eisai_groupA,2,6,ts-global_detected_seizures,232716,232745,29
Jensen_Eisai_groupA,2,6,ts-global_detected_seizures,232756,232788,32
Jensen_Eisai_groupA,2,6,ts-global_detected_seizures,232799,232824,25
Jensen_Eisai_groupA,2,6,ts-global_detected_seizures,232854,233315,461
Jensen_Eisai_groupA,2,6,ts-global_detected_seizures,233317,233373,56
Jensen_Eisai_groupA,2,6,ts-global_detected_seizures,233385,233412,27
Jensen_Eisai_groupA,2,6,ts-global_detected_seizures,233419,233444,25
Jensen_Eisai_groupA,2,6,ts-global_detected_seizures,233454,233489,35
Jensen_Eisai_groupA,2,6,ts-global_detected_seizures,233499,233537,38
Jensen_Eisai_groupA,2,6,ts-global_detected_seizures,233696,233726,30
Jensen_Eisai_groupA,4,8,ts-global_detected_seizures,233752,257948,24196
Jensen_Eisai_groupA,2,6,ts-global_detected_seizures,233771,233799,28
Jensen_Eisai_groupA,2,6,ts-global_detected_seizures,233890,233934,44
Jensen_Eisai_groupA,1,5,ts-global_detected_seizures,233900,234753,853
Jensen_Eisai_groupA,2,6,ts-global_detected_seizures,233992,234045,53
Jensen_Eisai_groupA,2,6,ts-global_detected_seizures,234116,234141,25
Jensen_Eisai_groupA,2,6,ts-global_detected_seizures,234228,234263,35
Jensen_Eisai_groupA,2,6,ts-global_detected_seizures,234364,234389,25
Jensen_Eisai_groupA,2,6,ts-global_detected_seizures,234489,234524,35
Jensen_Eisai_groupA,2,6,ts-global_detected_seizures,234597,234628,31
Jensen_Eisai_groupA,2,6,ts-global_detected_seizures,234671,234704,33
Jensen_Eisai_groupA,2,6,ts-global_detected_seizures,234729,234769,40
Jensen_Eisai_groupA,1,5,ts-global_detected_seizures,234754,235710,956
Jensen_Eisai_groupA,2,6,ts-global_detected_seizures,234798,234821,23
Jensen_Eisai_groupA,2,6,ts-global_detected_seizures,234845,234870,25
Jensen_Eisai_groupA,2,6,ts-global_detected_seizures,234888,235588,700
Jensen_Eisai_groupA,2,6,ts-global_detected_seizures,235634,235660,26
Jensen_Eisai_groupA,2,6,ts-global_detected_seizures,235674,235733,59
Jensen_Eisai_groupA,1,5,ts-global_detected_seizures,235711,235749,38
Jensen_Eisai_groupA,2,6,ts-global_detected_seizures,235737,235768,31
Jensen_Eisai_groupA,2,6,ts-global_detected_seizures,235868,235903,35
Jensen_Eisai_groupA,1,5,ts-global_detected_seizures,235912,235939,27
Jensen_Eisai_groupA,2,6,ts-global_detected_seizures,235926,235953,27
Jensen_Eisai_groupA,2,6,ts-global_detected_seizures,235981,236007,26
Jensen_Eisai_groupA,2,6,ts-global_detected_seizures,236018,236045,27
Jensen_Eisai_groupA,2,6,ts-global_detected_seizures,236084,236110,26
Jensen_Eisai_groupA,2,6,ts-global_detected_seizures,236137,236175,38
Jensen_Eisai_groupA,2,6,ts-global_detected_seizures,236192,236234,42
Jensen_Eisai_groupA,2,6,ts-global_detected_seizures,236241,236265,24
Jensen_Eisai_groupA,2,6,ts-global_detected_seizures,236324,236346,22
Jensen_Eisai_groupA,2,6,ts-global_detected_seizures,236375,237176,801
Jensen_Eisai_groupA,1,5,ts-global_detected_seizures,236451,236481,30
Jensen_Eisai_groupA,1,5,ts-global_detected_seizures,236718,236754,36
Jensen_Eisai_groupA,1,5,ts-global_detected_seizures,236785,236811,26
Jensen_Eisai_groupA,1,5,ts-global_detected_seizures,236971,236998,27
Jensen_Eisai_groupA,1,5,ts-global_detected_seizures,237125,237155,30
Jensen_Eisai_groupA,1,5,ts-global_detected_seizures,237170,237196,26
Jensen_Eisai_groupA,2,6,ts-global_detected_seizures,237177,237202,25
Jensen_Eisai_groupA,1,5,ts-global_detected_seizures,237212,237266,54
Jensen_Eisai_groupA,2,6,ts-global_detected_seizures,237262,237289,27
Jensen_Eisai_groupA,1,5,ts-global_detected_seizures,237267,237292,25
Jensen_Eisai_groupA,2,6,ts-global_detected_seizures,237329,237375,46
Jensen_Eisai_groupA,1,5,ts-global_detected_seizures,237359,237381,22
Jensen_Eisai_groupA,1,5,ts-global_detected_seizures,237428,237459,31
Jensen_Eisai_groupA,1,5,ts-global_detected_seizures,237490,237517,27
Jensen_Eisai_groupA,2,6,ts-global_detected_seizures,237512,237568,56
Jensen_Eisai_groupA,2,6,ts-global_detected_seizures,237587,237673,86
Jensen_Eisai_groupA,1,5,ts-global_detected_seizures,237632,237662,30
Jensen_Eisai_groupA,2,6,ts-global_detected_seizures,237695,238163,468
Jensen_Eisai_groupA,1,5,ts-global_detected_seizures,237741,237765,24
Jensen_Eisai_groupA,1,5,ts-global_detected_seizures,237779,237862,83
Jensen_Eisai_groupA,1,5,ts-global_detected_seizures,237901,237932,31
Jensen_Eisai_groupA,1,5,ts-global_detected_seizures,237951,238049,98
Jensen_Eisai_groupA,1,5,ts-global_detected_seizures,238101,238134,33
Jensen_Eisai_groupA,1,5,ts-global_detected_seizures,238196,238261,65
Jensen_Eisai_groupA,2,6,ts-global_detected_seizures,238251,238278,27
Jensen_Eisai_groupA,1,5,ts-global_detected_seizures,238262,238288,26
Jensen_Eisai_groupA,1,5,ts-global_detected_seizures,238289,238325,36
Jensen_Eisai_groupA,1,5,ts-global_detected_seizures,238370,238463,93
Jensen_Eisai_groupA,2,6,ts-global_detected_seizures,238386,238415,29
Jensen_Eisai_groupA,2,6,ts-global_detected_seizures,238423,238469,46
Jensen_Eisai_groupA,1,5,ts-global_detected_seizures,238480,238521,41
Jensen_Eisai_groupA,2,6,ts-global_detected_seizures,238497,238519,22
Jensen_Eisai_groupA,1,5,ts-global_detected_seizures,238551,238588,37
Jensen_Eisai_groupA,2,6,ts-global_detected_seizures,238575,238615,40
Jensen_Eisai_groupA,1,5,ts-global_detected_seizures,238596,238753,157
Jensen_Eisai_groupA,2,6,ts-global_detected_seizures,238642,238674,32
Jensen_Eisai_groupA,2,6,ts-global_detected_seizures,238746,238791,45
Jensen_Eisai_groupA,1,5,ts-global_detected_seizures,238768,238824,56
Jensen_Eisai_groupA,2,6,ts-global_detected_seizures,238864,238896,32
Jensen_Eisai_groupA,1,5,ts-global_detected_seizures,238877,238934,57
Jensen_Eisai_groupA,2,6,ts-global_detected_seizures,238914,238937,23
Jensen_Eisai_groupA,1,5,ts-global_detected_seizures,238935,238974,39
Jensen_Eisai_groupA,1,5,ts-global_detected_seizures,238993,239033,40
Jensen_Eisai_groupA,2,6,ts-global_detected_seizures,238995,239032,37
Jensen_Eisai_groupA,2,6,ts-global_detected_seizures,239033,239075,42
Jensen_Eisai_groupA,1,5,ts-global_detected_seizures,239073,239146,73
Jensen_Eisai_groupA,1,5,ts-global_detected_seizures,239149,239235,86
Jensen_Eisai_groupA,1,5,ts-global_detected_seizures,239250,239284,34
Jensen_Eisai_groupA,1,5,ts-global_detected_seizures,239338,239496,158
Jensen_Eisai_groupA,2,6,ts-global_detected_seizures,239369,239394,25
Jensen_Eisai_groupA,2,6,ts-global_detected_seizures,239396,239436,40
Jensen_Eisai_groupA,2,6,ts-global_detected_seizures,239475,240764,1289
Jensen_Eisai_groupA,1,5,ts-global_detected_seizures,239498,239604,106
Jensen_Eisai_groupA,1,5,ts-global_detected_seizures,239623,239645,22
Jensen_Eisai_groupA,1,5,ts-global_detected_seizures,239646,239672,26
Jensen_Eisai_groupA,1,5,ts-global_detected_seizures,239678,239730,52
Jensen_Eisai_groupA,1,5,ts-global_detected_seizures,239737,239856,119
Jensen_Eisai_groupA,1,5,ts-global_detected_seizures,239887,244306,4419
Jensen_Eisai_groupA,2,6,ts-global_detected_seizures,240777,240801,24
Jensen_Eisai_groupA,2,6,ts-global_detected_seizures,240815,240849,34
Jensen_Eisai_groupA,2,6,ts-global_detected_seizures,240888,240919,31
Jensen_Eisai_groupA,2,6,ts-global_detected_seizures,240943,240979,36
Jensen_Eisai_groupA,2,6,ts-global_detected_seizures,241000,241037,37
Jensen_Eisai_groupA,2,6,ts-global_detected_seizures,241066,241090,24
Jensen_Eisai_groupA,2,6,ts-global_detected_seizures,241191,241231,40
Jensen_Eisai_groupA,2,6,ts-global_detected_seizures,241262,241284,22
Jensen_Eisai_groupA,2,6,ts-global_detected_seizures,241306,241331,25
Jensen_Eisai_groupA,2,6,ts-global_detected_seizures,241386,241422,36
Jensen_Eisai_groupA,2,6,ts-global_detected_seizures,241561,241590,29
Jensen_Eisai_groupA,2,6,ts-global_detected_seizures,241596,241683,87
Jensen_Eisai_groupA,2,6,ts-global_detected_seizures,241688,241714,26
Jensen_Eisai_groupA,2,6,ts-global_detected_seizures,241725,241752,27
Jensen_Eisai_groupA,2,6,ts-global_detected_seizures,241870,241895,25
Jensen_Eisai_groupA,2,6,ts-global_detected_seizures,241952,241991,39
Jensen_Eisai_groupA,2,6,ts-global_detected_seizures,242008,242030,22
Jensen_Eisai_groupA,2,6,ts-global_detected_seizures,242051,242084,33
Jensen_Eisai_groupA,2,6,ts-global_detected_seizures,242111,242133,22
Jensen_Eisai_groupA,2,6,ts-global_detected_seizures,242149,242173,24
Jensen_Eisai_groupA,2,6,ts-global_detected_seizures,242207,242229,22
Jensen_Eisai_groupA,2,6,ts-global_detected_seizures,242280,242314,34
Jensen_Eisai_groupA,2,6,ts-global_detected_seizures,242350,242384,34
Jensen_Eisai_groupA,2,6,ts-global_detected_seizures,242385,242425,40
Jensen_Eisai_groupA,2,6,ts-global_detected_seizures,242490,242533,43
Jensen_Eisai_groupA,2,6,ts-global_detected_seizures,242567,242616,49
Jensen_Eisai_groupA,2,6,ts-global_detected_seizures,242623,242657,34
Jensen_Eisai_groupA,2,6,ts-global_detected_seizures,242658,242688,30
Jensen_Eisai_groupA,2,6,ts-global_detected_seizures,242701,242723,22
Jensen_Eisai_groupA,2,6,ts-global_detected_seizures,242833,242856,23
Jensen_Eisai_groupA,2,6,ts-global_detected_seizures,242890,242918,28
Jensen_Eisai_groupA,2,6,ts-global_detected_seizures,242945,242976,31
Jensen_Eisai_groupA,2,6,ts-global_detected_seizures,243030,243059,29
Jensen_Eisai_groupA,2,6,ts-global_detected_seizures,243076,243235,159
Jensen_Eisai_groupA,2,6,ts-global_detected_seizures,243236,243262,26
Jensen_Eisai_groupA,2,6,ts-global_detected_seizures,243263,244063,800
Jensen_Eisai_groupA,2,6,ts-global_detected_seizures,244069,244871,802
Jensen_Eisai_groupA,1,5,ts-global_detected_seizures,244307,247272,2965
Jensen_Eisai_groupA,2,6,ts-global_detected_seizures,244886,244930,44
Jensen_Eisai_groupA,2,6,ts-global_detected_seizures,244957,244992,35
Jensen_Eisai_groupA,2,6,ts-global_detected_seizures,244993,245053,60
Jensen_Eisai_groupA,2,6,ts-global_detected_seizures,245054,245100,46
Jensen_Eisai_groupA,2,6,ts-global_detected_seizures,245102,245185,83
Jensen_Eisai_groupA,2,6,ts-global_detected_seizures,245186,246245,1059
Jensen_Eisai_groupA,2,6,ts-global_detected_seizures,246246,246322,76
Jensen_Eisai_groupA,2,6,ts-global_detected_seizures,246356,246400,44
Jensen_Eisai_groupA,2,6,ts-global_detected_seizures,246441,246505,64
Jensen_Eisai_groupA,2,6,ts-global_detected_seizures,246587,246609,22
Jensen_Eisai_groupA,2,6,ts-global_detected_seizures,246663,246687,24
Jensen_Eisai_groupA,2,6,ts-global_detected_seizures,246742,246774,32
Jensen_Eisai_groupA,2,6,ts-global_detected_seizures,246788,246822,34
Jensen_Eisai_groupA,2,6,ts-global_detected_seizures,246838,246876,38
Jensen_Eisai_groupA,2,6,ts-global_detected_seizures,246887,246909,22
Jensen_Eisai_groupA,2,6,ts-global_detected_seizures,247024,247066,42
Jensen_Eisai_groupA,2,6,ts-global_detected_seizures,247100,247130,30
Jensen_Eisai_groupA,2,6,ts-global_detected_seizures,247241,247265,24
Jensen_Eisai_groupA,1,5,ts-global_detected_seizures,247273,248055,782
Jensen_Eisai_groupA,2,6,ts-global_detected_seizures,247360,247390,30
Jensen_Eisai_groupA,2,6,ts-global_detected_seizures,247391,247430,39
Jensen_Eisai_groupA,2,6,ts-global_detected_seizures,247437,247462,25
Jensen_Eisai_groupA,2,6,ts-global_detected_seizures,247500,247522,22
Jensen_Eisai_groupA,2,6,ts-global_detected_seizures,247666,247691,25
Jensen_Eisai_groupA,2,6,ts-global_detected_seizures,247735,247770,35
Jensen_Eisai_groupA,2,6,ts-global_detected_seizures,247827,247869,42
Jensen_Eisai_groupA,2,6,ts-global_detected_seizures,247904,247938,34
Jensen_Eisai_groupA,2,6,ts-global_detected_seizures,247977,248016,39
Jensen_Eisai_groupA,1,5,ts-global_detected_seizures,248073,248808,735
Jensen_Eisai_groupA,2,6,ts-global_detected_seizures,248077,248104,27
Jensen_Eisai_groupA,2,6,ts-global_detected_seizures,248212,248283,71
Jensen_Eisai_groupA,2,6,ts-global_detected_seizures,248296,248329,33
Jensen_Eisai_groupA,2,6,ts-global_detected_seizures,248348,248377,29
Jensen_Eisai_groupA,2,6,ts-global_detected_seizures,248463,248502,39
Jensen_Eisai_groupA,2,6,ts-global_detected_seizures,248515,248555,40
Jensen_Eisai_groupA,2,6,ts-global_detected_seizures,248571,248600,29
Jensen_Eisai_groupA,2,6,ts-global_detected_seizures,248667,248703,36
Jensen_Eisai_groupA,2,6,ts-global_detected_seizures,248704,248738,34
Jensen_Eisai_groupA,2,6,ts-global_detected_seizures,248741,248774,33
Jensen_Eisai_groupA,2,6,ts-global_detected_seizures,248787,249351,564
Jensen_Eisai_groupA,1,5,ts-global_detected_seizures,248809,249290,481
Jensen_Eisai_groupA,1,5,ts-global_detected_seizures,249291,249525,234
Jensen_Eisai_groupA,2,6,ts-global_detected_seizures,249353,249503,150
Jensen_Eisai_groupA,2,6,ts-global_detected_seizures,249566,249591,25
Jensen_Eisai_groupA,2,6,ts-global_detected_seizures,249593,249619,26
Jensen_Eisai_groupA,2,6,ts-global_detected_seizures,249624,249661,37
Jensen_Eisai_groupA,1,5,ts-global_detected_seizures,249683,249719,36
Jensen_Eisai_groupA,2,6,ts-global_detected_seizures,249708,249751,43
Jensen_Eisai_groupA,1,5,ts-global_detected_seizures,249750,249826,76
Jensen_Eisai_groupA,2,6,ts-global_detected_seizures,249780,249808,28
Jensen_Eisai_groupA,2,6,ts-global_detected_seizures,249823,249868,45
Jensen_Eisai_groupA,2,6,ts-global_detected_seizures,249875,249900,25
Jensen_Eisai_groupA,2,6,ts-global_detected_seizures,249901,249926,25
Jensen_Eisai_groupA,1,5,ts-global_detected_seizures,249914,249975,61
Jensen_Eisai_groupA,2,6,ts-global_detected_seizures,249940,250544,604
Jensen_Eisai_groupA,1,5,ts-global_detected_seizures,250088,250136,48
Jensen_Eisai_groupA,1,5,ts-global_detected_seizures,250186,250210,24
Jensen_Eisai_groupA,1,5,ts-global_detected_seizures,250215,250242,27
Jensen_Eisai_groupA,1,5,ts-global_detected_seizures,250345,250462,117
Jensen_Eisai_groupA,1,5,ts-global_detected_seizures,250497,250520,23
Jensen_Eisai_groupA,1,5,ts-global_detected_seizures,250522,250562,40
Jensen_Eisai_groupA,2,6,ts-global_detected_seizures,250559,250596,37
Jensen_Eisai_groupA,2,6,ts-global_detected_seizures,250597,250623,26
Jensen_Eisai_groupA,2,6,ts-global_detected_seizures,250667,250716,49
Jensen_Eisai_groupA,1,5,ts-global_detected_seizures,250679,250789,110
Jensen_Eisai_groupA,2,6,ts-global_detected_seizures,250735,250764,29
Jensen_Eisai_groupA,2,6,ts-global_detected_seizures,250775,250803,28
Jensen_Eisai_groupA,2,6,ts-global_detected_seizures,250818,250844,26
Jensen_Eisai_groupA,1,5,ts-global_detected_seizures,250837,250859,22
Jensen_Eisai_groupA,2,6,ts-global_detected_seizures,250866,250893,27
Jensen_Eisai_groupA,2,6,ts-global_detected_seizures,250898,250922,24
Jensen_Eisai_groupA,1,5,ts-global_detected_seizures,250962,251030,68
Jensen_Eisai_groupA,2,6,ts-global_detected_seizures,251029,251074,45
Jensen_Eisai_groupA,1,5,ts-global_detected_seizures,251052,251074,22
Jensen_Eisai_groupA,1,5,ts-global_detected_seizures,251096,251134,38
Jensen_Eisai_groupA,2,6,ts-global_detected_seizures,251098,251121,23
Jensen_Eisai_groupA,2,6,ts-global_detected_seizures,251171,251202,31
Jensen_Eisai_groupA,1,5,ts-global_detected_seizures,251175,251207,32
Jensen_Eisai_groupA,1,5,ts-global_detected_seizures,251257,251280,23
Jensen_Eisai_groupA,2,6,ts-global_detected_seizures,251276,251298,22
Jensen_Eisai_groupA,1,5,ts-global_detected_seizures,251324,251375,51
Jensen_Eisai_groupA,2,6,ts-global_detected_seizures,251341,251373,32
Jensen_Eisai_groupA,1,5,ts-global_detected_seizures,251389,251462,73
Jensen_Eisai_groupA,2,6,ts-global_detected_seizures,251393,251415,22
Jensen_Eisai_groupA,2,6,ts-global_detected_seizures,251486,251509,23
Jensen_Eisai_groupA,1,5,ts-global_detected_seizures,251489,251538,49
Jensen_Eisai_groupA,1,5,ts-global_detected_seizures,251539,251576,37
Jensen_Eisai_groupA,2,6,ts-global_detected_seizures,251560,251583,23
Jensen_Eisai_groupA,2,6,ts-global_detected_seizures,251615,251646,31
Jensen_Eisai_groupA,1,5,ts-global_detected_seizures,251645,251765,120
Jensen_Eisai_groupA,2,6,ts-global_detected_seizures,251727,251752,25
Jensen_Eisai_groupA,1,5,ts-global_detected_seizures,251766,251818,52
Jensen_Eisai_groupA,2,6,ts-global_detected_seizures,251799,251821,22
Jensen_Eisai_groupA,1,5,ts-global_detected_seizures,251862,251957,95
Jensen_Eisai_groupA,2,6,ts-global_detected_seizures,251865,251899,34
Jensen_Eisai_groupA,2,6,ts-global_detected_seizures,251922,251952,30
Jensen_Eisai_groupA,1,5,ts-global_detected_seizures,251980,252057,77
Jensen_Eisai_groupA,2,6,ts-global_detected_seizures,251986,252027,41
Jensen_Eisai_groupA,2,6,ts-global_detected_seizures,252050,252093,43
Jensen_Eisai_groupA,1,5,ts-global_detected_seizures,252060,252083,23
Jensen_Eisai_groupA,1,5,ts-global_detected_seizures,252090,252186,96
Jensen_Eisai_groupA,2,6,ts-global_detected_seizures,252125,252148,23
Jensen_Eisai_groupA,2,6,ts-global_detected_seizures,252149,252172,23
Jensen_Eisai_groupA,2,6,ts-global_detected_seizures,252209,252242,33
Jensen_Eisai_groupA,1,5,ts-global_detected_seizures,252221,252271,50
Jensen_Eisai_groupA,2,6,ts-global_detected_seizures,252278,252316,38
Jensen_Eisai_groupA,2,6,ts-global_detected_seizures,252322,252348,26
Jensen_Eisai_groupA,1,5,ts-global_detected_seizures,252324,252482,158
Jensen_Eisai_groupA,2,6,ts-global_detected_seizures,252394,253248,854
Jensen_Eisai_groupA,1,5,ts-global_detected_seizures,252483,252638,155
Jensen_Eisai_groupA,1,5,ts-global_detected_seizures,252684,252754,70
Jensen_Eisai_groupA,1,5,ts-global_detected_seizures,252765,252992,227
Jensen_Eisai_groupA,1,5,ts-global_detected_seizures,252993,253036,43
Jensen_Eisai_groupA,1,5,ts-global_detected_seizures,253050,253077,27
Jensen_Eisai_groupA,1,5,ts-global_detected_seizures,253099,253160,61
Jensen_Eisai_groupA,1,5,ts-global_detected_seizures,253217,253511,294
Jensen_Eisai_groupA,2,6,ts-global_detected_seizures,253249,253801,552
Jensen_Eisai_groupA,1,5,ts-global_detected_seizures,253515,253609,94
Jensen_Eisai_groupA,1,5,ts-global_detected_seizures,253642,253726,84
Jensen_Eisai_groupA,1,5,ts-global_detected_seizures,253754,253802,48
Jensen_Eisai_groupA,2,6,ts-global_detected_seizures,253802,254195,393
Jensen_Eisai_groupA,1,5,ts-global_detected_seizures,253803,253841,38
Jensen_Eisai_groupA,1,5,ts-global_detected_seizures,253884,253936,52
Jensen_Eisai_groupA,1,5,ts-global_detected_seizures,253937,253982,45
Jensen_Eisai_groupA,1,5,ts-global_detected_seizures,253983,254014,31
Jensen_Eisai_groupA,1,5,ts-global_detected_seizures,254017,254088,71
Jensen_Eisai_groupA,1,5,ts-global_detected_seizures,254089,257663,3574
Jensen_Eisai_groupA,2,6,ts-global_detected_seizures,254220,254252,32
Jensen_Eisai_groupA,2,6,ts-global_detected_seizures,254297,254353,56
Jensen_Eisai_groupA,2,6,ts-global_detected_seizures,254357,254399,42
Jensen_Eisai_groupA,2,6,ts-global_detected_seizures,254402,254424,22
Jensen_Eisai_groupA,2,6,ts-global_detected_seizures,254476,256003,1527
Jensen_Eisai_groupA,2,6,ts-global_detected_seizures,256005,256030,25
Jensen_Eisai_groupA,2,6,ts-global_detected_seizures,256046,256089,43
Jensen_Eisai_groupA,2,6,ts-global_detected_seizures,256092,256117,25
Jensen_Eisai_groupA,2,6,ts-global_detected_seizures,256125,256221,96
Jensen_Eisai_groupA,2,6,ts-global_detected_seizures,256223,256273,50
Jensen_Eisai_groupA,2,6,ts-global_detected_seizures,256274,256394,120
Jensen_Eisai_groupA,2,6,ts-global_detected_seizures,256487,256752,265
Jensen_Eisai_groupA,2,6,ts-global_detected_seizures,256753,256972,219
Jensen_Eisai_groupA,2,6,ts-global_detected_seizures,256973,257249,276
Jensen_Eisai_groupA,2,6,ts-global_detected_seizures,257250,257278,28
Jensen_Eisai_groupA,2,6,ts-global_detected_seizures,257294,257326,32
Jensen_Eisai_groupA,2,6,ts-global_detected_seizures,257349,257375,26
Jensen_Eisai_groupA,2,6,ts-global_detected_seizures,257378,257508,130
Jensen_Eisai_groupA,2,6,ts-global_detected_seizures,257515,257539,24
Jensen_Eisai_groupA,2,6,ts-global_detected_seizures,257542,257565,23
Jensen_Eisai_groupA,2,6,ts-global_detected_seizures,257610,257635,25
Jensen_Eisai_groupA,2,6,ts-global_detected_seizures,257641,257669,28
Jensen_Eisai_groupA,1,5,ts-global_detected_seizures,257664,257703,39
Jensen_Eisai_groupA,2,6,ts-global_detected_seizures,257684,257711,27
Jensen_Eisai_groupA,1,5,ts-global_detected_seizures,257707,257948,241
Jensen_Eisai_groupA,2,6,ts-global_detected_seizures,257718,257745,27
Jensen_Eisai_groupA,2,6,ts-global_detected_seizures,257749,257948,199
Jensen_Eisai_groupA,4,8,ts-global_detected_seizures,258562,266757,8195
Jensen_Eisai_groupA,2,6,ts-global_detected_seizures,258646,259137,491
Jensen_Eisai_groupA,1,5,ts-global_detected_seizures,258936,258961,25
Jensen_Eisai_groupA,1,5,ts-global_detected_seizures,258989,259022,33
Jensen_Eisai_groupA,1,5,ts-global_detected_seizures,259070,259109,39
Jensen_Eisai_groupA,2,6,ts-global_detected_seizures,259144,259196,52
Jensen_Eisai_groupA,1,5,ts-global_detected_seizures,259169,259194,25
Jensen_Eisai_groupA,2,6,ts-global_detected_seizures,259221,259251,30
Jensen_Eisai_groupA,2,6,ts-global_detected_seizures,259252,259276,24
Jensen_Eisai_groupA,1,5,ts-global_detected_seizures,259262,259291,29
Jensen_Eisai_groupA,2,6,ts-global_detected_seizures,259282,259306,24
Jensen_Eisai_groupA,2,6,ts-global_detected_seizures,259338,259396,58
Jensen_Eisai_groupA,1,5,ts-global_detected_seizures,259343,259378,35
Jensen_Eisai_groupA,1,5,ts-global_detected_seizures,259417,259440,23
Jensen_Eisai_groupA,2,6,ts-global_detected_seizures,259491,259532,41
Jensen_Eisai_groupA,1,5,ts-global_detected_seizures,259531,259562,31
Jensen_Eisai_groupA,2,6,ts-global_detected_seizures,259565,259589,24
Jensen_Eisai_groupA,2,6,ts-global_detected_seizures,259610,259640,30
Jensen_Eisai_groupA,2,6,ts-global_detected_seizures,259678,259711,33
Jensen_Eisai_groupA,1,5,ts-global_detected_seizures,259770,259808,38
Jensen_Eisai_groupA,2,6,ts-global_detected_seizures,259810,259850,40
Jensen_Eisai_groupA,2,6,ts-global_detected_seizures,259852,259876,24
Jensen_Eisai_groupA,1,5,ts-global_detected_seizures,259886,259915,29
Jensen_Eisai_groupA,2,6,ts-global_detected_seizures,259901,259957,56
Jensen_Eisai_groupA,2,6,ts-global_detected_seizures,259971,259999,28
Jensen_Eisai_groupA,1,5,ts-global_detected_seizures,259988,260029,41
Jensen_Eisai_groupA,2,6,ts-global_detected_seizures,260020,260045,25
Jensen_Eisai_groupA,2,6,ts-global_detected_seizures,260067,260097,30
Jensen_Eisai_groupA,1,5,ts-global_detected_seizures,260091,260115,24
Jensen_Eisai_groupA,1,5,ts-global_detected_seizures,260116,260179,63
Jensen_Eisai_groupA,2,6,ts-global_detected_seizures,260204,260266,62
Jensen_Eisai_groupA,1,5,ts-global_detected_seizures,260234,260264,30
Jensen_Eisai_groupA,1,5,ts-global_detected_seizures,260266,260336,70
Jensen_Eisai_groupA,2,6,ts-global_detected_seizures,260280,260369,89
Jensen_Eisai_groupA,1,5,ts-global_detected_seizures,260367,260393,26
Jensen_Eisai_groupA,2,6,ts-global_detected_seizures,260372,260423,51
Jensen_Eisai_groupA,1,5,ts-global_detected_seizures,260413,260451,38
Jensen_Eisai_groupA,2,6,ts-global_detected_seizures,260456,260488,32
Jensen_Eisai_groupA,1,5,ts-global_detected_seizures,260485,260516,31
Jensen_Eisai_groupA,2,6,ts-global_detected_seizures,260503,260539,36
Jensen_Eisai_groupA,1,5,ts-global_detected_seizures,260520,260543,23
Jensen_Eisai_groupA,2,6,ts-global_detected_seizures,260547,260579,32
Jensen_Eisai_groupA,1,5,ts-global_detected_seizures,260551,260574,23
Jensen_Eisai_groupA,2,6,ts-global_detected_seizures,260609,260646,37
Jensen_Eisai_groupA,1,5,ts-global_detected_seizures,260632,260654,22
Jensen_Eisai_groupA,2,6,ts-global_detected_seizures,260654,260680,26
Jensen_Eisai_groupA,1,5,ts-global_detected_seizures,260655,260683,28
Jensen_Eisai_groupA,1,5,ts-global_detected_seizures,260688,260713,25
Jensen_Eisai_groupA,1,5,ts-global_detected_seizures,260728,260766,38
Jensen_Eisai_groupA,2,6,ts-global_detected_seizures,260755,260800,45
Jensen_Eisai_groupA,1,5,ts-global_detected_seizures,260790,260822,32
Jensen_Eisai_groupA,1,5,ts-global_detected_seizures,260833,260884,51
Jensen_Eisai_groupA,2,6,ts-global_detected_seizures,260841,260869,28
Jensen_Eisai_groupA,2,6,ts-global_detected_seizures,260926,260959,33
Jensen_Eisai_groupA,1,5,ts-global_detected_seizures,260946,260973,27
Jensen_Eisai_groupA,2,6,ts-global_detected_seizures,260972,260994,22
Jensen_Eisai_groupA,1,5,ts-global_detected_seizures,261004,261041,37
Jensen_Eisai_groupA,2,6,ts-global_detected_seizures,261042,261066,24
Jensen_Eisai_groupA,2,6,ts-global_detected_seizures,261093,261131,38
Jensen_Eisai_groupA,1,5,ts-global_detected_seizures,261134,261205,71
Jensen_Eisai_groupA,2,6,ts-global_detected_seizures,261161,261206,45
Jensen_Eisai_groupA,2,6,ts-global_detected_seizures,261233,261259,26
Jensen_Eisai_groupA,1,5,ts-global_detected_seizures,261265,261327,62
Jensen_Eisai_groupA,1,5,ts-global_detected_seizures,261328,261417,89
Jensen_Eisai_groupA,2,6,ts-global_detected_seizures,261333,261375,42
Jensen_Eisai_groupA,1,5,ts-global_detected_seizures,261425,261465,40
Jensen_Eisai_groupA,2,6,ts-global_detected_seizures,261446,261471,25
Jensen_Eisai_groupA,1,5,ts-global_detected_seizures,261480,261517,37
Jensen_Eisai_groupA,2,6,ts-global_detected_seizures,261489,261523,34
Jensen_Eisai_groupA,1,5,ts-global_detected_seizures,261528,261554,26
Jensen_Eisai_groupA,2,6,ts-global_detected_seizures,261572,261615,43
Jensen_Eisai_groupA,1,5,ts-global_detected_seizures,261616,261782,166
Jensen_Eisai_groupA,2,6,ts-global_detected_seizures,261680,261702,22
Jensen_Eisai_groupA,2,6,ts-global_detected_seizures,261703,261745,42
Jensen_Eisai_groupA,1,5,ts-global_detected_seizures,261783,261828,45
Jensen_Eisai_groupA,1,5,ts-global_detected_seizures,261844,261902,58
Jensen_Eisai_groupA,2,6,ts-global_detected_seizures,261892,261920,28
Jensen_Eisai_groupA,1,5,ts-global_detected_seizures,261935,261970,35
Jensen_Eisai_groupA,1,5,ts-global_detected_seizures,261986,262032,46
Jensen_Eisai_groupA,2,6,ts-global_detected_seizures,261987,262028,41
Jensen_Eisai_groupA,1,5,ts-global_detected_seizures,262059,262134,75
Jensen_Eisai_groupA,2,6,ts-global_detected_seizures,262095,262119,24
Jensen_Eisai_groupA,1,5,ts-global_detected_seizures,262150,262173,23
Jensen_Eisai_groupA,2,6,ts-global_detected_seizures,262184,262207,23
Jensen_Eisai_groupA,1,5,ts-global_detected_seizures,262199,262245,46
Jensen_Eisai_groupA,2,6,ts-global_detected_seizures,262225,262247,22
Jensen_Eisai_groupA,1,5,ts-global_detected_seizures,262255,262298,43
Jensen_Eisai_groupA,1,5,ts-global_detected_seizures,262255,262298,43
Jensen_Eisai_groupA,1,5,ts-global_detected_seizures,262299,262373,74
Jensen_Eisai_groupA,2,6,ts-global_detected_seizures,262305,262336,31
Jensen_Eisai_groupA,2,6,ts-global_detected_seizures,262363,262398,35
Jensen_Eisai_groupA,1,5,ts-global_detected_seizures,262403,262457,54
Jensen_Eisai_groupA,1,5,ts-global_detected_seizures,262459,262535,76
Jensen_Eisai_groupA,2,6,ts-global_detected_seizures,262468,262490,22
Jensen_Eisai_groupA,2,6,ts-global_detected_seizures,262531,262564,33
Jensen_Eisai_groupA,1,5,ts-global_detected_seizures,262536,262610,74
Jensen_Eisai_groupA,2,6,ts-global_detected_seizures,262587,262652,65
Jensen_Eisai_groupA,1,5,ts-global_detected_seizures,262653,262698,45
Jensen_Eisai_groupA,2,6,ts-global_detected_seizures,262674,262702,28
Jensen_Eisai_groupA,1,5,ts-global_detected_seizures,262715,262782,67
Jensen_Eisai_groupA,2,6,ts-global_detected_seizures,262720,262758,38
Jensen_Eisai_groupA,1,5,ts-global_detected_seizures,262783,262831,48
Jensen_Eisai_groupA,2,6,ts-global_detected_seizures,262797,262832,35
Jensen_Eisai_groupA,2,6,ts-global_detected_seizures,262847,262878,31
Jensen_Eisai_groupA,1,5,ts-global_detected_seizures,262858,262899,41
Jensen_Eisai_groupA,1,5,ts-global_detected_seizures,262900,262931,31
Jensen_Eisai_groupA,2,6,ts-global_detected_seizures,262919,262948,29
Jensen_Eisai_groupA,1,5,ts-global_detected_seizures,262935,262957,22
Jensen_Eisai_groupA,2,6,ts-global_detected_seizures,262970,263000,30
Jensen_Eisai_groupA,1,5,ts-global_detected_seizures,262977,265545,2568
Jensen_Eisai_groupA,2,6,ts-global_detected_seizures,263034,263060,26
Jensen_Eisai_groupA,2,6,ts-global_detected_seizures,263111,263138,27
Jensen_Eisai_groupA,2,6,ts-global_detected_seizures,263184,263216,32
Jensen_Eisai_groupA,2,6,ts-global_detected_seizures,263240,263273,33
Jensen_Eisai_groupA,2,6,ts-global_detected_seizures,263335,263447,112
Jensen_Eisai_groupA,2,6,ts-global_detected_seizures,263470,263511,41
Jensen_Eisai_groupA,2,6,ts-global_detected_seizures,263706,263730,24
Jensen_Eisai_groupA,2,6,ts-global_detected_seizures,263731,263781,50
Jensen_Eisai_groupA,2,6,ts-global_detected_seizures,263786,263812,26
Jensen_Eisai_groupA,2,6,ts-global_detected_seizures,263858,263894,36
Jensen_Eisai_groupA,2,6,ts-global_detected_seizures,263953,264001,48
Jensen_Eisai_groupA,2,6,ts-global_detected_seizures,264037,264062,25
Jensen_Eisai_groupA,2,6,ts-global_detected_seizures,264066,264090,24
Jensen_Eisai_groupA,2,6,ts-global_detected_seizures,264111,264173,62
Jensen_Eisai_groupA,2,6,ts-global_detected_seizures,264176,264210,34
Jensen_Eisai_groupA,2,6,ts-global_detected_seizures,264237,264297,60
Jensen_Eisai_groupA,2,6,ts-global_detected_seizures,264302,264333,31
Jensen_Eisai_groupA,2,6,ts-global_detected_seizures,264361,264398,37
Jensen_Eisai_groupA,2,6,ts-global_detected_seizures,264404,264428,24
Jensen_Eisai_groupA,2,6,ts-global_detected_seizures,264476,264520,44
Jensen_Eisai_groupA,2,6,ts-global_detected_seizures,264547,264572,25
Jensen_Eisai_groupA,2,6,ts-global_detected_seizures,264605,264631,26
Jensen_Eisai_groupA,2,6,ts-global_detected_seizures,264718,264754,36
Jensen_Eisai_groupA,2,6,ts-global_detected_seizures,264809,264839,30
Jensen_Eisai_groupA,2,6,ts-global_detected_seizures,264890,264925,35
Jensen_Eisai_groupA,2,6,ts-global_detected_seizures,264926,264951,25
Jensen_Eisai_groupA,2,6,ts-global_detected_seizures,264984,265008,24
Jensen_Eisai_groupA,2,6,ts-global_detected_seizures,265040,265076,36
Jensen_Eisai_groupA,2,6,ts-global_detected_seizures,265147,265196,49
Jensen_Eisai_groupA,2,6,ts-global_detected_seizures,265237,265266,29
Jensen_Eisai_groupA,2,6,ts-global_detected_seizures,265367,265403,36
Jensen_Eisai_groupA,2,6,ts-global_detected_seizures,265436,265470,34
Jensen_Eisai_groupA,2,6,ts-global_detected_seizures,265530,265586,56
Jensen_Eisai_groupA,1,5,ts-global_detected_seizures,265591,265649,58
Jensen_Eisai_groupA,2,6,ts-global_detected_seizures,265596,265640,44
Jensen_Eisai_groupA,2,6,ts-global_detected_seizures,265678,265712,34
Jensen_Eisai_groupA,2,6,ts-global_detected_seizures,265749,265806,57
Jensen_Eisai_groupA,1,5,ts-global_detected_seizures,265750,265818,68
Jensen_Eisai_groupA,2,6,ts-global_detected_seizures,265818,265869,51
Jensen_Eisai_groupA,1,5,ts-global_detected_seizures,265819,265844,25
Jensen_Eisai_groupA,1,5,ts-global_detected_seizures,265845,265883,38
Jensen_Eisai_groupA,2,6,ts-global_detected_seizures,265884,265947,63
Jensen_Eisai_groupA,1,5,ts-global_detected_seizures,265896,265932,36
Jensen_Eisai_groupA,2,6,ts-global_detected_seizures,265964,266001,37
Jensen_Eisai_groupA,1,5,ts-global_detected_seizures,265998,266033,35
Jensen_Eisai_groupA,2,6,ts-global_detected_seizures,266012,266037,25
Jensen_Eisai_groupA,1,5,ts-global_detected_seizures,266061,266116,55
Jensen_Eisai_groupA,2,6,ts-global_detected_seizures,266144,266196,52
Jensen_Eisai_groupA,1,5,ts-global_detected_seizures,266163,266321,158
Jensen_Eisai_groupA,2,6,ts-global_detected_seizures,266224,266248,24
Jensen_Eisai_groupA,2,6,ts-global_detected_seizures,266276,266316,40
Jensen_Eisai_groupA,2,6,ts-global_detected_seizures,266393,266428,35
Jensen_Eisai_groupA,1,5,ts-global_detected_seizures,266419,266459,40
Jensen_Eisai_groupA,2,6,ts-global_detected_seizures,266455,266699,244
Jensen_Eisai_groupA,1,5,ts-global_detected_seizures,266464,266494,30
Jensen_Eisai_groupA,1,5,ts-global_detected_seizures,266497,266550,53
Jensen_Eisai_groupA,1,5,ts-global_detected_seizures,266552,266576,24
Jensen_Eisai_groupA,1,5,ts-global_detected_seizures,266589,266616,27
Jensen_Eisai_groupA,1,5,ts-global_detected_seizures,266638,266668,30
Jensen_Eisai_groupA,1,5,ts-global_detected_seizures,266698,266803,105
Jensen_Eisai_groupA,2,6,ts-global_detected_seizures,266701,266823,122
Jensen_Eisai_groupA,4,8,ts-global_detected_seizures,266758,284680,17922
Jensen_Eisai_groupA,2,6,ts-global_detected_seizures,266824,266870,46
Jensen_Eisai_groupA,1,5,ts-global_detected_seizures,266886,266955,69
Jensen_Eisai_groupA,2,6,ts-global_detected_seizures,266969,266994,25
Jensen_Eisai_groupA,1,5,ts-global_detected_seizures,266992,267016,24
Jensen_Eisai_groupA,2,6,ts-global_detected_seizures,267014,267068,54
Jensen_Eisai_groupA,1,5,ts-global_detected_seizures,267045,267071,26
Jensen_Eisai_groupA,2,6,ts-global_detected_seizures,267096,267171,75
Jensen_Eisai_groupA,1,5,ts-global_detected_seizures,267119,267266,147
Jensen_Eisai_groupA,2,6,ts-global_detected_seizures,267229,267266,37
Jensen_Eisai_groupA,1,5,ts-global_detected_seizures,267267,267349,82
Jensen_Eisai_groupA,2,6,ts-global_detected_seizures,267289,267322,33
Jensen_Eisai_groupA,1,5,ts-global_detected_seizures,267351,267405,54
Jensen_Eisai_groupA,2,6,ts-global_detected_seizures,267386,267413,27
Jensen_Eisai_groupA,1,5,ts-global_detected_seizures,267441,267477,36
Jensen_Eisai_groupA,2,6,ts-global_detected_seizures,267472,267500,28
Jensen_Eisai_groupA,1,5,ts-global_detected_seizures,267518,267559,41
Jensen_Eisai_groupA,2,6,ts-global_detected_seizures,267531,267575,44
Jensen_Eisai_groupA,1,5,ts-global_detected_seizures,267606,267691,85
Jensen_Eisai_groupA,2,6,ts-global_detected_seizures,267638,267677,39
Jensen_Eisai_groupA,1,5,ts-global_detected_seizures,267692,267741,49
Jensen_Eisai_groupA,2,6,ts-global_detected_seizures,267720,267752,32
Jensen_Eisai_groupA,1,5,ts-global_detected_seizures,267769,267837,68
Jensen_Eisai_groupA,2,6,ts-global_detected_seizures,267791,267826,35
Jensen_Eisai_groupA,2,6,ts-global_detected_seizures,267848,267876,28
Jensen_Eisai_groupA,1,5,ts-global_detected_seizures,267854,267889,35
Jensen_Eisai_groupA,1,5,ts-global_detected_seizures,267905,267943,38
Jensen_Eisai_groupA,2,6,ts-global_detected_seizures,267917,267951,34
Jensen_Eisai_groupA,1,5,ts-global_detected_seizures,267954,267989,35
Jensen_Eisai_groupA,1,5,ts-global_detected_seizures,267998,268061,63
Jensen_Eisai_groupA,2,6,ts-global_detected_seizures,268021,268045,24
Jensen_Eisai_groupA,2,6,ts-global_detected_seizures,268076,268113,37
Jensen_Eisai_groupA,1,5,ts-global_detected_seizures,268079,268452,373
Jensen_Eisai_groupA,2,6,ts-global_detected_seizures,268169,268214,45
Jensen_Eisai_groupA,2,6,ts-global_detected_seizures,268235,268270,35
Jensen_Eisai_groupA,2,6,ts-global_detected_seizures,268290,268317,27
Jensen_Eisai_groupA,2,6,ts-global_detected_seizures,268346,268374,28
Jensen_Eisai_groupA,2,6,ts-global_detected_seizures,268409,268444,35
Jensen_Eisai_groupA,1,5,ts-global_detected_seizures,268454,268484,30
Jensen_Eisai_groupA,1,5,ts-global_detected_seizures,268492,268538,46
Jensen_Eisai_groupA,2,6,ts-global_detected_seizures,268513,268552,39
Jensen_Eisai_groupA,1,5,ts-global_detected_seizures,268540,268613,73
Jensen_Eisai_groupA,2,6,ts-global_detected_seizures,268576,268601,25
Jensen_Eisai_groupA,2,6,ts-global_detected_seizures,268614,268639,25
Jensen_Eisai_groupA,1,5,ts-global_detected_seizures,268619,268690,71
Jensen_Eisai_groupA,2,6,ts-global_detected_seizures,268671,268707,36
Jensen_Eisai_groupA,1,5,ts-global_detected_seizures,268691,268714,23
Jensen_Eisai_groupA,2,6,ts-global_detected_seizures,268742,268773,31
Jensen_Eisai_groupA,1,5,ts-global_detected_seizures,268751,268793,42
Jensen_Eisai_groupA,2,6,ts-global_detected_seizures,268799,268836,37
Jensen_Eisai_groupA,1,5,ts-global_detected_seizures,268824,268923,99
Jensen_Eisai_groupA,2,6,ts-global_detected_seizures,268881,268903,22
Jensen_Eisai_groupA,2,6,ts-global_detected_seizures,268922,268951,29
Jensen_Eisai_groupA,2,6,ts-global_detected_seizures,268961,268984,23
Jensen_Eisai_groupA,1,5,ts-global_detected_seizures,269052,269105,53
Jensen_Eisai_groupA,2,6,ts-global_detected_seizures,269081,269103,22
Jensen_Eisai_groupA,1,5,ts-global_detected_seizures,269106,269128,22
Jensen_Eisai_groupA,1,5,ts-global_detected_seizures,269152,269282,130
Jensen_Eisai_groupA,2,6,ts-global_detected_seizures,269161,269205,44
Jensen_Eisai_groupA,2,6,ts-global_detected_seizures,269220,269242,22
Jensen_Eisai_groupA,2,6,ts-global_detected_seizures,269255,269293,38
Jensen_Eisai_groupA,2,6,ts-global_detected_seizures,269305,269328,23
Jensen_Eisai_groupA,1,5,ts-global_detected_seizures,269318,269355,37
Jensen_Eisai_groupA,2,6,ts-global_detected_seizures,269341,269363,22
Jensen_Eisai_groupA,1,5,ts-global_detected_seizures,269376,269415,39
Jensen_Eisai_groupA,2,6,ts-global_detected_seizures,269386,269411,25
Jensen_Eisai_groupA,1,5,ts-global_detected_seizures,269416,269504,88
Jensen_Eisai_groupA,2,6,ts-global_detected_seizures,269436,269470,34
Jensen_Eisai_groupA,2,6,ts-global_detected_seizures,269490,270306,816
Jensen_Eisai_groupA,1,5,ts-global_detected_seizures,269548,269768,220
Jensen_Eisai_groupA,1,5,ts-global_detected_seizures,269801,269867,66
Jensen_Eisai_groupA,1,5,ts-global_detected_seizures,269869,271583,1714
Jensen_Eisai_groupA,2,6,ts-global_detected_seizures,270308,270356,48
Jensen_Eisai_groupA,2,6,ts-global_detected_seizures,270360,270400,40
Jensen_Eisai_groupA,2,6,ts-global_detected_seizures,270402,270465,63
Jensen_Eisai_groupA,2,6,ts-global_detected_seizures,270513,270546,33
Jensen_Eisai_groupA,2,6,ts-global_detected_seizures,270557,270746,189
Jensen_Eisai_groupA,2,6,ts-global_detected_seizures,270806,270852,46
Jensen_Eisai_groupA,2,6,ts-global_detected_seizures,270866,270888,22
Jensen_Eisai_groupA,2,6,ts-global_detected_seizures,270890,270928,38
Jensen_Eisai_groupA,2,6,ts-global_detected_seizures,270932,270970,38
Jensen_Eisai_groupA,2,6,ts-global_detected_seizures,271002,271144,142
Jensen_Eisai_groupA,2,6,ts-global_detected_seizures,271145,271261,116
Jensen_Eisai_groupA,2,6,ts-global_detected_seizures,271262,271413,151
Jensen_Eisai_groupA,2,6,ts-global_detected_seizures,271423,271545,122
Jensen_Eisai_groupA,2,6,ts-global_detected_seizures,271554,271591,37
Jensen_Eisai_groupA,1,5,ts-global_detected_seizures,271596,271620,24
Jensen_Eisai_groupA,2,6,ts-global_detected_seizures,271597,271623,26
Jensen_Eisai_groupA,1,5,ts-global_detected_seizures,271639,271668,29
Jensen_Eisai_groupA,2,6,ts-global_detected_seizures,271658,271684,26
Jensen_Eisai_groupA,1,5,ts-global_detected_seizures,271685,271709,24
Jensen_Eisai_groupA,2,6,ts-global_detected_seizures,271706,271734,28
Jensen_Eisai_groupA,1,5,ts-global_detected_seizures,271710,271753,43
Jensen_Eisai_groupA,2,6,ts-global_detected_seizures,271742,271764,22
Jensen_Eisai_groupA,1,5,ts-global_detected_seizures,271754,271787,33
Jensen_Eisai_groupA,2,6,ts-global_detected_seizures,271791,271836,45
Jensen_Eisai_groupA,1,5,ts-global_detected_seizures,271812,271844,32
Jensen_Eisai_groupA,1,5,ts-global_detected_seizures,271845,271871,26
Jensen_Eisai_groupA,2,6,ts-global_detected_seizures,271853,271880,27
Jensen_Eisai_groupA,1,5,ts-global_detected_seizures,271894,271919,25
Jensen_Eisai_groupA,1,5,ts-global_detected_seizures,271973,272320,347
Jensen_Eisai_groupA,2,6,ts-global_detected_seizures,271983,272016,33
Jensen_Eisai_groupA,2,6,ts-global_detected_seizures,272058,272106,48
Jensen_Eisai_groupA,2,6,ts-global_detected_seizures,272148,272170,22
Jensen_Eisai_groupA,2,6,ts-global_detected_seizures,272182,272216,34
Jensen_Eisai_groupA,2,6,ts-global_detected_seizures,272266,272293,27
Jensen_Eisai_groupA,1,5,ts-global_detected_seizures,272321,272350,29
Jensen_Eisai_groupA,2,6,ts-global_detected_seizures,272332,272355,23
Jensen_Eisai_groupA,1,5,ts-global_detected_seizures,272363,272431,68
Jensen_Eisai_groupA,2,6,ts-global_detected_seizures,272386,272413,27
Jensen_Eisai_groupA,2,6,ts-global_detected_seizures,272433,272465,32
Jensen_Eisai_groupA,1,5,ts-global_detected_seizures,272443,272473,30
Jensen_Eisai_groupA,1,5,ts-global_detected_seizures,272498,272525,27
Jensen_Eisai_groupA,2,6,ts-global_detected_seizures,272545,272572,27
Jensen_Eisai_groupA,2,6,ts-global_detected_seizures,272575,272626,51
Jensen_Eisai_groupA,2,6,ts-global_detected_seizures,272627,272676,49
Jensen_Eisai_groupA,1,5,ts-global_detected_seizures,272652,272677,25
Jensen_Eisai_groupA,2,6,ts-global_detected_seizures,272679,272701,22
Jensen_Eisai_groupA,2,6,ts-global_detected_seizures,272704,272739,35
Jensen_Eisai_groupA,1,5,ts-global_detected_seizures,272712,272736,24
Jensen_Eisai_groupA,2,6,ts-global_detected_seizures,272750,272776,26
Jensen_Eisai_groupA,1,5,ts-global_detected_seizures,272770,272805,35
Jensen_Eisai_groupA,2,6,ts-global_detected_seizures,272804,272852,48
Jensen_Eisai_groupA,1,5,ts-global_detected_seizures,272836,273001,165
Jensen_Eisai_groupA,2,6,ts-global_detected_seizures,272885,272914,29
Jensen_Eisai_groupA,2,6,ts-global_detected_seizures,272922,273019,97
Jensen_Eisai_groupA,2,6,ts-global_detected_seizures,273021,273053,32
Jensen_Eisai_groupA,1,5,ts-global_detected_seizures,273035,273065,30
Jensen_Eisai_groupA,1,5,ts-global_detected_seizures,273066,273099,33
Jensen_Eisai_groupA,2,6,ts-global_detected_seizures,273067,273644,577
Jensen_Eisai_groupA,1,5,ts-global_detected_seizures,273109,273142,33
Jensen_Eisai_groupA,1,5,ts-global_detected_seizures,273188,273243,55
Jensen_Eisai_groupA,1,5,ts-global_detected_seizures,273249,273310,61
Jensen_Eisai_groupA,1,5,ts-global_detected_seizures,273315,273371,56
Jensen_Eisai_groupA,1,5,ts-global_detected_seizures,273400,273430,30
Jensen_Eisai_groupA,1,5,ts-global_detected_seizures,273451,273475,24
Jensen_Eisai_groupA,1,5,ts-global_detected_seizures,273486,273513,27
Jensen_Eisai_groupA,1,5,ts-global_detected_seizures,273515,273618,103
Jensen_Eisai_groupA,1,5,ts-global_detected_seizures,273653,273698,45
Jensen_Eisai_groupA,2,6,ts-global_detected_seizures,273687,273715,28
Jensen_Eisai_groupA,1,5,ts-global_detected_seizures,273706,273944,238
Jensen_Eisai_groupA,2,6,ts-global_detected_seizures,273732,273762,30
Jensen_Eisai_groupA,2,6,ts-global_detected_seizures,273766,273798,32
Jensen_Eisai_groupA,2,6,ts-global_detected_seizures,273889,273921,32
Jensen_Eisai_groupA,2,6,ts-global_detected_seizures,273947,273989,42
Jensen_Eisai_groupA,1,5,ts-global_detected_seizures,273955,273987,32
Jensen_Eisai_groupA,2,6,ts-global_detected_seizures,274009,274036,27
Jensen_Eisai_groupA,1,5,ts-global_detected_seizures,274032,274067,35
Jensen_Eisai_groupA,2,6,ts-global_detected_seizures,274052,274088,36
Jensen_Eisai_groupA,1,5,ts-global_detected_seizures,274068,274095,27
Jensen_Eisai_groupA,1,5,ts-global_detected_seizures,274107,274140,33
Jensen_Eisai_groupA,2,6,ts-global_detected_seizures,274132,274177,45
Jensen_Eisai_groupA,1,5,ts-global_detected_seizures,274149,274287,138
Jensen_Eisai_groupA,2,6,ts-global_detected_seizures,274241,274281,40
Jensen_Eisai_groupA,1,5,ts-global_detected_seizures,274291,274337,46
Jensen_Eisai_groupA,2,6,ts-global_detected_seizures,274309,274333,24
Jensen_Eisai_groupA,1,5,ts-global_detected_seizures,274338,274385,47
Jensen_Eisai_groupA,2,6,ts-global_detected_seizures,274371,274406,35
Jensen_Eisai_groupA,1,5,ts-global_detected_seizures,274425,274502,77
Jensen_Eisai_groupA,2,6,ts-global_detected_seizures,274454,274480,26
Jensen_Eisai_groupA,1,5,ts-global_detected_seizures,274519,274586,67
Jensen_Eisai_groupA,2,6,ts-global_detected_seizures,274567,274595,28
Jensen_Eisai_groupA,2,6,ts-global_detected_seizures,274630,274654,24
Jensen_Eisai_groupA,1,5,ts-global_detected_seizures,274662,274695,33
Jensen_Eisai_groupA,1,5,ts-global_detected_seizures,274697,274897,200
Jensen_Eisai_groupA,2,6,ts-global_detected_seizures,274708,274730,22
Jensen_Eisai_groupA,1,5,ts-global_detected_seizures,274914,274947,33
Jensen_Eisai_groupA,2,6,ts-global_detected_seizures,274954,274979,25
Jensen_Eisai_groupA,1,5,ts-global_detected_seizures,274985,275223,238
Jensen_Eisai_groupA,2,6,ts-global_detected_seizures,275051,275098,47
Jensen_Eisai_groupA,2,6,ts-global_detected_seizures,275178,275216,38
Jensen_Eisai_groupA,2,6,ts-global_detected_seizures,275217,275375,158
Jensen_Eisai_groupA,1,5,ts-global_detected_seizures,275245,275270,25
Jensen_Eisai_groupA,1,5,ts-global_detected_seizures,275301,275331,30
Jensen_Eisai_groupA,1,5,ts-global_detected_seizures,275355,275388,33
Jensen_Eisai_groupA,1,5,ts-global_detected_seizures,275404,275447,43
Jensen_Eisai_groupA,2,6,ts-global_detected_seizures,275457,275481,24
Jensen_Eisai_groupA,1,5,ts-global_detected_seizures,275470,275522,52
Jensen_Eisai_groupA,2,6,ts-global_detected_seizures,275491,275516,25
Jensen_Eisai_groupA,2,6,ts-global_detected_seizures,275532,275554,22
Jensen_Eisai_groupA,1,5,ts-global_detected_seizures,275567,275866,299
Jensen_Eisai_groupA,2,6,ts-global_detected_seizures,275575,275602,27
Jensen_Eisai_groupA,2,6,ts-global_detected_seizures,275641,275672,31
Jensen_Eisai_groupA,2,6,ts-global_detected_seizures,275743,275772,29
Jensen_Eisai_groupA,2,6,ts-global_detected_seizures,275778,275810,32
Jensen_Eisai_groupA,2,6,ts-global_detected_seizures,275847,275874,27
Jensen_Eisai_groupA,2,6,ts-global_detected_seizures,275892,275923,31
Jensen_Eisai_groupA,1,5,ts-global_detected_seizures,275894,275927,33
Jensen_Eisai_groupA,1,5,ts-global_detected_seizures,275938,275977,39
Jensen_Eisai_groupA,1,5,ts-global_detected_seizures,275979,276010,31
Jensen_Eisai_groupA,2,6,ts-global_detected_seizures,275988,276026,38
Jensen_Eisai_groupA,2,6,ts-global_detected_seizures,276057,276087,30
Jensen_Eisai_groupA,1,5,ts-global_detected_seizures,276079,276158,79
Jensen_Eisai_groupA,2,6,ts-global_detected_seizures,276089,276156,67
Jensen_Eisai_groupA,1,5,ts-global_detected_seizures,276159,276199,40
Jensen_Eisai_groupA,2,6,ts-global_detected_seizures,276171,276225,54
Jensen_Eisai_groupA,1,5,ts-global_detected_seizures,276211,276270,59
Jensen_Eisai_groupA,2,6,ts-global_detected_seizures,276237,276291,54
Jensen_Eisai_groupA,1,5,ts-global_detected_seizures,276271,276328,57
Jensen_Eisai_groupA,2,6,ts-global_detected_seizures,276308,276363,55
Jensen_Eisai_groupA,1,5,ts-global_detected_seizures,276329,276364,35
Jensen_Eisai_groupA,2,6,ts-global_detected_seizures,276367,276817,450
Jensen_Eisai_groupA,1,5,ts-global_detected_seizures,276368,276400,32
Jensen_Eisai_groupA,1,5,ts-global_detected_seizures,276436,276498,62
Jensen_Eisai_groupA,1,5,ts-global_detected_seizures,276513,276564,51
Jensen_Eisai_groupA,1,5,ts-global_detected_seizures,276576,276599,23
Jensen_Eisai_groupA,1,5,ts-global_detected_seizures,276614,276672,58
Jensen_Eisai_groupA,1,5,ts-global_detected_seizures,276695,276727,32
Jensen_Eisai_groupA,1,5,ts-global_detected_seizures,276756,276779,23
Jensen_Eisai_groupA,2,6,ts-global_detected_seizures,276818,276910,92
Jensen_Eisai_groupA,1,5,ts-global_detected_seizures,276824,276944,120
Jensen_Eisai_groupA,2,6,ts-global_detected_seizures,276913,276943,30
Jensen_Eisai_groupA,2,6,ts-global_detected_seizures,276948,276976,28
Jensen_Eisai_groupA,1,5,ts-global_detected_seizures,276953,277075,122
Jensen_Eisai_groupA,2,6,ts-global_detected_seizures,276985,277012,27
Jensen_Eisai_groupA,2,6,ts-global_detected_seizures,277025,277112,87
Jensen_Eisai_groupA,1,5,ts-global_detected_seizures,277078,277111,33
Jensen_Eisai_groupA,1,5,ts-global_detected_seizures,277123,277174,51
Jensen_Eisai_groupA,2,6,ts-global_detected_seizures,277124,277161,37
Jensen_Eisai_groupA,2,6,ts-global_detected_seizures,277166,277771,605
Jensen_Eisai_groupA,2,6,ts-global_detected_seizures,277166,277771,605
Jensen_Eisai_groupA,1,5,ts-global_detected_seizures,277175,277212,37
Jensen_Eisai_groupA,1,5,ts-global_detected_seizures,277213,277263,50
Jensen_Eisai_groupA,1,5,ts-global_detected_seizures,277266,277308,42
Jensen_Eisai_groupA,1,5,ts-global_detected_seizures,277314,277380,66
Jensen_Eisai_groupA,1,5,ts-global_detected_seizures,277399,277425,26
Jensen_Eisai_groupA,1,5,ts-global_detected_seizures,277442,277526,84
Jensen_Eisai_groupA,1,5,ts-global_detected_seizures,277527,277573,46
Jensen_Eisai_groupA,1,5,ts-global_detected_seizures,277595,277666,71
Jensen_Eisai_groupA,1,5,ts-global_detected_seizures,277668,277724,56
Jensen_Eisai_groupA,1,5,ts-global_detected_seizures,277734,277800,66
Jensen_Eisai_groupA,2,6,ts-global_detected_seizures,277772,277829,57
Jensen_Eisai_groupA,1,5,ts-global_detected_seizures,277801,277824,23
Jensen_Eisai_groupA,1,5,ts-global_detected_seizures,277827,277856,29
Jensen_Eisai_groupA,2,6,ts-global_detected_seizures,277832,277859,27
Jensen_Eisai_groupA,1,5,ts-global_detected_seizures,277869,280753,2884
Jensen_Eisai_groupA,2,6,ts-global_detected_seizures,277891,277921,30
Jensen_Eisai_groupA,2,6,ts-global_detected_seizures,278012,278051,39
Jensen_Eisai_groupA,2,6,ts-global_detected_seizures,278072,278107,35
Jensen_Eisai_groupA,2,6,ts-global_detected_seizures,278146,278177,31
Jensen_Eisai_groupA,2,6,ts-global_detected_seizures,278197,278222,25
Jensen_Eisai_groupA,2,6,ts-global_detected_seizures,278249,278277,28
Jensen_Eisai_groupA,2,6,ts-global_detected_seizures,278314,278345,31
Jensen_Eisai_groupA,2,6,ts-global_detected_seizures,278365,278394,29
Jensen_Eisai_groupA,2,6,ts-global_detected_seizures,278441,278471,30
Jensen_Eisai_groupA,2,6,ts-global_detected_seizures,278575,278599,24
Jensen_Eisai_groupA,2,6,ts-global_detected_seizures,278640,278693,53
Jensen_Eisai_groupA,2,6,ts-global_detected_seizures,278815,278838,23
Jensen_Eisai_groupA,2,6,ts-global_detected_seizures,278852,278886,34
Jensen_Eisai_groupA,2,6,ts-global_detected_seizures,278907,278933,26
Jensen_Eisai_groupA,2,6,ts-global_detected_seizures,278987,279012,25
Jensen_Eisai_groupA,2,6,ts-global_detected_seizures,279060,279111,51
Jensen_Eisai_groupA,2,6,ts-global_detected_seizures,279124,279153,29
Jensen_Eisai_groupA,2,6,ts-global_detected_seizures,279253,279276,23
Jensen_Eisai_groupA,2,6,ts-global_detected_seizures,279292,279322,30
Jensen_Eisai_groupA,2,6,ts-global_detected_seizures,279421,279467,46
Jensen_Eisai_groupA,2,6,ts-global_detected_seizures,279485,279538,53
Jensen_Eisai_groupA,2,6,ts-global_detected_seizures,279565,279590,25
Jensen_Eisai_groupA,2,6,ts-global_detected_seizures,279602,279633,31
Jensen_Eisai_groupA,2,6,ts-global_detected_seizures,279656,279685,29
Jensen_Eisai_groupA,2,6,ts-global_detected_seizures,279710,279745,35
Jensen_Eisai_groupA,2,6,ts-global_detected_seizures,279784,279816,32
Jensen_Eisai_groupA,2,6,ts-global_detected_seizures,279867,279899,32
Jensen_Eisai_groupA,2,6,ts-global_detected_seizures,279958,280006,48
Jensen_Eisai_groupA,2,6,ts-global_detected_seizures,280084,280113,29
Jensen_Eisai_groupA,2,6,ts-global_detected_seizures,280132,280193,61
Jensen_Eisai_groupA,2,6,ts-global_detected_seizures,280220,280249,29
Jensen_Eisai_groupA,2,6,ts-global_detected_seizures,280375,280408,33
Jensen_Eisai_groupA,2,6,ts-global_detected_seizures,280444,280471,27
Jensen_Eisai_groupA,2,6,ts-global_detected_seizures,280559,280594,35
Jensen_Eisai_groupA,2,6,ts-global_detected_seizures,280606,280631,25
Jensen_Eisai_groupA,2,6,ts-global_detected_seizures,280646,280670,24
Jensen_Eisai_groupA,2,6,ts-global_detected_seizures,280713,280739,26
Jensen_Eisai_groupA,1,5,ts-global_detected_seizures,280762,280800,38
Jensen_Eisai_groupA,2,6,ts-global_detected_seizures,280780,280810,30
Jensen_Eisai_groupA,1,5,ts-global_detected_seizures,280801,280846,45
Jensen_Eisai_groupA,2,6,ts-global_detected_seizures,280853,280911,58
Jensen_Eisai_groupA,2,6,ts-global_detected_seizures,280949,280972,23
Jensen_Eisai_groupA,1,5,ts-global_detected_seizures,280982,281023,41
Jensen_Eisai_groupA,2,6,ts-global_detected_seizures,281005,281036,31
Jensen_Eisai_groupA,2,6,ts-global_detected_seizures,281068,281145,77
Jensen_Eisai_groupA,1,5,ts-global_detected_seizures,281089,281445,356
Jensen_Eisai_groupA,2,6,ts-global_detected_seizures,281160,281182,22
Jensen_Eisai_groupA,2,6,ts-global_detected_seizures,281243,281265,22
Jensen_Eisai_groupA,2,6,ts-global_detected_seizures,281294,281322,28
Jensen_Eisai_groupA,2,6,ts-global_detected_seizures,281342,281371,29
Jensen_Eisai_groupA,1,5,ts-global_detected_seizures,281452,281475,23
Jensen_Eisai_groupA,2,6,ts-global_detected_seizures,281502,281537,35
Jensen_Eisai_groupA,1,5,ts-global_detected_seizures,281567,281601,34
Jensen_Eisai_groupA,1,5,ts-global_detected_seizures,281624,281648,24
Jensen_Eisai_groupA,2,6,ts-global_detected_seizures,281638,281670,32
Jensen_Eisai_groupA,1,5,ts-global_detected_seizures,281659,281703,44
Jensen_Eisai_groupA,2,6,ts-global_detected_seizures,281706,281743,37
Jensen_Eisai_groupA,2,6,ts-global_detected_seizures,281767,281796,29
Jensen_Eisai_groupA,1,5,ts-global_detected_seizures,281772,281878,106
Jensen_Eisai_groupA,2,6,ts-global_detected_seizures,281834,281881,47
Jensen_Eisai_groupA,1,5,ts-global_detected_seizures,281879,282031,152
Jensen_Eisai_groupA,2,6,ts-global_detected_seizures,281886,281912,26
Jensen_Eisai_groupA,2,6,ts-global_detected_seizures,281957,282028,71
Jensen_Eisai_groupA,1,5,ts-global_detected_seizures,282032,282121,89
Jensen_Eisai_groupA,2,6,ts-global_detected_seizures,282036,282077,41
Jensen_Eisai_groupA,2,6,ts-global_detected_seizures,282098,282125,27
Jensen_Eisai_groupA,2,6,ts-global_detected_seizures,282151,282179,28
Jensen_Eisai_groupA,1,5,ts-global_detected_seizures,282154,282195,41
Jensen_Eisai_groupA,2,6,ts-global_detected_seizures,282186,282213,27
Jensen_Eisai_groupA,1,5,ts-global_detected_seizures,282206,282267,61
Jensen_Eisai_groupA,2,6,ts-global_detected_seizures,282219,282244,25
Jensen_Eisai_groupA,1,5,ts-global_detected_seizures,282274,282343,69
Jensen_Eisai_groupA,2,6,ts-global_detected_seizures,282283,282316,33
Jensen_Eisai_groupA,2,6,ts-global_detected_seizures,282361,282399,38
Jensen_Eisai_groupA,1,5,ts-global_detected_seizures,282362,282391,29
Jensen_Eisai_groupA,1,5,ts-global_detected_seizures,282397,282438,41
Jensen_Eisai_groupA,2,6,ts-global_detected_seizures,282444,282481,37
Jensen_Eisai_groupA,1,5,ts-global_detected_seizures,282472,282519,47
Jensen_Eisai_groupA,2,6,ts-global_detected_seizures,282505,282557,52
Jensen_Eisai_groupA,1,5,ts-global_detected_seizures,282520,282577,57
Jensen_Eisai_groupA,2,6,ts-global_detected_seizures,282569,282611,42
Jensen_Eisai_groupA,2,6,ts-global_detected_seizures,282617,283135,518
Jensen_Eisai_groupA,1,5,ts-global_detected_seizures,282640,282685,45
Jensen_Eisai_groupA,1,5,ts-global_detected_seizures,282701,282796,95
Jensen_Eisai_groupA,1,5,ts-global_detected_seizures,282800,282890,90
Jensen_Eisai_groupA,1,5,ts-global_detected_seizures,282892,283008,116
Jensen_Eisai_groupA,1,5,ts-global_detected_seizures,283009,283046,37
Jensen_Eisai_groupA,1,5,ts-global_detected_seizures,283102,283147,45
Jensen_Eisai_groupA,1,5,ts-global_detected_seizures,283162,283197,35
Jensen_Eisai_groupA,2,6,ts-global_detected_seizures,283180,283202,22
Jensen_Eisai_groupA,1,5,ts-global_detected_seizures,283205,283232,27
Jensen_Eisai_groupA,2,6,ts-global_detected_seizures,283210,283266,56
Jensen_Eisai_groupA,1,5,ts-global_detected_seizures,283233,283280,47
Jensen_Eisai_groupA,2,6,ts-global_detected_seizures,283267,283319,52
Jensen_Eisai_groupA,1,5,ts-global_detected_seizures,283281,283312,31
Jensen_Eisai_groupA,1,5,ts-global_detected_seizures,283336,283361,25
Jensen_Eisai_groupA,2,6,ts-global_detected_seizures,283343,283378,35
Jensen_Eisai_groupA,1,5,ts-global_detected_seizures,283370,283457,87
Jensen_Eisai_groupA,2,6,ts-global_detected_seizures,283384,283436,52
Jensen_Eisai_groupA,2,6,ts-global_detected_seizures,283448,284017,569
Jensen_Eisai_groupA,1,5,ts-global_detected_seizures,283553,283579,26
Jensen_Eisai_groupA,1,5,ts-global_detected_seizures,283616,283724,108
Jensen_Eisai_groupA,1,5,ts-global_detected_seizures,283737,283780,43
Jensen_Eisai_groupA,1,5,ts-global_detected_seizures,283837,283890,53
Jensen_Eisai_groupA,1,5,ts-global_detected_seizures,283892,283922,30
Jensen_Eisai_groupA,1,5,ts-global_detected_seizures,283923,283946,23
Jensen_Eisai_groupA,1,5,ts-global_detected_seizures,284010,284490,480
Jensen_Eisai_groupA,2,6,ts-global_detected_seizures,284018,284162,144
Jensen_Eisai_groupA,2,6,ts-global_detected_seizures,284163,284212,49
Jensen_Eisai_groupA,2,6,ts-global_detected_seizures,284214,284355,141
Jensen_Eisai_groupA,2,6,ts-global_detected_seizures,284357,284388,31
Jensen_Eisai_groupA,2,6,ts-global_detected_seizures,284397,284425,28
Jensen_Eisai_groupA,2,6,ts-global_detected_seizures,284468,284493,25
Jensen_Eisai_groupA,2,6,ts-global_detected_seizures,284503,284543,40
Jensen_Eisai_groupA,1,5,ts-global_detected_seizures,284507,284560,53
Jensen_Eisai_groupA,1,5,ts-global_detected_seizures,284570,286597,2027
Jensen_Eisai_groupA,2,6,ts-global_detected_seizures,284640,284678,38
Jensen_Eisai_groupA,4,8,ts-global_detected_seizures,284681,292185,7504
Jensen_Eisai_groupA,2,6,ts-global_detected_seizures,284732,284755,23
Jensen_Eisai_groupA,2,6,ts-global_detected_seizures,284827,284862,35
Jensen_Eisai_groupA,2,6,ts-global_detected_seizures,284902,284928,26
Jensen_Eisai_groupA,2,6,ts-global_detected_seizures,284954,284982,28
Jensen_Eisai_groupA,2,6,ts-global_detected_seizures,284990,285027,37
Jensen_Eisai_groupA,2,6,ts-global_detected_seizures,285049,285077,28
Jensen_Eisai_groupA,2,6,ts-global_detected_seizures,285112,285134,22
Jensen_Eisai_groupA,2,6,ts-global_detected_seizures,285254,285287,33
Jensen_Eisai_groupA,2,6,ts-global_detected_seizures,285339,285369,30
Jensen_Eisai_groupA,2,6,ts-global_detected_seizures,285372,285418,46
Jensen_Eisai_groupA,2,6,ts-global_detected_seizures,285436,285462,26
Jensen_Eisai_groupA,2,6,ts-global_detected_seizures,285501,285524,23
Jensen_Eisai_groupA,2,6,ts-global_detected_seizures,285568,285606,38
Jensen_Eisai_groupA,2,6,ts-global_detected_seizures,285653,285675,22
Jensen_Eisai_groupA,2,6,ts-global_detected_seizures,285688,285735,47
Jensen_Eisai_groupA,2,6,ts-global_detected_seizures,285776,285810,34
Jensen_Eisai_groupA,2,6,ts-global_detected_seizures,285828,285851,23
Jensen_Eisai_groupA,2,6,ts-global_detected_seizures,285908,285945,37
Jensen_Eisai_groupA,2,6,ts-global_detected_seizures,285992,286020,28
Jensen_Eisai_groupA,2,6,ts-global_detected_seizures,286088,286137,49
Jensen_Eisai_groupA,2,6,ts-global_detected_seizures,286215,286246,31
Jensen_Eisai_groupA,2,6,ts-global_detected_seizures,286260,286285,25
Jensen_Eisai_groupA,2,6,ts-global_detected_seizures,286306,286360,54
Jensen_Eisai_groupA,2,6,ts-global_detected_seizures,286361,286383,22
Jensen_Eisai_groupA,2,6,ts-global_detected_seizures,286455,286524,69
Jensen_Eisai_groupA,2,6,ts-global_detected_seizures,286572,286632,60
Jensen_Eisai_groupA,1,5,ts-global_detected_seizures,286635,286776,141
Jensen_Eisai_groupA,2,6,ts-global_detected_seizures,286715,286738,23
Jensen_Eisai_groupA,1,5,ts-global_detected_seizures,286787,286829,42
Jensen_Eisai_groupA,2,6,ts-global_detected_seizures,286833,286857,24
Jensen_Eisai_groupA,1,5,ts-global_detected_seizures,286857,286916,59
Jensen_Eisai_groupA,2,6,ts-global_detected_seizures,286884,286914,30
Jensen_Eisai_groupA,1,5,ts-global_detected_seizures,286972,287031,59
Jensen_Eisai_groupA,2,6,ts-global_detected_seizures,286981,287035,54
Jensen_Eisai_groupA,1,5,ts-global_detected_seizures,287063,287091,28
Jensen_Eisai_groupA,2,6,ts-global_detected_seizures,287146,287175,29
Jensen_Eisai_groupA,1,5,ts-global_detected_seizures,287178,287509,331
Jensen_Eisai_groupA,2,6,ts-global_detected_seizures,287258,287282,24
Jensen_Eisai_groupA,2,6,ts-global_detected_seizures,287313,287342,29
Jensen_Eisai_groupA,2,6,ts-global_detected_seizures,287363,287387,24
Jensen_Eisai_groupA,2,6,ts-global_detected_seizures,287409,287433,24
Jensen_Eisai_groupA,2,6,ts-global_detected_seizures,287466,287739,273
Jensen_Eisai_groupA,1,5,ts-global_detected_seizures,287513,287576,63
Jensen_Eisai_groupA,1,5,ts-global_detected_seizures,287606,287648,42
Jensen_Eisai_groupA,1,5,ts-global_detected_seizures,287698,287725,27
Jensen_Eisai_groupA,2,6,ts-global_detected_seizures,287744,287823,79
Jensen_Eisai_groupA,1,5,ts-global_detected_seizures,287763,287808,45
Jensen_Eisai_groupA,2,6,ts-global_detected_seizures,287842,287868,26
Jensen_Eisai_groupA,1,5,ts-global_detected_seizures,287884,287934,50
Jensen_Eisai_groupA,2,6,ts-global_detected_seizures,287895,287962,67
Jensen_Eisai_groupA,1,5,ts-global_detected_seizures,287972,287995,23
Jensen_Eisai_groupA,2,6,ts-global_detected_seizures,287982,288052,70
Jensen_Eisai_groupA,2,6,ts-global_detected_seizures,288053,288651,598
Jensen_Eisai_groupA,1,5,ts-global_detected_seizures,288068,288202,134
Jensen_Eisai_groupA,1,5,ts-global_detected_seizures,288205,288246,41
Jensen_Eisai_groupA,1,5,ts-global_detected_seizures,288252,288307,55
Jensen_Eisai_groupA,1,5,ts-global_detected_seizures,288309,288334,25
Jensen_Eisai_groupA,1,5,ts-global_detected_seizures,288355,288389,34
Jensen_Eisai_groupA,1,5,ts-global_detected_seizures,288407,288436,29
Jensen_Eisai_groupA,1,5,ts-global_detected_seizures,288453,288477,24
Jensen_Eisai_groupA,1,5,ts-global_detected_seizures,288478,288508,30
Jensen_Eisai_groupA,1,5,ts-global_detected_seizures,288509,288590,81
Jensen_Eisai_groupA,1,5,ts-global_detected_seizures,288595,288623,28
Jensen_Eisai_groupA,2,6,ts-global_detected_seizures,288652,288690,38
Jensen_Eisai_groupA,1,5,ts-global_detected_seizures,288659,288723,64
Jensen_Eisai_groupA,2,6,ts-global_detected_seizures,288713,288751,38
Jensen_Eisai_groupA,1,5,ts-global_detected_seizures,288741,288782,41
Jensen_Eisai_groupA,2,6,ts-global_detected_seizures,288763,288789,26
Jensen_Eisai_groupA,1,5,ts-global_detected_seizures,288787,288844,57
Jensen_Eisai_groupA,2,6,ts-global_detected_seizures,288796,288819,23
Jensen_Eisai_groupA,2,6,ts-global_detected_seizures,288842,288873,31
Jensen_Eisai_groupA,1,5,ts-global_detected_seizures,288846,288901,55
Jensen_Eisai_groupA,2,6,ts-global_detected_seizures,288901,288944,43
Jensen_Eisai_groupA,1,5,ts-global_detected_seizures,288923,288948,25
Jensen_Eisai_groupA,2,6,ts-global_detected_seizures,288956,288992,36
Jensen_Eisai_groupA,1,5,ts-global_detected_seizures,288979,289020,41
Jensen_Eisai_groupA,1,5,ts-global_detected_seizures,289035,289061,26
Jensen_Eisai_groupA,2,6,ts-global_detected_seizures,289068,289105,37
Jensen_Eisai_groupA,1,5,ts-global_detected_seizures,289083,289109,26
Jensen_Eisai_groupA,2,6,ts-global_detected_seizures,289119,289149,30
Jensen_Eisai_groupA,1,5,ts-global_detected_seizures,289151,289193,42
Jensen_Eisai_groupA,1,5,ts-global_detected_seizures,289212,289251,39
Jensen_Eisai_groupA,2,6,ts-global_detected_seizures,289229,289257,28
Jensen_Eisai_groupA,1,5,ts-global_detected_seizures,289269,289432,163
Jensen_Eisai_groupA,2,6,ts-global_detected_seizures,289339,289367,28
Jensen_Eisai_groupA,2,6,ts-global_detected_seizures,289405,289450,45
Jensen_Eisai_groupA,1,5,ts-global_detected_seizures,289435,289557,122
Jensen_Eisai_groupA,2,6,ts-global_detected_seizures,289511,289542,31
Jensen_Eisai_groupA,1,5,ts-global_detected_seizures,289558,289603,45
Jensen_Eisai_groupA,2,6,ts-global_detected_seizures,289566,289599,33
Jensen_Eisai_groupA,1,5,ts-global_detected_seizures,289605,289639,34
Jensen_Eisai_groupA,2,6,ts-global_detected_seizures,289621,289655,34
Jensen_Eisai_groupA,1,5,ts-global_detected_seizures,289655,289699,44
Jensen_Eisai_groupA,2,6,ts-global_detected_seizures,289684,289709,25
Jensen_Eisai_groupA,1,5,ts-global_detected_seizures,289731,289835,104
Jensen_Eisai_groupA,2,6,ts-global_detected_seizures,289740,289763,23
Jensen_Eisai_groupA,2,6,ts-global_detected_seizures,289818,289848,30
Jensen_Eisai_groupA,2,6,ts-global_detected_seizures,289905,289934,29
Jensen_Eisai_groupA,1,5,ts-global_detected_seizures,289938,289996,58
Jensen_Eisai_groupA,2,6,ts-global_detected_seizures,289974,290001,27
Jensen_Eisai_groupA,2,6,ts-global_detected_seizures,290014,290039,25
Jensen_Eisai_groupA,1,5,ts-global_detected_seizures,290030,290073,43
Jensen_Eisai_groupA,2,6,ts-global_detected_seizures,290070,290146,76
Jensen_Eisai_groupA,1,5,ts-global_detected_seizures,290074,290100,26
Jensen_Eisai_groupA,1,5,ts-global_detected_seizures,290101,290171,70
Jensen_Eisai_groupA,2,6,ts-global_detected_seizures,290147,290711,564
Jensen_Eisai_groupA,1,5,ts-global_detected_seizures,290174,290340,166
Jensen_Eisai_groupA,1,5,ts-global_detected_seizures,290341,290382,41
Jensen_Eisai_groupA,1,5,ts-global_detected_seizures,290386,290428,42
Jensen_Eisai_groupA,1,5,ts-global_detected_seizures,290449,290502,53
Jensen_Eisai_groupA,1,5,ts-global_detected_seizures,290572,290642,70
Jensen_Eisai_groupA,1,5,ts-global_detected_seizures,290661,290726,65
Jensen_Eisai_groupA,2,6,ts-global_detected_seizures,290712,290776,64
Jensen_Eisai_groupA,1,5,ts-global_detected_seizures,290757,290810,53
Jensen_Eisai_groupA,2,6,ts-global_detected_seizures,290839,290866,27
Jensen_Eisai_groupA,1,5,ts-global_detected_seizures,290842,290905,63
Jensen_Eisai_groupA,2,6,ts-global_detected_seizures,290905,290927,22
Jensen_Eisai_groupA,1,5,ts-global_detected_seizures,290915,290955,40
Jensen_Eisai_groupA,2,6,ts-global_detected_seizures,290944,290971,27
Jensen_Eisai_groupA,1,5,ts-global_detected_seizures,290956,290978,22
Jensen_Eisai_groupA,2,6,ts-global_detected_seizures,290981,291004,23
Jensen_Eisai_groupA,2,6,ts-global_detected_seizures,291030,291060,30
Jensen_Eisai_groupA,2,6,ts-global_detected_seizures,291126,291166,40
Jensen_Eisai_groupA,1,5,ts-global_detected_seizures,291148,291276,128
Jensen_Eisai_groupA,2,6,ts-global_detected_seizures,291213,291240,27
Jensen_Eisai_groupA,2,6,ts-global_detected_seizures,291263,291293,30
Jensen_Eisai_groupA,1,5,ts-global_detected_seizures,291291,291383,92
Jensen_Eisai_groupA,2,6,ts-global_detected_seizures,291309,291332,23
Jensen_Eisai_groupA,2,6,ts-global_detected_seizures,291358,291384,26
Jensen_Eisai_groupA,1,5,ts-global_detected_seizures,291394,291480,86
Jensen_Eisai_groupA,2,6,ts-global_detected_seizures,291441,291467,26
Jensen_Eisai_groupA,1,5,ts-global_detected_seizures,291499,291522,23
Jensen_Eisai_groupA,2,6,ts-global_detected_seizures,291501,291527,26
Jensen_Eisai_groupA,2,6,ts-global_detected_seizures,291550,291573,23
Jensen_Eisai_groupA,1,5,ts-global_detected_seizures,291551,291591,40
Jensen_Eisai_groupA,2,6,ts-global_detected_seizures,291612,291639,27
Jensen_Eisai_groupA,1,5,ts-global_detected_seizures,291620,291643,23
Jensen_Eisai_groupA,2,6,ts-global_detected_seizures,291680,291713,33
Jensen_Eisai_groupA,1,5,ts-global_detected_seizures,291689,291806,117
Jensen_Eisai_groupA,2,6,ts-global_detected_seizures,291714,291767,53
Jensen_Eisai_groupA,2,6,ts-global_detected_seizures,291782,291809,27
Jensen_Eisai_groupA,1,5,ts-global_detected_seizures,291822,291855,33
Jensen_Eisai_groupA,1,5,ts-global_detected_seizures,291939,292177,238
Jensen_Eisai_groupA,2,6,ts-global_detected_seizures,291975,291999,24
Jensen_Eisai_groupA,2,6,ts-global_detected_seizures,292171,292223,52
Jensen_Eisai_groupA,1,5,ts-global_detected_seizures,292178,292212,34
Jensen_Eisai_groupA,4,8,ts-global_detected_seizures,292186,294471,2285
Jensen_Eisai_groupA,1,5,ts-global_detected_seizures,292220,292277,57
Jensen_Eisai_groupA,2,6,ts-global_detected_seizures,292264,292292,28
Jensen_Eisai_groupA,1,5,ts-global_detected_seizures,292284,292318,34
Jensen_Eisai_groupA,1,5,ts-global_detected_seizures,292323,292407,84
Jensen_Eisai_groupA,2,6,ts-global_detected_seizures,292340,292377,37
Jensen_Eisai_groupA,2,6,ts-global_detected_seizures,292441,292464,23
Jensen_Eisai_groupA,1,5,ts-global_detected_seizures,292450,292501,51
Jensen_Eisai_groupA,2,6,ts-global_detected_seizures,292484,292531,47
Jensen_Eisai_groupA,1,5,ts-global_detected_seizures,292502,292582,80
Jensen_Eisai_groupA,2,6,ts-global_detected_seizures,292557,292586,29
Jensen_Eisai_groupA,1,5,ts-global_detected_seizures,292583,292625,42
Jensen_Eisai_groupA,2,6,ts-global_detected_seizures,292590,292623,33
Jensen_Eisai_groupA,1,5,ts-global_detected_seizures,292627,292916,289
Jensen_Eisai_groupA,2,6,ts-global_detected_seizures,292657,292683,26
Jensen_Eisai_groupA,2,6,ts-global_detected_seizures,292684,292712,28
Jensen_Eisai_groupA,2,6,ts-global_detected_seizures,292720,292753,33
Jensen_Eisai_groupA,2,6,ts-global_detected_seizures,292756,292790,34
Jensen_Eisai_groupA,2,6,ts-global_detected_seizures,292854,293620,766
Jensen_Eisai_groupA,1,5,ts-global_detected_seizures,292924,292973,49
Jensen_Eisai_groupA,1,5,ts-global_detected_seizures,292980,293064,84
Jensen_Eisai_groupA,1,5,ts-global_detected_seizures,293073,293097,24
Jensen_Eisai_groupA,1,5,ts-global_detected_seizures,293148,293215,67
Jensen_Eisai_groupA,1,5,ts-global_detected_seizures,293237,293290,53
Jensen_Eisai_groupA,1,5,ts-global_detected_seizures,293302,293330,28
Jensen_Eisai_groupA,1,5,ts-global_detected_seizures,293347,293439,92
Jensen_Eisai_groupA,1,5,ts-global_detected_seizures,293440,293471,31
Jensen_Eisai_groupA,1,5,ts-global_detected_seizures,293472,293549,77
Jensen_Eisai_groupA,1,5,ts-global_detected_seizures,293570,293611,41
Jensen_Eisai_groupA,2,6,ts-global_detected_seizures,293621,293729,108
Jensen_Eisai_groupA,1,5,ts-global_detected_seizures,293713,293764,51
Jensen_Eisai_groupA,2,6,ts-global_detected_seizures,293748,293796,48
Jensen_Eisai_groupA,1,5,ts-global_detected_seizures,293811,293847,36
Jensen_Eisai_groupA,1,5,ts-global_detected_seizures,293858,294004,146
Jensen_Eisai_groupA,2,6,ts-global_detected_seizures,293899,293934,35
Jensen_Eisai_groupA,2,6,ts-global_detected_seizures,293937,293959,22
Jensen_Eisai_groupA,1,5,ts-global_detected_seizures,294007,294083,76
Jensen_Eisai_groupA,2,6,ts-global_detected_seizures,294029,294062,33
Jensen_Eisai_groupA,1,5,ts-global_detected_seizures,294094,294136,42
Jensen_Eisai_groupA,2,6,ts-global_detected_seizures,294119,294159,40
Jensen_Eisai_groupA,1,5,ts-global_detected_seizures,294164,294222,58
Jensen_Eisai_groupA,1,5,ts-global_detected_seizures,294237,294268,31
Jensen_Eisai_groupA,2,6,ts-global_detected_seizures,294264,294295,31
Jensen_Eisai_groupA,1,5,ts-global_detected_seizures,294274,294303,29
Jensen_Eisai_groupA,1,5,ts-global_detected_seizures,294317,294364,47
Jensen_Eisai_groupA,2,6,ts-global_detected_seizures,294360,294406,46
Jensen_Eisai_groupA,1,5,ts-global_detected_seizures,294373,294412,39
Jensen_Eisai_groupA,1,5,ts-global_detected_seizures,294427,294458,31
Jensen_Eisai_groupA,2,6,ts-global_detected_seizures,294439,294461,22
Jensen_Eisai_groupA,4,8,ts-global_detected_seizures,294472,298321,3849
Jensen_Eisai_groupA,1,5,ts-global_detected_seizures,294498,294526,28
Jensen_Eisai_groupA,1,5,ts-global_detected_seizures,294536,294584,48
Jensen_Eisai_groupA,1,5,ts-global_detected_seizures,294588,294686,98
Jensen_Eisai_groupA,2,6,ts-global_detected_seizures,294589,294620,31
Jensen_Eisai_groupA,2,6,ts-global_detected_seizures,294671,294695,24
Jensen_Eisai_groupA,1,5,ts-global_detected_seizures,294693,294762,69
Jensen_Eisai_groupA,2,6,ts-global_detected_seizures,294725,294800,75
Jensen_Eisai_groupA,1,5,ts-global_detected_seizures,294763,294793,30
Jensen_Eisai_groupA,1,5,ts-global_detected_seizures,294828,296063,1235
Jensen_Eisai_groupA,2,6,ts-global_detected_seizures,294938,294960,22
Jensen_Eisai_groupA,2,6,ts-global_detected_seizures,294975,295016,41
Jensen_Eisai_groupA,2,6,ts-global_detected_seizures,295087,295111,24
Jensen_Eisai_groupA,2,6,ts-global_detected_seizures,295144,295177,33
Jensen_Eisai_groupA,2,6,ts-global_detected_seizures,295218,295848,630
Jensen_Eisai_groupA,2,6,ts-global_detected_seizures,295850,295892,42
Jensen_Eisai_groupA,2,6,ts-global_detected_seizures,295914,295941,27
Jensen_Eisai_groupA,2,6,ts-global_detected_seizures,295984,296022,38
Jensen_Eisai_groupA,2,6,ts-global_detected_seizures,296029,296064,35
Jensen_Eisai_groupA,1,5,ts-global_detected_seizures,296064,296093,29
Jensen_Eisai_groupA,2,6,ts-global_detected_seizures,296088,296128,40
Jensen_Eisai_groupA,1,5,ts-global_detected_seizures,296097,296161,64
Jensen_Eisai_groupA,1,5,ts-global_detected_seizures,296162,296192,30
Jensen_Eisai_groupA,2,6,ts-global_detected_seizures,296202,296225,23
Jensen_Eisai_groupA,1,5,ts-global_detected_seizures,296205,296239,34
Jensen_Eisai_groupA,2,6,ts-global_detected_seizures,296257,296279,22
Jensen_Eisai_groupA,1,5,ts-global_detected_seizures,296283,296319,36
Jensen_Eisai_groupA,2,6,ts-global_detected_seizures,296285,296318,33
Jensen_Eisai_groupA,2,6,ts-global_detected_seizures,296343,296381,38
Jensen_Eisai_groupA,1,5,ts-global_detected_seizures,296381,296421,40
Jensen_Eisai_groupA,2,6,ts-global_detected_seizures,296413,296435,22
Jensen_Eisai_groupA,1,5,ts-global_detected_seizures,296431,296479,48
Jensen_Eisai_groupA,2,6,ts-global_detected_seizures,296457,296500,43
Jensen_Eisai_groupA,1,5,ts-global_detected_seizures,296492,296520,28
Jensen_Eisai_groupA,2,6,ts-global_detected_seizures,296533,296567,34
Jensen_Eisai_groupA,1,5,ts-global_detected_seizures,296535,296566,31
Jensen_Eisai_groupA,1,5,ts-global_detected_seizures,296653,296687,34
Jensen_Eisai_groupA,1,5,ts-global_detected_seizures,296688,296775,87
Jensen_Eisai_groupA,2,6,ts-global_detected_seizures,296739,296762,23
Jensen_Eisai_groupA,2,6,ts-global_detected_seizures,296765,296794,29
Jensen_Eisai_groupA,1,5,ts-global_detected_seizures,296785,296810,25
Jensen_Eisai_groupA,1,5,ts-global_detected_seizures,296814,296855,41
Jensen_Eisai_groupA,1,5,ts-global_detected_seizures,296859,296887,28
Jensen_Eisai_groupA,2,6,ts-global_detected_seizures,296878,296919,41
Jensen_Eisai_groupA,1,5,ts-global_detected_seizures,296909,296940,31
Jensen_Eisai_groupA,1,5,ts-global_detected_seizures,296974,296999,25
Jensen_Eisai_groupA,1,5,ts-global_detected_seizures,297037,297090,53
Jensen_Eisai_groupA,2,6,ts-global_detected_seizures,297112,297154,42
Jensen_Eisai_groupA,2,6,ts-global_detected_seizures,297178,297209,31
Jensen_Eisai_groupA,1,5,ts-global_detected_seizures,297181,297220,39
Jensen_Eisai_groupA,2,6,ts-global_detected_seizures,297218,297243,25
Jensen_Eisai_groupA,1,5,ts-global_detected_seizures,297238,297262,24
Jensen_Eisai_groupA,2,6,ts-global_detected_seizures,297255,297284,29
Jensen_Eisai_groupA,1,5,ts-global_detected_seizures,297290,297317,27
Jensen_Eisai_groupA,1,5,ts-global_detected_seizures,297336,297950,614
Jensen_Eisai_groupA,2,6,ts-global_detected_seizures,297338,297360,22
Jensen_Eisai_groupA,2,6,ts-global_detected_seizures,297394,297416,22
Jensen_Eisai_groupA,2,6,ts-global_detected_seizures,297436,297462,26
Jensen_Eisai_groupA,2,6,ts-global_detected_seizures,297529,297553,24
Jensen_Eisai_groupA,2,6,ts-global_detected_seizures,297582,297607,25
Jensen_Eisai_groupA,2,6,ts-global_detected_seizures,297642,297666,24
Jensen_Eisai_groupA,2,6,ts-global_detected_seizures,297674,297697,23
Jensen_Eisai_groupA,2,6,ts-global_detected_seizures,297698,297720,22
Jensen_Eisai_groupA,2,6,ts-global_detected_seizures,297753,297803,50
Jensen_Eisai_groupA,2,6,ts-global_detected_seizures,297838,297963,125
Jensen_Eisai_groupA,1,5,ts-global_detected_seizures,297951,297987,36
Jensen_Eisai_groupA,2,6,ts-global_detected_seizures,297966,298068,102
Jensen_Eisai_groupA,1,5,ts-global_detected_seizures,297988,298128,140
Jensen_Eisai_groupA,2,6,ts-global_detected_seizures,298069,298457,388
Jensen_Eisai_groupA,1,5,ts-global_detected_seizures,298170,298208,38
Jensen_Eisai_groupA,1,5,ts-global_detected_seizures,298209,298238,29
Jensen_Eisai_groupA,1,5,ts-global_detected_seizures,298240,298285,45
Jensen_Eisai_groupA,1,5,ts-global_detected_seizures,298290,298320,30
Jensen_Eisai_groupA,4,8,ts-global_detected_seizures,298322,300789,2467
Jensen_Eisai_groupA,1,5,ts-global_detected_seizures,298347,298394,47
Jensen_Eisai_groupA,1,5,ts-global_detected_seizures,298411,298501,90
Jensen_Eisai_groupA,2,6,ts-global_detected_seizures,298458,298598,140
Jensen_Eisai_groupA,1,5,ts-global_detected_seizures,298510,298534,24
Jensen_Eisai_groupA,1,5,ts-global_detected_seizures,298591,299569,978
Jensen_Eisai_groupA,2,6,ts-global_detected_seizures,298626,298651,25
Jensen_Eisai_groupA,2,6,ts-global_detected_seizures,298665,298714,49
Jensen_Eisai_groupA,2,6,ts-global_detected_seizures,298746,298787,41
Jensen_Eisai_groupA,2,6,ts-global_detected_seizures,298790,298826,36
Jensen_Eisai_groupA,2,6,ts-global_detected_seizures,299017,299041,24
Jensen_Eisai_groupA,2,6,ts-global_detected_seizures,299085,299108,23
Jensen_Eisai_groupA,2,6,ts-global_detected_seizures,299124,299150,26
Jensen_Eisai_groupA,2,6,ts-global_detected_seizures,299233,299267,34
Jensen_Eisai_groupA,2,6,ts-global_detected_seizures,299346,299395,49
Jensen_Eisai_groupA,2,6,ts-global_detected_seizures,299474,299496,22
Jensen_Eisai_groupA,2,6,ts-global_detected_seizures,299516,299540,24
Jensen_Eisai_groupA,2,6,ts-global_detected_seizures,299568,299591,23
Jensen_Eisai_groupA,1,5,ts-global_detected_seizures,299570,299614,44
Jensen_Eisai_groupA,1,5,ts-global_detected_seizures,299618,299662,44
Jensen_Eisai_groupA,2,6,ts-global_detected_seizures,299633,299659,26
Jensen_Eisai_groupA,1,5,ts-global_detected_seizures,299781,299805,24
Jensen_Eisai_groupA,1,5,ts-global_detected_seizures,299806,299830,24
Jensen_Eisai_groupA,2,6,ts-global_detected_seizures,299809,299839,30
Jensen_Eisai_groupA,1,5,ts-global_detected_seizures,299869,300284,415
Jensen_Eisai_groupA,2,6,ts-global_detected_seizures,299924,299965,41
Jensen_Eisai_groupA,2,6,ts-global_detected_seizures,300032,300059,27
Jensen_Eisai_groupA,2,6,ts-global_detected_seizures,300067,300105,38
Jensen_Eisai_groupA,2,6,ts-global_detected_seizures,300220,300248,28
Jensen_Eisai_groupA,2,6,ts-global_detected_seizures,300265,300470,205
Jensen_Eisai_groupA,1,5,ts-global_detected_seizures,300285,300398,113
Jensen_Eisai_groupA,1,5,ts-global_detected_seizures,300399,300484,85
Jensen_Eisai_groupA,2,6,ts-global_detected_seizures,300483,300509,26
Jensen_Eisai_groupA,2,6,ts-global_detected_seizures,300514,300536,22
Jensen_Eisai_groupA,2,6,ts-global_detected_seizures,300537,300567,30
Jensen_Eisai_groupA,2,6,ts-global_detected_seizures,300569,300595,26
Jensen_Eisai_groupA,1,5,ts-global_detected_seizures,300577,300628,51
Jensen_Eisai_groupA,2,6,ts-global_detected_seizures,300598,300895,297
Jensen_Eisai_groupA,1,5,ts-global_detected_seizures,300646,300707,61
Jensen_Eisai_groupA,1,5,ts-global_detected_seizures,300725,300756,31
Jensen_Eisai_groupA,1,5,ts-global_detected_seizures,300771,300865,94
Jensen_Eisai_groupA,4,8,ts-global_detected_seizures,300814,302544,1730
Jensen_Eisai_groupA,1,5,ts-global_detected_seizures,300866,301814,948
Jensen_Eisai_groupA,2,6,ts-global_detected_seizures,300896,300922,26
Jensen_Eisai_groupA,2,6,ts-global_detected_seizures,300939,301704,765
Jensen_Eisai_groupA,2,6,ts-global_detected_seizures,301722,301790,68
Jensen_Eisai_groupA,1,5,ts-global_detected_seizures,301815,302089,274
Jensen_Eisai_groupA,2,6,ts-global_detected_seizures,301833,302423,590
Jensen_Eisai_groupA,1,5,ts-global_detected_seizures,302090,302751,661
Jensen_Eisai_groupA,2,6,ts-global_detected_seizures,302447,302484,37
Jensen_Eisai_groupA,2,6,ts-global_detected_seizures,302486,302535,49
Jensen_Eisai_groupA,4,8,ts-global_detected_seizures,302545,306654,4109
Jensen_Eisai_groupA,2,6,ts-global_detected_seizures,302547,302581,34
Jensen_Eisai_groupA,2,6,ts-global_detected_seizures,302670,302699,29
Jensen_Eisai_groupA,2,6,ts-global_detected_seizures,302722,302744,22
Jensen_Eisai_groupA,1,5,ts-global_detected_seizures,302752,304570,1818
Jensen_Eisai_groupA,2,6,ts-global_detected_seizures,302754,302779,25
Jensen_Eisai_groupA,2,6,ts-global_detected_seizures,302813,302848,35
Jensen_Eisai_groupA,2,6,ts-global_detected_seizures,302854,302887,33
Jensen_Eisai_groupA,2,6,ts-global_detected_seizures,302899,302945,46
Jensen_Eisai_groupA,2,6,ts-global_detected_seizures,302957,302982,25
Jensen_Eisai_groupA,2,6,ts-global_detected_seizures,302994,303030,36
Jensen_Eisai_groupA,2,6,ts-global_detected_seizures,303057,303775,718
Jensen_Eisai_groupA,2,6,ts-global_detected_seizures,303779,303815,36
Jensen_Eisai_groupA,2,6,ts-global_detected_seizures,303924,303999,75
Jensen_Eisai_groupA,2,6,ts-global_detected_seizures,304007,304046,39
Jensen_Eisai_groupA,2,6,ts-global_detected_seizures,304074,304099,25
Jensen_Eisai_groupA,2,6,ts-global_detected_seizures,304117,304181,64
Jensen_Eisai_groupA,2,6,ts-global_detected_seizures,304187,304209,22
Jensen_Eisai_groupA,2,6,ts-global_detected_seizures,304225,304774,549
Jensen_Eisai_groupA,1,5,ts-global_detected_seizures,304571,305071,500
Jensen_Eisai_groupA,2,6,ts-global_detected_seizures,304775,304843,68
Jensen_Eisai_groupA,2,6,ts-global_detected_seizures,304932,304956,24
Jensen_Eisai_groupA,2,6,ts-global_detected_seizures,304971,305052,81
Jensen_Eisai_groupA,2,6,ts-global_detected_seizures,305059,305706,647
Jensen_Eisai_groupA,1,5,ts-global_detected_seizures,305072,305759,687
Jensen_Eisai_groupA,2,6,ts-global_detected_seizures,305707,306043,336
Jensen_Eisai_groupA,1,5,ts-global_detected_seizures,305760,305789,29
Jensen_Eisai_groupA,1,5,ts-global_detected_seizures,305790,306151,361
Jensen_Eisai_groupA,2,6,ts-global_detected_seizures,306044,306072,28
Jensen_Eisai_groupA,2,6,ts-global_detected_seizures,306076,306098,22
Jensen_Eisai_groupA,2,6,ts-global_detected_seizures,306118,306146,28
Jensen_Eisai_groupA,1,5,ts-global_detected_seizures,306152,306619,467
Jensen_Eisai_groupA,2,6,ts-global_detected_seizures,306224,306252,28
Jensen_Eisai_groupA,2,6,ts-global_detected_seizures,306279,306301,22
Jensen_Eisai_groupA,2,6,ts-global_detected_seizures,306362,306387,25
Jensen_Eisai_groupA,2,6,ts-global_detected_seizures,306416,306446,30
Jensen_Eisai_groupA,2,6,ts-global_detected_seizures,306617,306704,87
Jensen_Eisai_groupA,1,5,ts-global_detected_seizures,306620,306642,22
Jensen_Eisai_groupA,1,5,ts-global_detected_seizures,306643,306931,288
Jensen_Eisai_groupA,4,8,ts-global_detected_seizures,306655,313089,6434
Jensen_Eisai_groupA,2,6,ts-global_detected_seizures,306766,306788,22
Jensen_Eisai_groupA,2,6,ts-global_detected_seizures,306801,306825,24
Jensen_Eisai_groupA,2,6,ts-global_detected_seizures,306897,306920,23
Jensen_Eisai_groupA,1,5,ts-global_detected_seizures,306932,307084,152
Jensen_Eisai_groupA,2,6,ts-global_detected_seizures,306939,306971,32
Jensen_Eisai_groupA,2,6,ts-global_detected_seizures,307012,307050,38
Jensen_Eisai_groupA,1,5,ts-global_detected_seizures,307112,307636,524
Jensen_Eisai_groupA,2,6,ts-global_detected_seizures,307117,307556,439
Jensen_Eisai_groupA,2,6,ts-global_detected_seizures,307575,307874,299
Jensen_Eisai_groupA,1,5,ts-global_detected_seizures,307637,308338,701
Jensen_Eisai_groupA,2,6,ts-global_detected_seizures,307933,307959,26
Jensen_Eisai_groupA,2,6,ts-global_detected_seizures,308026,308058,32
Jensen_Eisai_groupA,2,6,ts-global_detected_seizures,308073,308104,31
Jensen_Eisai_groupA,2,6,ts-global_detected_seizures,308124,308958,834
Jensen_Eisai_groupA,1,5,ts-global_detected_seizures,308343,308382,39
Jensen_Eisai_groupA,1,5,ts-global_detected_seizures,308383,308426,43
Jensen_Eisai_groupA,1,5,ts-global_detected_seizures,308427,308741,314
Jensen_Eisai_groupA,1,5,ts-global_detected_seizures,308742,309062,320
Jensen_Eisai_groupA,2,6,ts-global_detected_seizures,308963,308987,24
Jensen_Eisai_groupA,1,5,ts-global_detected_seizures,309063,309182,119
Jensen_Eisai_groupA,2,6,ts-global_detected_seizures,309075,309107,32
Jensen_Eisai_groupA,2,6,ts-global_detected_seizures,309127,309162,35
Jensen_Eisai_groupA,1,5,ts-global_detected_seizures,309183,309296,113
Jensen_Eisai_groupA,2,6,ts-global_detected_seizures,309219,309562,343
Jensen_Eisai_groupA,1,5,ts-global_detected_seizures,309317,309390,73
Jensen_Eisai_groupA,1,5,ts-global_detected_seizures,309391,310427,1036
Jensen_Eisai_groupA,2,6,ts-global_detected_seizures,309662,309688,26
Jensen_Eisai_groupA,2,6,ts-global_detected_seizures,309779,309851,72
Jensen_Eisai_groupA,2,6,ts-global_detected_seizures,309859,310257,398
Jensen_Eisai_groupA,2,6,ts-global_detected_seizures,310259,310281,22
Jensen_Eisai_groupA,2,6,ts-global_detected_seizures,310283,310312,29
Jensen_Eisai_groupA,2,6,ts-global_detected_seizures,310326,310355,29
Jensen_Eisai_groupA,1,5,ts-global_detected_seizures,310428,310451,23
Jensen_Eisai_groupA,1,5,ts-global_detected_seizures,310452,310552,100
Jensen_Eisai_groupA,2,6,ts-global_detected_seizures,310464,310503,39
Jensen_Eisai_groupA,2,6,ts-global_detected_seizures,310521,310562,41
Jensen_Eisai_groupA,1,5,ts-global_detected_seizures,310553,311605,1052
Jensen_Eisai_groupA,2,6,ts-global_detected_seizures,310592,310619,27
Jensen_Eisai_groupA,2,6,ts-global_detected_seizures,310672,310695,23
Jensen_Eisai_groupA,2,6,ts-global_detected_seizures,310712,310789,77
Jensen_Eisai_groupA,2,6,ts-global_detected_seizures,310810,311417,607
Jensen_Eisai_groupA,2,6,ts-global_detected_seizures,311452,311474,22
Jensen_Eisai_groupA,2,6,ts-global_detected_seizures,311484,311513,29
Jensen_Eisai_groupA,2,6,ts-global_detected_seizures,311578,311628,50
Jensen_Eisai_groupA,1,5,ts-global_detected_seizures,311606,311863,257
Jensen_Eisai_groupA,2,6,ts-global_detected_seizures,311663,311685,22
Jensen_Eisai_groupA,2,6,ts-global_detected_seizures,311740,311919,179
Jensen_Eisai_groupA,1,5,ts-global_detected_seizures,311864,312592,728
Jensen_Eisai_groupA,2,6,ts-global_detected_seizures,311920,311992,72
Jensen_Eisai_groupA,2,6,ts-global_detected_seizures,312126,312572,446
Jensen_Eisai_groupA,1,5,ts-global_detected_seizures,312593,313577,984
Jensen_Eisai_groupA,2,6,ts-global_detected_seizures,312743,312781,38
Jensen_Eisai_groupA,2,6,ts-global_detected_seizures,312811,312835,24
Jensen_Eisai_groupA,2,6,ts-global_detected_seizures,312910,312951,41
Jensen_Eisai_groupA,2,6,ts-global_detected_seizures,312980,313014,34
Jensen_Eisai_groupA,2,6,ts-global_detected_seizures,313053,313088,35
Jensen_Eisai_groupA,4,8,ts-global_detected_seizures,313090,328605,15515
Jensen_Eisai_groupA,2,6,ts-global_detected_seizures,313111,313140,29
Jensen_Eisai_groupA,2,6,ts-global_detected_seizures,313161,313423,262
Jensen_Eisai_groupA,2,6,ts-global_detected_seizures,313424,313489,65
Jensen_Eisai_groupA,2,6,ts-global_detected_seizures,313490,313522,32
Jensen_Eisai_groupA,1,5,ts-global_detected_seizures,313578,313978,400
Jensen_Eisai_groupA,2,6,ts-global_detected_seizures,313585,313607,22
Jensen_Eisai_groupA,2,6,ts-global_detected_seizures,313637,313666,29
Jensen_Eisai_groupA,2,6,ts-global_detected_seizures,313722,313765,43
Jensen_Eisai_groupA,2,6,ts-global_detected_seizures,313788,313812,24
Jensen_Eisai_groupA,2,6,ts-global_detected_seizures,313838,314039,201
Jensen_Eisai_groupA,1,5,ts-global_detected_seizures,313979,314364,385
Jensen_Eisai_groupA,2,6,ts-global_detected_seizures,314040,314107,67
Jensen_Eisai_groupA,1,5,ts-global_detected_seizures,314365,314640,275
Jensen_Eisai_groupA,2,6,ts-global_detected_seizures,314391,314414,23
Jensen_Eisai_groupA,2,6,ts-global_detected_seizures,314499,314718,219
Jensen_Eisai_groupA,1,5,ts-global_detected_seizures,314641,314845,204
Jensen_Eisai_groupA,2,6,ts-global_detected_seizures,314719,315174,455
Jensen_Eisai_groupA,1,5,ts-global_detected_seizures,314846,315401,555
Jensen_Eisai_groupA,2,6,ts-global_detected_seizures,315175,315214,39
Jensen_Eisai_groupA,2,6,ts-global_detected_seizures,315251,315432,181
Jensen_Eisai_groupA,1,5,ts-global_detected_seizures,315402,315439,37
Jensen_Eisai_groupA,2,6,ts-global_detected_seizures,315442,315469,27
Jensen_Eisai_groupA,1,5,ts-global_detected_seizures,315469,315607,138
Jensen_Eisai_groupA,2,6,ts-global_detected_seizures,315529,315564,35
Jensen_Eisai_groupA,2,6,ts-global_detected_seizures,315604,315647,43
Jensen_Eisai_groupA,1,5,ts-global_detected_seizures,315641,315671,30
Jensen_Eisai_groupA,1,5,ts-global_detected_seizures,315680,315755,75
Jensen_Eisai_groupA,1,5,ts-global_detected_seizures,315756,315778,22
Jensen_Eisai_groupA,2,6,ts-global_detected_seizures,315837,315862,25
Jensen_Eisai_groupA,1,5,ts-global_detected_seizures,315853,315875,22
Jensen_Eisai_groupA,1,5,ts-global_detected_seizures,315896,315927,31
Jensen_Eisai_groupA,1,5,ts-global_detected_seizures,315931,316106,175
Jensen_Eisai_groupA,2,6,ts-global_detected_seizures,315934,315966,32
Jensen_Eisai_groupA,2,6,ts-global_detected_seizures,316056,316089,33
Jensen_Eisai_groupA,2,6,ts-global_detected_seizures,316095,317058,963
Jensen_Eisai_groupA,1,5,ts-global_detected_seizures,316129,316257,128
Jensen_Eisai_groupA,1,5,ts-global_detected_seizures,316322,316375,53
Jensen_Eisai_groupA,1,5,ts-global_detected_seizures,316616,317340,724
Jensen_Eisai_groupA,2,6,ts-global_detected_seizures,317213,317241,28
Jensen_Eisai_groupA,2,6,ts-global_detected_seizures,317282,317319,37
Jensen_Eisai_groupA,1,5,ts-global_detected_seizures,317341,317747,406
Jensen_Eisai_groupA,2,6,ts-global_detected_seizures,317365,317388,23
Jensen_Eisai_groupA,2,6,ts-global_detected_seizures,317415,317504,89
Jensen_Eisai_groupA,2,6,ts-global_detected_seizures,317606,317660,54
Jensen_Eisai_groupA,2,6,ts-global_detected_seizures,317693,317718,25
Jensen_Eisai_groupA,1,5,ts-global_detected_seizures,317748,317799,51
Jensen_Eisai_groupA,2,6,ts-global_detected_seizures,317751,317779,28
Jensen_Eisai_groupA,1,5,ts-global_detected_seizures,317800,320065,2265
Jensen_Eisai_groupA,2,6,ts-global_detected_seizures,317808,317833,25
Jensen_Eisai_groupA,2,6,ts-global_detected_seizures,317881,317918,37
Jensen_Eisai_groupA,2,6,ts-global_detected_seizures,317932,318276,344
Jensen_Eisai_groupA,2,6,ts-global_detected_seizures,318316,318338,22
Jensen_Eisai_groupA,2,6,ts-global_detected_seizures,318370,318427,57
Jensen_Eisai_groupA,2,6,ts-global_detected_seizures,318439,319150,711
Jensen_Eisai_groupA,2,6,ts-global_detected_seizures,319157,319218,61
Jensen_Eisai_groupA,2,6,ts-global_detected_seizures,319222,319250,28
Jensen_Eisai_groupA,2,6,ts-global_detected_seizures,319311,319722,411
Jensen_Eisai_groupA,2,6,ts-global_detected_seizures,319724,319756,32
Jensen_Eisai_groupA,2,6,ts-global_detected_seizures,319995,320025,30
Jensen_Eisai_groupA,1,5,ts-global_detected_seizures,320066,320975,909
Jensen_Eisai_groupA,2,6,ts-global_detected_seizures,320114,320145,31
Jensen_Eisai_groupA,2,6,ts-global_detected_seizures,320171,320200,29
Jensen_Eisai_groupA,2,6,ts-global_detected_seizures,320234,320267,33
Jensen_Eisai_groupA,2,6,ts-global_detected_seizures,320320,320345,25
Jensen_Eisai_groupA,2,6,ts-global_detected_seizures,320390,320425,35
Jensen_Eisai_groupA,2,6,ts-global_detected_seizures,320522,320573,51
Jensen_Eisai_groupA,2,6,ts-global_detected_seizures,320717,320758,41
Jensen_Eisai_groupA,2,6,ts-global_detected_seizures,320849,320914,65
Jensen_Eisai_groupA,2,6,ts-global_detected_seizures,320976,321011,35
Jensen_Eisai_groupA,1,5,ts-global_detected_seizures,320999,321128,129
Jensen_Eisai_groupA,2,6,ts-global_detected_seizures,321057,321082,25
Jensen_Eisai_groupA,2,6,ts-global_detected_seizures,321169,321218,49
Jensen_Eisai_groupA,1,5,ts-global_detected_seizures,321219,321243,24
Jensen_Eisai_groupA,2,6,ts-global_detected_seizures,321250,321272,22
Jensen_Eisai_groupA,2,6,ts-global_detected_seizures,321366,321404,38
Jensen_Eisai_groupA,1,5,ts-global_detected_seizures,321464,321491,27
Jensen_Eisai_groupA,2,6,ts-global_detected_seizures,321514,321540,26
Jensen_Eisai_groupA,2,6,ts-global_detected_seizures,321569,321598,29
Jensen_Eisai_groupA,2,6,ts-global_detected_seizures,321623,322024,401
Jensen_Eisai_groupA,1,5,ts-global_detected_seizures,321855,321983,128
Jensen_Eisai_groupA,1,5,ts-global_detected_seizures,321984,322032,48
Jensen_Eisai_groupA,2,6,ts-global_detected_seizures,322052,322541,489
Jensen_Eisai_groupA,1,5,ts-global_detected_seizures,322114,324162,2048
Jensen_Eisai_groupA,2,6,ts-global_detected_seizures,322543,322576,33
Jensen_Eisai_groupA,2,6,ts-global_detected_seizures,322779,322816,37
Jensen_Eisai_groupA,2,6,ts-global_detected_seizures,322817,322841,24
Jensen_Eisai_groupA,2,6,ts-global_detected_seizures,322855,323180,325
Jensen_Eisai_groupA,2,6,ts-global_detected_seizures,323201,323240,39
Jensen_Eisai_groupA,2,6,ts-global_detected_seizures,323282,323304,22
Jensen_Eisai_groupA,2,6,ts-global_detected_seizures,323351,323707,356
Jensen_Eisai_groupA,2,6,ts-global_detected_seizures,323747,323793,46
Jensen_Eisai_groupA,2,6,ts-global_detected_seizures,323797,323824,27
Jensen_Eisai_groupA,2,6,ts-global_detected_seizures,323990,324015,25
Jensen_Eisai_groupA,2,6,ts-global_detected_seizures,324085,324113,28
Jensen_Eisai_groupA,2,6,ts-global_detected_seizures,324119,324147,28
Jensen_Eisai_groupA,1,5,ts-global_detected_seizures,324163,324301,138
Jensen_Eisai_groupA,2,6,ts-global_detected_seizures,324171,324197,26
Jensen_Eisai_groupA,2,6,ts-global_detected_seizures,324222,324281,59
Jensen_Eisai_groupA,1,5,ts-global_detected_seizures,324302,324930,628
Jensen_Eisai_groupA,2,6,ts-global_detected_seizures,324330,324361,31
Jensen_Eisai_groupA,2,6,ts-global_detected_seizures,324386,324421,35
Jensen_Eisai_groupA,2,6,ts-global_detected_seizures,324423,324445,22
Jensen_Eisai_groupA,2,6,ts-global_detected_seizures,324446,324503,57
Jensen_Eisai_groupA,2,6,ts-global_detected_seizures,324555,324588,33
Jensen_Eisai_groupA,2,6,ts-global_detected_seizures,324710,324739,29
Jensen_Eisai_groupA,2,6,ts-global_detected_seizures,324763,324789,26
Jensen_Eisai_groupA,2,6,ts-global_detected_seizures,324833,324865,32
Jensen_Eisai_groupA,2,6,ts-global_detected_seizures,324892,325059,167
Jensen_Eisai_groupA,1,5,ts-global_detected_seizures,324931,325906,975
Jensen_Eisai_groupA,2,6,ts-global_detected_seizures,325071,325094,23
Jensen_Eisai_groupA,2,6,ts-global_detected_seizures,325158,325181,23
Jensen_Eisai_groupA,2,6,ts-global_detected_seizures,325196,325218,22
Jensen_Eisai_groupA,2,6,ts-global_detected_seizures,325245,325283,38
Jensen_Eisai_groupA,2,6,ts-global_detected_seizures,325295,325325,30
Jensen_Eisai_groupA,2,6,ts-global_detected_seizures,325326,325353,27
Jensen_Eisai_groupA,2,6,ts-global_detected_seizures,325367,325391,24
Jensen_Eisai_groupA,2,6,ts-global_detected_seizures,325458,325486,28
Jensen_Eisai_groupA,2,6,ts-global_detected_seizures,325510,325536,26
Jensen_Eisai_groupA,2,6,ts-global_detected_seizures,325543,325922,379
Jensen_Eisai_groupA,1,5,ts-global_detected_seizures,325907,327691,1784
Jensen_Eisai_groupA,2,6,ts-global_detected_seizures,325923,326084,161
Jensen_Eisai_groupA,2,6,ts-global_detected_seizures,326085,327251,1166
Jensen_Eisai_groupA,2,6,ts-global_detected_seizures,327253,327436,183
Jensen_Eisai_groupA,2,6,ts-global_detected_seizures,327437,327459,22
Jensen_Eisai_groupA,2,6,ts-global_detected_seizures,327557,327705,148
Jensen_Eisai_groupA,1,5,ts-global_detected_seizures,327696,327726,30
Jensen_Eisai_groupA,1,5,ts-global_detected_seizures,327727,328613,886
Jensen_Eisai_groupA,2,6,ts-global_detected_seizures,327829,327868,39
Jensen_Eisai_groupA,2,6,ts-global_detected_seizures,327978,328009,31
Jensen_Eisai_groupA,2,6,ts-global_detected_seizures,328018,329234,1216
Jensen_Eisai_groupA,4,8,ts-global_detected_seizures,328606,333124,4518
Jensen_Eisai_groupA,1,5,ts-global_detected_seizures,328614,329515,901
Jensen_Eisai_groupA,2,6,ts-global_detected_seizures,329235,329262,27
Jensen_Eisai_groupA,2,6,ts-global_detected_seizures,329343,329365,22
Jensen_Eisai_groupA,2,6,ts-global_detected_seizures,329417,329468,51
Jensen_Eisai_groupA,1,5,ts-global_detected_seizures,329517,329651,134
Jensen_Eisai_groupA,2,6,ts-global_detected_seizures,329525,329548,23
Jensen_Eisai_groupA,2,6,ts-global_detected_seizures,329581,329603,22
Jensen_Eisai_groupA,1,5,ts-global_detected_seizures,329652,329680,28
Jensen_Eisai_groupA,2,6,ts-global_detected_seizures,329656,329679,23
Jensen_Eisai_groupA,1,5,ts-global_detected_seizures,329681,329773,92
Jensen_Eisai_groupA,2,6,ts-global_detected_seizures,329739,329774,35
Jensen_Eisai_groupA,2,6,ts-global_detected_seizures,329804,329830,26
Jensen_Eisai_groupA,2,6,ts-global_detected_seizures,329859,329882,23
Jensen_Eisai_groupA,1,5,ts-global_detected_seizures,329889,329913,24
Jensen_Eisai_groupA,1,5,ts-global_detected_seizures,329920,330134,214
Jensen_Eisai_groupA,2,6,ts-global_detected_seizures,329921,329945,24
Jensen_Eisai_groupA,2,6,ts-global_detected_seizures,330017,330071,54
Jensen_Eisai_groupA,2,6,ts-global_detected_seizures,330142,330177,35
Jensen_Eisai_groupA,2,6,ts-global_detected_seizures,330194,330221,27
Jensen_Eisai_groupA,1,5,ts-global_detected_seizures,330267,330313,46
Jensen_Eisai_groupA,2,6,ts-global_detected_seizures,330284,330313,29
Jensen_Eisai_groupA,2,6,ts-global_detected_seizures,330387,330720,333
Jensen_Eisai_groupA,1,5,ts-global_detected_seizures,330683,330713,30
Jensen_Eisai_groupA,2,6,ts-global_detected_seizures,330721,331192,471
Jensen_Eisai_groupA,1,5,ts-global_detected_seizures,330817,330848,31
Jensen_Eisai_groupA,1,5,ts-global_detected_seizures,330849,330874,25
Jensen_Eisai_groupA,1,5,ts-global_detected_seizures,331019,331041,22
Jensen_Eisai_groupA,1,5,ts-global_detected_seizures,331063,331135,72
Jensen_Eisai_groupA,2,6,ts-global_detected_seizures,331193,331301,108
Jensen_Eisai_groupA,2,6,ts-global_detected_seizures,331304,331765,461
Jensen_Eisai_groupA,1,5,ts-global_detected_seizures,331406,331444,38
Jensen_Eisai_groupA,1,5,ts-global_detected_seizures,331445,331514,69
Jensen_Eisai_groupA,1,5,ts-global_detected_seizures,331569,331592,23
Jensen_Eisai_groupA,1,5,ts-global_detected_seizures,331710,331733,23
Jensen_Eisai_groupA,2,6,ts-global_detected_seizures,331767,331869,102
Jensen_Eisai_groupA,1,5,ts-global_detected_seizures,331779,331802,23
Jensen_Eisai_groupA,1,5,ts-global_detected_seizures,331804,331831,27
Jensen_Eisai_groupA,1,5,ts-global_detected_seizures,331833,331862,29
Jensen_Eisai_groupA,1,5,ts-global_detected_seizures,331864,331890,26
Jensen_Eisai_groupA,2,6,ts-global_detected_seizures,331906,331930,24
Jensen_Eisai_groupA,1,5,ts-global_detected_seizures,331937,331960,23
Jensen_Eisai_groupA,2,6,ts-global_detected_seizures,331945,331968,23
Jensen_Eisai_groupA,1,5,ts-global_detected_seizures,331991,332019,28
Jensen_Eisai_groupA,2,6,ts-global_detected_seizures,332008,332031,23
Jensen_Eisai_groupA,2,6,ts-global_detected_seizures,332052,332078,26
Jensen_Eisai_groupA,1,5,ts-global_detected_seizures,332066,332136,70
Jensen_Eisai_groupA,2,6,ts-global_detected_seizures,332091,332136,45
Jensen_Eisai_groupA,1,5,ts-global_detected_seizures,332144,332204,60
Jensen_Eisai_groupA,2,6,ts-global_detected_seizures,332177,332202,25
Jensen_Eisai_groupA,1,5,ts-global_detected_seizures,332205,332237,32
Jensen_Eisai_groupA,2,6,ts-global_detected_seizures,332219,332241,22
Jensen_Eisai_groupA,1,5,ts-global_detected_seizures,332238,332294,56
Jensen_Eisai_groupA,2,6,ts-global_detected_seizures,332254,332277,23
Jensen_Eisai_groupA,1,5,ts-global_detected_seizures,332295,332336,41
Jensen_Eisai_groupA,1,5,ts-global_detected_seizures,332360,332395,35
Jensen_Eisai_groupA,2,6,ts-global_detected_seizures,332365,332393,28
Jensen_Eisai_groupA,2,6,ts-global_detected_seizures,332457,332489,32
Jensen_Eisai_groupA,1,5,ts-global_detected_seizures,332464,332504,40
Jensen_Eisai_groupA,1,5,ts-global_detected_seizures,332505,332529,24
Jensen_Eisai_groupA,2,6,ts-global_detected_seizures,332528,332555,27
Jensen_Eisai_groupA,1,5,ts-global_detected_seizures,332538,332578,40
Jensen_Eisai_groupA,2,6,ts-global_detected_seizures,332566,332589,23
Jensen_Eisai_groupA,1,5,ts-global_detected_seizures,332595,332631,36
Jensen_Eisai_groupA,1,5,ts-global_detected_seizures,332635,332668,33
Jensen_Eisai_groupA,2,6,ts-global_detected_seizures,332654,332681,27
Jensen_Eisai_groupA,1,5,ts-global_detected_seizures,332686,332714,28
Jensen_Eisai_groupA,2,6,ts-global_detected_seizures,332700,332742,42
Jensen_Eisai_groupA,1,5,ts-global_detected_seizures,332732,332754,22
Jensen_Eisai_groupA,2,6,ts-global_detected_seizures,332743,332781,38
Jensen_Eisai_groupA,2,6,ts-global_detected_seizures,332806,333083,277
Jensen_Eisai_groupA,1,5,ts-global_detected_seizures,332831,332859,28
Jensen_Eisai_groupA,1,5,ts-global_detected_seizures,332861,332929,68
Jensen_Eisai_groupA,1,5,ts-global_detected_seizures,332930,332965,35
Jensen_Eisai_groupA,1,5,ts-global_detected_seizures,332984,334191,1207
Jensen_Eisai_groupA,2,6,ts-global_detected_seizures,333084,334533,1449
Jensen_Eisai_groupA,4,8,ts-global_detected_seizures,333125,344454,11329
Jensen_Eisai_groupA,1,5,ts-global_detected_seizures,334192,339675,5483
Jensen_Eisai_groupA,2,6,ts-global_detected_seizures,334534,334762,228
Jensen_Eisai_groupA,2,6,ts-global_detected_seizures,334763,334811,48
Jensen_Eisai_groupA,2,6,ts-global_detected_seizures,334953,334986,33
Jensen_Eisai_groupA,2,6,ts-global_detected_seizures,335070,335095,25
Jensen_Eisai_groupA,2,6,ts-global_detected_seizures,335130,335154,24
Jensen_Eisai_groupA,2,6,ts-global_detected_seizures,335209,335240,31
Jensen_Eisai_groupA,2,6,ts-global_detected_seizures,335241,335263,22
Jensen_Eisai_groupA,2,6,ts-global_detected_seizures,335299,335420,121
Jensen_Eisai_groupA,2,6,ts-global_detected_seizures,335428,335467,39
Jensen_Eisai_groupA,2,6,ts-global_detected_seizures,335490,335518,28
Jensen_Eisai_groupA,2,6,ts-global_detected_seizures,335540,335570,30
Jensen_Eisai_groupA,2,6,ts-global_detected_seizures,335618,335662,44
Jensen_Eisai_groupA,2,6,ts-global_detected_seizures,335677,335712,35
Jensen_Eisai_groupA,2,6,ts-global_detected_seizures,335713,335739,26
Jensen_Eisai_groupA,2,6,ts-global_detected_seizures,335846,335933,87
Jensen_Eisai_groupA,2,6,ts-global_detected_seizures,335935,335963,28
Jensen_Eisai_groupA,2,6,ts-global_detected_seizures,336029,336059,30
Jensen_Eisai_groupA,2,6,ts-global_detected_seizures,336127,336163,36
Jensen_Eisai_groupA,2,6,ts-global_detected_seizures,336210,336239,29
Jensen_Eisai_groupA,2,6,ts-global_detected_seizures,336260,336292,32
Jensen_Eisai_groupA,2,6,ts-global_detected_seizures,336304,336329,25
Jensen_Eisai_groupA,2,6,ts-global_detected_seizures,336385,336443,58
Jensen_Eisai_groupA,2,6,ts-global_detected_seizures,336444,336466,22
Jensen_Eisai_groupA,2,6,ts-global_detected_seizures,336480,336505,25
Jensen_Eisai_groupA,2,6,ts-global_detected_seizures,336506,336533,27
Jensen_Eisai_groupA,2,6,ts-global_detected_seizures,336542,336572,30
Jensen_Eisai_groupA,2,6,ts-global_detected_seizures,336580,336607,27
Jensen_Eisai_groupA,2,6,ts-global_detected_seizures,336617,336640,23
Jensen_Eisai_groupA,2,6,ts-global_detected_seizures,336688,336720,32
Jensen_Eisai_groupA,2,6,ts-global_detected_seizures,336725,336753,28
Jensen_Eisai_groupA,2,6,ts-global_detected_seizures,336787,337043,256
Jensen_Eisai_groupA,2,6,ts-global_detected_seizures,337045,337067,22
Jensen_Eisai_groupA,2,6,ts-global_detected_seizures,337069,337102,33
Jensen_Eisai_groupA,2,6,ts-global_detected_seizures,337203,337233,30
Jensen_Eisai_groupA,2,6,ts-global_detected_seizures,337263,337300,37
Jensen_Eisai_groupA,2,6,ts-global_detected_seizures,337316,337351,35
Jensen_Eisai_groupA,2,6,ts-global_detected_seizures,337431,337470,39
Jensen_Eisai_groupA,2,6,ts-global_detected_seizures,337485,337517,32
Jensen_Eisai_groupA,2,6,ts-global_detected_seizures,337547,337596,49
Jensen_Eisai_groupA,2,6,ts-global_detected_seizures,337622,337685,63
Jensen_Eisai_groupA,2,6,ts-global_detected_seizures,337755,337784,29
Jensen_Eisai_groupA,2,6,ts-global_detected_seizures,337787,337838,51
Jensen_Eisai_groupA,2,6,ts-global_detected_seizures,337894,337920,26
Jensen_Eisai_groupA,2,6,ts-global_detected_seizures,337894,337920,26
Jensen_Eisai_groupA,2,6,ts-global_detected_seizures,337987,338039,52
Jensen_Eisai_groupA,2,6,ts-global_detected_seizures,338063,338097,34
Jensen_Eisai_groupA,2,6,ts-global_detected_seizures,338161,338244,83
Jensen_Eisai_groupA,2,6,ts-global_detected_seizures,338333,338356,23
Jensen_Eisai_groupA,2,6,ts-global_detected_seizures,338399,338848,449
Jensen_Eisai_groupA,2,6,ts-global_detected_seizures,338849,340797,1948
Jensen_Eisai_groupA,1,5,ts-global_detected_seizures,339676,340569,893
Jensen_Eisai_groupA,1,5,ts-global_detected_seizures,340642,340682,40
Jensen_Eisai_groupA,1,5,ts-global_detected_seizures,340715,341504,789
Jensen_Eisai_groupA,2,6,ts-global_detected_seizures,340799,340842,43
Jensen_Eisai_groupA,2,6,ts-global_detected_seizures,340852,340876,24
Jensen_Eisai_groupA,2,6,ts-global_detected_seizures,340890,340920,30
Jensen_Eisai_groupA,2,6,ts-global_detected_seizures,340922,341912,990
Jensen_Eisai_groupA,1,5,ts-global_detected_seizures,341505,341585,80
Jensen_Eisai_groupA,1,5,ts-global_detected_seizures,341685,341712,27
Jensen_Eisai_groupA,1,5,ts-global_detected_seizures,341901,341933,32
Jensen_Eisai_groupA,2,6,ts-global_detected_seizures,341913,341993,80
Jensen_Eisai_groupA,1,5,ts-global_detected_seizures,342075,342100,25
Jensen_Eisai_groupA,2,6,ts-global_detected_seizures,342104,342131,27
Jensen_Eisai_groupA,1,5,ts-global_detected_seizures,342226,342260,34
Jensen_Eisai_groupA,1,5,ts-global_detected_seizures,342261,342329,68
Jensen_Eisai_groupA,2,6,ts-global_detected_seizures,342267,342338,71
Jensen_Eisai_groupA,1,5,ts-global_detected_seizures,342423,342471,48
Jensen_Eisai_groupA,1,5,ts-global_detected_seizures,342482,342559,77
Jensen_Eisai_groupA,2,6,ts-global_detected_seizures,342537,342561,24
Jensen_Eisai_groupA,2,6,ts-global_detected_seizures,342607,342635,28
Jensen_Eisai_groupA,1,5,ts-global_detected_seizures,342616,342645,29
Jensen_Eisai_groupA,1,5,ts-global_detected_seizures,342647,342670,23
Jensen_Eisai_groupA,1,5,ts-global_detected_seizures,342672,342883,211
Jensen_Eisai_groupA,2,6,ts-global_detected_seizures,342686,342708,22
Jensen_Eisai_groupA,2,6,ts-global_detected_seizures,342723,342748,25
Jensen_Eisai_groupA,2,6,ts-global_detected_seizures,342833,342902,69
Jensen_Eisai_groupA,1,5,ts-global_detected_seizures,342884,342924,40
Jensen_Eisai_groupA,2,6,ts-global_detected_seizures,342944,343540,596
Jensen_Eisai_groupA,1,5,ts-global_detected_seizures,342957,343018,61
Jensen_Eisai_groupA,1,5,ts-global_detected_seizures,343084,343153,69
Jensen_Eisai_groupA,1,5,ts-global_detected_seizures,343321,343420,99
Jensen_Eisai_groupA,1,5,ts-global_detected_seizures,343452,343487,35
Jensen_Eisai_groupA,1,5,ts-global_detected_seizures,343530,343616,86
Jensen_Eisai_groupA,2,6,ts-global_detected_seizures,343541,343645,104
Jensen_Eisai_groupA,1,5,ts-global_detected_seizures,343618,343661,43
Jensen_Eisai_groupA,2,6,ts-global_detected_seizures,343646,344454,808
Jensen_Eisai_groupA,1,5,ts-global_detected_seizures,343678,343708,30
Jensen_Eisai_groupA,1,5,ts-global_detected_seizures,343726,343791,65
Jensen_Eisai_groupA,1,5,ts-global_detected_seizures,343806,343839,33
Jensen_Eisai_groupA,1,5,ts-global_detected_seizures,343840,343878,38
Jensen_Eisai_groupA,1,5,ts-global_detected_seizures,343879,343903,24
Jensen_Eisai_groupA,1,5,ts-global_detected_seizures,343938,344088,150
Jensen_Eisai_groupA,1,5,ts-global_detected_seizures,344151,344202,51
Jensen_Eisai_groupA,1,5,ts-global_detected_seizures,344210,344291,81
Jensen_Eisai_groupA,1,5,ts-global_detected_seizures,344306,344339,33
Jensen_Eisai_groupA,1,5,ts-global_detected_seizures,344342,344364,22
Jensen_Eisai_groupA,1,5,ts-global_detected_seizures,344382,344432,50
Jensen_Eisai_groupA,1,5,LL-indiv_detected_seizures,41700,41732,32
Jensen_Eisai_groupA,1,5,LL-indiv_detected_seizures,42434,42467,33
Jensen_Eisai_groupA,1,5,ts-indiv_detected_seizures,41700,41732,32
Jensen_Eisai_groupA,1,5,ts-indiv_detected_seizures,42433,42468,35
Jensen_Eisai_groupA,1,5,LL-global_detected_seizures,41700,41731,31
Jensen_Eisai_groupA,1,5,LL-global_detected_seizures,42437,42467,30
Jensen_Eisai_groupA,1,5,Non_Seizures,6225.524,6283.426,57.902
Jensen_Eisai_groupA,1,5,Non_Seizures,15118.091,15176.969,58.8779999999988
Jensen_Eisai_groupA,1,5,Non_Seizures,39633.952,39683.171,49.2190000000046
Jensen_Eisai_groupA,1,5,Non_Seizures,39697.562,39742.147,44.5849999999991
Jensen_Eisai_groupA,1,5,True_Seizures,41699.645,41730.206,30.5610000000015
Jensen_Eisai_groupA,1,5,True_Seizures,42431.927,42465.846,33.9189999999944
Jensen_Eisai_groupB,3,6,ts-global_detected_seizures,1,309,308
Jensen_Eisai_groupB,2,5,ts-global_detected_seizures,123,313,190
Jensen_Eisai_groupB,3,6,ts-global_detected_seizures,310,22057,21747
Jensen_Eisai_groupB,2,5,ts-global_detected_seizures,315,439,124
Jensen_Eisai_groupB,2,5,ts-global_detected_seizures,440,918,478
Jensen_Eisai_groupB,1,4,ts-global_detected_seizures,625,1032,407
Jensen_Eisai_groupB,2,5,ts-global_detected_seizures,927,1237,310
Jensen_Eisai_groupB,1,4,ts-global_detected_seizures,1033,1236,203
Jensen_Eisai_groupB,2,5,ts-global_detected_seizures,1239,1342,103
Jensen_Eisai_groupB,1,4,ts-global_detected_seizures,1276,2872,1596
Jensen_Eisai_groupB,2,5,ts-global_detected_seizures,1354,1379,25
Jensen_Eisai_groupB,2,5,ts-global_detected_seizures,1415,1709,294
Jensen_Eisai_groupB,2,5,ts-global_detected_seizures,1747,1773,26
Jensen_Eisai_groupB,2,5,ts-global_detected_seizures,1836,1864,28
Jensen_Eisai_groupB,2,5,ts-global_detected_seizures,1942,1975,33
Jensen_Eisai_groupB,2,5,ts-global_detected_seizures,2227,2251,24
Jensen_Eisai_groupB,2,5,ts-global_detected_seizures,2419,2442,23
Jensen_Eisai_groupB,2,5,ts-global_detected_seizures,2640,2677,37
Jensen_Eisai_groupB,2,5,ts-global_detected_seizures,2736,2763,27
Jensen_Eisai_groupB,2,5,ts-global_detected_seizures,2813,2837,24
Jensen_Eisai_groupB,1,4,ts-global_detected_seizures,2873,2911,38
Jensen_Eisai_groupB,2,5,ts-global_detected_seizures,2903,2932,29
Jensen_Eisai_groupB,1,4,ts-global_detected_seizures,2923,2960,37
Jensen_Eisai_groupB,2,5,ts-global_detected_seizures,3004,3050,46
Jensen_Eisai_groupB,1,4,ts-global_detected_seizures,3067,3095,28
Jensen_Eisai_groupB,2,5,ts-global_detected_seizures,3094,3118,24
Jensen_Eisai_groupB,2,5,ts-global_detected_seizures,3129,3159,30
Jensen_Eisai_groupB,2,5,ts-global_detected_seizures,3168,3196,28
Jensen_Eisai_groupB,1,4,ts-global_detected_seizures,3262,3306,44
Jensen_Eisai_groupB,1,4,ts-global_detected_seizures,3344,3368,24
Jensen_Eisai_groupB,2,5,ts-global_detected_seizures,3377,3401,24
Jensen_Eisai_groupB,1,4,ts-global_detected_seizures,3394,3417,23
Jensen_Eisai_groupB,2,5,ts-global_detected_seizures,3448,3476,28
Jensen_Eisai_groupB,1,4,ts-global_detected_seizures,3500,3575,75
Jensen_Eisai_groupB,2,5,ts-global_detected_seizures,3504,3562,58
Jensen_Eisai_groupB,2,5,ts-global_detected_seizures,3563,3612,49
Jensen_Eisai_groupB,1,4,ts-global_detected_seizures,3599,3633,34
Jensen_Eisai_groupB,1,4,ts-global_detected_seizures,3642,3678,36
Jensen_Eisai_groupB,2,5,ts-global_detected_seizures,3662,3684,22
Jensen_Eisai_groupB,1,4,ts-global_detected_seizures,3716,3783,67
Jensen_Eisai_groupB,1,4,ts-global_detected_seizures,3784,3818,34
Jensen_Eisai_groupB,2,5,ts-global_detected_seizures,3794,3822,28
Jensen_Eisai_groupB,1,4,ts-global_detected_seizures,3871,3901,30
Jensen_Eisai_groupB,1,4,ts-global_detected_seizures,3985,4135,150
Jensen_Eisai_groupB,2,5,ts-global_detected_seizures,4028,4053,25
Jensen_Eisai_groupB,2,5,ts-global_detected_seizures,4095,4124,29
Jensen_Eisai_groupB,2,5,ts-global_detected_seizures,4192,4245,53
Jensen_Eisai_groupB,2,5,ts-global_detected_seizures,4268,4300,32
Jensen_Eisai_groupB,1,4,ts-global_detected_seizures,4292,4323,31
Jensen_Eisai_groupB,1,4,ts-global_detected_seizures,4325,4366,41
Jensen_Eisai_groupB,2,5,ts-global_detected_seizures,4336,4369,33
Jensen_Eisai_groupB,2,5,ts-global_detected_seizures,4407,4490,83
Jensen_Eisai_groupB,1,4,ts-global_detected_seizures,4473,4535,62
Jensen_Eisai_groupB,2,5,ts-global_detected_seizures,4492,4603,111
Jensen_Eisai_groupB,1,4,ts-global_detected_seizures,4536,4577,41
Jensen_Eisai_groupB,1,4,ts-global_detected_seizures,4593,4618,25
Jensen_Eisai_groupB,2,5,ts-global_detected_seizures,4614,4641,27
Jensen_Eisai_groupB,1,4,ts-global_detected_seizures,4628,4662,34
Jensen_Eisai_groupB,2,5,ts-global_detected_seizures,4644,5170,526
Jensen_Eisai_groupB,1,4,ts-global_detected_seizures,4681,4706,25
Jensen_Eisai_groupB,1,4,ts-global_detected_seizures,4737,4782,45
Jensen_Eisai_groupB,1,4,ts-global_detected_seizures,4793,4859,66
Jensen_Eisai_groupB,1,4,ts-global_detected_seizures,4894,4931,37
Jensen_Eisai_groupB,1,4,ts-global_detected_seizures,4968,4993,25
Jensen_Eisai_groupB,1,4,ts-global_detected_seizures,5027,5063,36
Jensen_Eisai_groupB,1,4,ts-global_detected_seizures,5085,5112,27
Jensen_Eisai_groupB,1,4,ts-global_detected_seizures,5145,5197,52
Jensen_Eisai_groupB,2,5,ts-global_detected_seizures,5184,5232,48
Jensen_Eisai_groupB,1,4,ts-global_detected_seizures,5230,5258,28
Jensen_Eisai_groupB,2,5,ts-global_detected_seizures,5233,5338,105
Jensen_Eisai_groupB,1,4,ts-global_detected_seizures,5273,5319,46
Jensen_Eisai_groupB,1,4,ts-global_detected_seizures,5337,5372,35
Jensen_Eisai_groupB,2,5,ts-global_detected_seizures,5386,5414,28
Jensen_Eisai_groupB,1,4,ts-global_detected_seizures,5415,5539,124
Jensen_Eisai_groupB,2,5,ts-global_detected_seizures,5525,5561,36
Jensen_Eisai_groupB,1,4,ts-global_detected_seizures,5540,5570,30
Jensen_Eisai_groupB,1,4,ts-global_detected_seizures,5587,5624,37
Jensen_Eisai_groupB,2,5,ts-global_detected_seizures,5604,5635,31
Jensen_Eisai_groupB,1,4,ts-global_detected_seizures,5627,5664,37
Jensen_Eisai_groupB,2,5,ts-global_detected_seizures,5674,5696,22
Jensen_Eisai_groupB,1,4,ts-global_detected_seizures,5676,5763,87
Jensen_Eisai_groupB,2,5,ts-global_detected_seizures,5700,5729,29
Jensen_Eisai_groupB,1,4,ts-global_detected_seizures,5766,5800,34
Jensen_Eisai_groupB,1,4,ts-global_detected_seizures,5813,5844,31
Jensen_Eisai_groupB,2,5,ts-global_detected_seizures,5832,5865,33
Jensen_Eisai_groupB,1,4,ts-global_detected_seizures,5847,5884,37
Jensen_Eisai_groupB,1,4,ts-global_detected_seizures,5931,5966,35
Jensen_Eisai_groupB,1,4,ts-global_detected_seizures,5994,6069,75
Jensen_Eisai_groupB,2,5,ts-global_detected_seizures,6017,6070,53
Jensen_Eisai_groupB,2,5,ts-global_detected_seizures,6083,6111,28
Jensen_Eisai_groupB,1,4,ts-global_detected_seizures,6086,6111,25
Jensen_Eisai_groupB,1,4,ts-global_detected_seizures,6126,6150,24
Jensen_Eisai_groupB,2,5,ts-global_detected_seizures,6154,6187,33
Jensen_Eisai_groupB,1,4,ts-global_detected_seizures,6156,6194,38
Jensen_Eisai_groupB,2,5,ts-global_detected_seizures,6195,6221,26
Jensen_Eisai_groupB,1,4,ts-global_detected_seizures,6247,6287,40
Jensen_Eisai_groupB,2,5,ts-global_detected_seizures,6282,6305,23
Jensen_Eisai_groupB,1,4,ts-global_detected_seizures,6303,6406,103
Jensen_Eisai_groupB,2,5,ts-global_detected_seizures,6406,6436,30
Jensen_Eisai_groupB,1,4,ts-global_detected_seizures,6426,6517,91
Jensen_Eisai_groupB,2,5,ts-global_detected_seizures,6461,6510,49
Jensen_Eisai_groupB,1,4,ts-global_detected_seizures,6536,8297,1761
Jensen_Eisai_groupB,2,5,ts-global_detected_seizures,6556,6584,28
Jensen_Eisai_groupB,2,5,ts-global_detected_seizures,6710,6738,28
Jensen_Eisai_groupB,2,5,ts-global_detected_seizures,6760,6783,23
Jensen_Eisai_groupB,2,5,ts-global_detected_seizures,6788,6813,25
Jensen_Eisai_groupB,2,5,ts-global_detected_seizures,6894,6971,77
Jensen_Eisai_groupB,2,5,ts-global_detected_seizures,7042,7067,25
Jensen_Eisai_groupB,2,5,ts-global_detected_seizures,7092,7121,29
Jensen_Eisai_groupB,2,5,ts-global_detected_seizures,7153,7180,27
Jensen_Eisai_groupB,2,5,ts-global_detected_seizures,7215,7241,26
Jensen_Eisai_groupB,2,5,ts-global_detected_seizures,7250,7298,48
Jensen_Eisai_groupB,2,5,ts-global_detected_seizures,7343,7368,25
Jensen_Eisai_groupB,2,5,ts-global_detected_seizures,7395,7417,22
Jensen_Eisai_groupB,2,5,ts-global_detected_seizures,7507,7537,30
Jensen_Eisai_groupB,2,5,ts-global_detected_seizures,7555,7585,30
Jensen_Eisai_groupB,2,5,ts-global_detected_seizures,7592,7692,100
Jensen_Eisai_groupB,2,5,ts-global_detected_seizures,7693,7748,55
Jensen_Eisai_groupB,2,5,ts-global_detected_seizures,7749,7961,212
Jensen_Eisai_groupB,2,5,ts-global_detected_seizures,7962,8490,528
Jensen_Eisai_groupB,1,4,ts-global_detected_seizures,8300,8679,379
Jensen_Eisai_groupB,2,5,ts-global_detected_seizures,8491,8586,95
Jensen_Eisai_groupB,2,5,ts-global_detected_seizures,8587,9023,436
Jensen_Eisai_groupB,1,4,ts-global_detected_seizures,8680,8738,58
Jensen_Eisai_groupB,1,4,ts-global_detected_seizures,8745,8786,41
Jensen_Eisai_groupB,1,4,ts-global_detected_seizures,8909,8938,29
Jensen_Eisai_groupB,2,5,ts-global_detected_seizures,9024,9109,85
Jensen_Eisai_groupB,1,4,ts-global_detected_seizures,9108,9136,28
Jensen_Eisai_groupB,2,5,ts-global_detected_seizures,9110,9435,325
Jensen_Eisai_groupB,1,4,ts-global_detected_seizures,9141,9257,116
Jensen_Eisai_groupB,1,4,ts-global_detected_seizures,9258,9293,35
Jensen_Eisai_groupB,1,4,ts-global_detected_seizures,9312,9339,27
Jensen_Eisai_groupB,1,4,ts-global_detected_seizures,9414,9580,166
Jensen_Eisai_groupB,2,5,ts-global_detected_seizures,9436,9465,29
Jensen_Eisai_groupB,2,5,ts-global_detected_seizures,9571,9596,25
Jensen_Eisai_groupB,2,5,ts-global_detected_seizures,9614,9639,25
Jensen_Eisai_groupB,1,4,ts-global_detected_seizures,9664,9688,24
Jensen_Eisai_groupB,2,5,ts-global_detected_seizures,9677,9708,31
Jensen_Eisai_groupB,1,4,ts-global_detected_seizures,9702,9729,27
Jensen_Eisai_groupB,1,4,ts-global_detected_seizures,9730,9759,29
Jensen_Eisai_groupB,2,5,ts-global_detected_seizures,9763,9787,24
Jensen_Eisai_groupB,1,4,ts-global_detected_seizures,9768,9790,22
Jensen_Eisai_groupB,1,4,ts-global_detected_seizures,9819,9921,102
Jensen_Eisai_groupB,1,4,ts-global_detected_seizures,9939,9963,24
Jensen_Eisai_groupB,1,4,ts-global_detected_seizures,9972,10012,40
Jensen_Eisai_groupB,1,4,ts-global_detected_seizures,10016,10040,24
Jensen_Eisai_groupB,2,5,ts-global_detected_seizures,10024,10097,73
Jensen_Eisai_groupB,1,4,ts-global_detected_seizures,10041,10241,200
Jensen_Eisai_groupB,2,5,ts-global_detected_seizures,10098,10162,64
Jensen_Eisai_groupB,2,5,ts-global_detected_seizures,10174,10220,46
Jensen_Eisai_groupB,2,5,ts-global_detected_seizures,10236,10318,82
Jensen_Eisai_groupB,1,4,ts-global_detected_seizures,10242,10357,115
Jensen_Eisai_groupB,1,4,ts-global_detected_seizures,10370,10394,24
Jensen_Eisai_groupB,2,5,ts-global_detected_seizures,10371,10449,78
Jensen_Eisai_groupB,1,4,ts-global_detected_seizures,10400,10463,63
Jensen_Eisai_groupB,1,4,ts-global_detected_seizures,10505,10537,32
Jensen_Eisai_groupB,1,4,ts-global_detected_seizures,10546,10570,24
Jensen_Eisai_groupB,2,5,ts-global_detected_seizures,10560,10616,56
Jensen_Eisai_groupB,1,4,ts-global_detected_seizures,10593,10619,26
Jensen_Eisai_groupB,1,4,ts-global_detected_seizures,10647,10676,29
Jensen_Eisai_groupB,1,4,ts-global_detected_seizures,10709,10863,154
Jensen_Eisai_groupB,2,5,ts-global_detected_seizures,10799,10830,31
Jensen_Eisai_groupB,1,4,ts-global_detected_seizures,10879,10922,43
Jensen_Eisai_groupB,2,5,ts-global_detected_seizures,10894,10952,58
Jensen_Eisai_groupB,1,4,ts-global_detected_seizures,10948,11018,70
Jensen_Eisai_groupB,1,4,ts-global_detected_seizures,11020,11057,37
Jensen_Eisai_groupB,1,4,ts-global_detected_seizures,11078,11105,27
Jensen_Eisai_groupB,1,4,ts-global_detected_seizures,11137,11164,27
Jensen_Eisai_groupB,1,4,ts-global_detected_seizures,11165,11238,73
Jensen_Eisai_groupB,2,5,ts-global_detected_seizures,11289,11365,76
Jensen_Eisai_groupB,1,4,ts-global_detected_seizures,11320,11360,40
Jensen_Eisai_groupB,1,4,ts-global_detected_seizures,11396,11425,29
Jensen_Eisai_groupB,1,4,ts-global_detected_seizures,11438,11494,56
Jensen_Eisai_groupB,2,5,ts-global_detected_seizures,11443,11470,27
Jensen_Eisai_groupB,2,5,ts-global_detected_seizures,11472,11497,25
Jensen_Eisai_groupB,2,5,ts-global_detected_seizures,11531,11623,92
Jensen_Eisai_groupB,2,5,ts-global_detected_seizures,11670,11703,33
Jensen_Eisai_groupB,1,4,ts-global_detected_seizures,11736,11809,73
Jensen_Eisai_groupB,2,5,ts-global_detected_seizures,11776,11807,31
Jensen_Eisai_groupB,1,4,ts-global_detected_seizures,11810,11844,34
Jensen_Eisai_groupB,1,4,ts-global_detected_seizures,11892,11920,28
Jensen_Eisai_groupB,2,5,ts-global_detected_seizures,11895,11930,35
Jensen_Eisai_groupB,1,4,ts-global_detected_seizures,11921,11963,42
Jensen_Eisai_groupB,2,5,ts-global_detected_seizures,11982,12004,22
Jensen_Eisai_groupB,1,4,ts-global_detected_seizures,12038,12063,25
Jensen_Eisai_groupB,1,4,ts-global_detected_seizures,12087,12130,43
Jensen_Eisai_groupB,1,4,ts-global_detected_seizures,12168,12223,55
Jensen_Eisai_groupB,2,5,ts-global_detected_seizures,12183,12208,25
Jensen_Eisai_groupB,1,4,ts-global_detected_seizures,12254,12288,34
Jensen_Eisai_groupB,2,5,ts-global_detected_seizures,12275,12325,50
Jensen_Eisai_groupB,1,4,ts-global_detected_seizures,12289,12325,36
Jensen_Eisai_groupB,1,4,ts-global_detected_seizures,12341,12366,25
Jensen_Eisai_groupB,2,5,ts-global_detected_seizures,12353,12423,70
Jensen_Eisai_groupB,1,4,ts-global_detected_seizures,12367,12393,26
Jensen_Eisai_groupB,1,4,ts-global_detected_seizures,12400,12429,29
Jensen_Eisai_groupB,2,5,ts-global_detected_seizures,12424,12498,74
Jensen_Eisai_groupB,1,4,ts-global_detected_seizures,12442,12536,94
Jensen_Eisai_groupB,2,5,ts-global_detected_seizures,12499,12522,23
Jensen_Eisai_groupB,2,5,ts-global_detected_seizures,12551,13457,906
Jensen_Eisai_groupB,1,4,ts-global_detected_seizures,12553,12582,29
Jensen_Eisai_groupB,1,4,ts-global_detected_seizures,12591,12622,31
Jensen_Eisai_groupB,1,4,ts-global_detected_seizures,12638,12689,51
Jensen_Eisai_groupB,1,4,ts-global_detected_seizures,12690,12728,38
Jensen_Eisai_groupB,1,4,ts-global_detected_seizures,12775,12806,31
Jensen_Eisai_groupB,1,4,ts-global_detected_seizures,12824,12868,44
Jensen_Eisai_groupB,1,4,ts-global_detected_seizures,12877,12912,35
Jensen_Eisai_groupB,1,4,ts-global_detected_seizures,12946,12974,28
Jensen_Eisai_groupB,1,4,ts-global_detected_seizures,12976,13026,50
Jensen_Eisai_groupB,1,4,ts-global_detected_seizures,13058,13093,35
Jensen_Eisai_groupB,1,4,ts-global_detected_seizures,13132,13208,76
Jensen_Eisai_groupB,1,4,ts-global_detected_seizures,13209,13333,124
Jensen_Eisai_groupB,1,4,ts-global_detected_seizures,13354,13421,67
Jensen_Eisai_groupB,1,4,ts-global_detected_seizures,13451,13490,39
Jensen_Eisai_groupB,2,5,ts-global_detected_seizures,13458,13546,88
Jensen_Eisai_groupB,1,4,ts-global_detected_seizures,13491,13565,74
Jensen_Eisai_groupB,2,5,ts-global_detected_seizures,13547,13621,74
Jensen_Eisai_groupB,1,4,ts-global_detected_seizures,13582,13637,55
Jensen_Eisai_groupB,1,4,ts-global_detected_seizures,13639,13663,24
Jensen_Eisai_groupB,2,5,ts-global_detected_seizures,13660,13696,36
Jensen_Eisai_groupB,1,4,ts-global_detected_seizures,13665,13687,22
Jensen_Eisai_groupB,1,4,ts-global_detected_seizures,13736,13863,127
Jensen_Eisai_groupB,2,5,ts-global_detected_seizures,13828,13859,31
Jensen_Eisai_groupB,1,4,ts-global_detected_seizures,13866,13890,24
Jensen_Eisai_groupB,2,5,ts-global_detected_seizures,13934,13958,24
Jensen_Eisai_groupB,1,4,ts-global_detected_seizures,13943,13990,47
Jensen_Eisai_groupB,2,5,ts-global_detected_seizures,13972,14003,31
Jensen_Eisai_groupB,1,4,ts-global_detected_seizures,14007,14039,32
Jensen_Eisai_groupB,2,5,ts-global_detected_seizures,14049,14092,43
Jensen_Eisai_groupB,1,4,ts-global_detected_seizures,14080,14109,29
Jensen_Eisai_groupB,1,4,ts-global_detected_seizures,14145,14182,37
Jensen_Eisai_groupB,2,5,ts-global_detected_seizures,14155,14190,35
Jensen_Eisai_groupB,1,4,ts-global_detected_seizures,14196,14303,107
Jensen_Eisai_groupB,2,5,ts-global_detected_seizures,14243,14281,38
Jensen_Eisai_groupB,2,5,ts-global_detected_seizures,14297,14331,34
Jensen_Eisai_groupB,1,4,ts-global_detected_seizures,14320,14446,126
Jensen_Eisai_groupB,2,5,ts-global_detected_seizures,14372,14395,23
Jensen_Eisai_groupB,2,5,ts-global_detected_seizures,14448,14472,24
Jensen_Eisai_groupB,1,4,ts-global_detected_seizures,14504,14636,132
Jensen_Eisai_groupB,2,5,ts-global_detected_seizures,14582,14617,35
Jensen_Eisai_groupB,2,5,ts-global_detected_seizures,14632,14659,27
Jensen_Eisai_groupB,1,4,ts-global_detected_seizures,14646,14768,122
Jensen_Eisai_groupB,2,5,ts-global_detected_seizures,14662,14695,33
Jensen_Eisai_groupB,2,5,ts-global_detected_seizures,14723,14749,26
Jensen_Eisai_groupB,1,4,ts-global_detected_seizures,14769,17440,2671
Jensen_Eisai_groupB,2,5,ts-global_detected_seizures,14981,15008,27
Jensen_Eisai_groupB,2,5,ts-global_detected_seizures,15042,15078,36
Jensen_Eisai_groupB,2,5,ts-global_detected_seizures,15081,15173,92
Jensen_Eisai_groupB,2,5,ts-global_detected_seizures,15271,15324,53
Jensen_Eisai_groupB,2,5,ts-global_detected_seizures,15325,15349,24
Jensen_Eisai_groupB,2,5,ts-global_detected_seizures,15427,15449,22
Jensen_Eisai_groupB,2,5,ts-global_detected_seizures,15510,15535,25
Jensen_Eisai_groupB,2,5,ts-global_detected_seizures,15578,15600,22
Jensen_Eisai_groupB,2,5,ts-global_detected_seizures,15639,15679,40
Jensen_Eisai_groupB,2,5,ts-global_detected_seizures,15697,15730,33
Jensen_Eisai_groupB,2,5,ts-global_detected_seizures,15763,15794,31
Jensen_Eisai_groupB,2,5,ts-global_detected_seizures,15806,15896,90
Jensen_Eisai_groupB,2,5,ts-global_detected_seizures,15909,15940,31
Jensen_Eisai_groupB,2,5,ts-global_detected_seizures,15968,16001,33
Jensen_Eisai_groupB,2,5,ts-global_detected_seizures,16012,16092,80
Jensen_Eisai_groupB,2,5,ts-global_detected_seizures,16108,16180,72
Jensen_Eisai_groupB,2,5,ts-global_detected_seizures,16181,16271,90
Jensen_Eisai_groupB,2,5,ts-global_detected_seizures,16313,16346,33
Jensen_Eisai_groupB,2,5,ts-global_detected_seizures,16625,16650,25
Jensen_Eisai_groupB,2,5,ts-global_detected_seizures,16687,16717,30
Jensen_Eisai_groupB,2,5,ts-global_detected_seizures,16739,17045,306
Jensen_Eisai_groupB,2,5,ts-global_detected_seizures,17047,17101,54
Jensen_Eisai_groupB,2,5,ts-global_detected_seizures,17102,17125,23
Jensen_Eisai_groupB,2,5,ts-global_detected_seizures,17134,17165,31
Jensen_Eisai_groupB,2,5,ts-global_detected_seizures,17176,17202,26
Jensen_Eisai_groupB,2,5,ts-global_detected_seizures,17218,17500,282
Jensen_Eisai_groupB,1,4,ts-global_detected_seizures,17441,17493,52
Jensen_Eisai_groupB,1,4,ts-global_detected_seizures,17494,17533,39
Jensen_Eisai_groupB,2,5,ts-global_detected_seizures,17501,18168,667
Jensen_Eisai_groupB,1,4,ts-global_detected_seizures,17619,17677,58
Jensen_Eisai_groupB,1,4,ts-global_detected_seizures,17746,17845,99
Jensen_Eisai_groupB,1,4,ts-global_detected_seizures,17912,17943,31
Jensen_Eisai_groupB,1,4,ts-global_detected_seizures,17973,18024,51
Jensen_Eisai_groupB,1,4,ts-global_detected_seizures,18074,18138,64
Jensen_Eisai_groupB,1,4,ts-global_detected_seizures,18157,18199,42
Jensen_Eisai_groupB,2,5,ts-global_detected_seizures,18171,18201,30
Jensen_Eisai_groupB,1,4,ts-global_detected_seizures,18207,18243,36
Jensen_Eisai_groupB,1,4,ts-global_detected_seizures,18274,18340,66
Jensen_Eisai_groupB,1,4,ts-global_detected_seizures,18343,18411,68
Jensen_Eisai_groupB,2,5,ts-global_detected_seizures,18369,18391,22
Jensen_Eisai_groupB,1,4,ts-global_detected_seizures,18422,18455,33
Jensen_Eisai_groupB,1,4,ts-global_detected_seizures,18499,18570,71
Jensen_Eisai_groupB,2,5,ts-global_detected_seizures,18510,18546,36
Jensen_Eisai_groupB,1,4,ts-global_detected_seizures,18607,18646,39
Jensen_Eisai_groupB,2,5,ts-global_detected_seizures,18614,18637,23
Jensen_Eisai_groupB,1,4,ts-global_detected_seizures,18661,18687,26
Jensen_Eisai_groupB,1,4,ts-global_detected_seizures,18733,18797,64
Jensen_Eisai_groupB,1,4,ts-global_detected_seizures,18798,18834,36
Jensen_Eisai_groupB,2,5,ts-global_detected_seizures,18813,18843,30
Jensen_Eisai_groupB,2,5,ts-global_detected_seizures,18844,18880,36
Jensen_Eisai_groupB,1,4,ts-global_detected_seizures,18859,18931,72
Jensen_Eisai_groupB,2,5,ts-global_detected_seizures,18881,18916,35
Jensen_Eisai_groupB,2,5,ts-global_detected_seizures,18927,18982,55
Jensen_Eisai_groupB,1,4,ts-global_detected_seizures,18978,19014,36
Jensen_Eisai_groupB,1,4,ts-global_detected_seizures,19028,19056,28
Jensen_Eisai_groupB,2,5,ts-global_detected_seizures,19040,19064,24
Jensen_Eisai_groupB,2,5,ts-global_detected_seizures,19078,19112,34
Jensen_Eisai_groupB,1,4,ts-global_detected_seizures,19101,19188,87
Jensen_Eisai_groupB,2,5,ts-global_detected_seizures,19145,19176,31
Jensen_Eisai_groupB,1,4,ts-global_detected_seizures,19208,19402,194
Jensen_Eisai_groupB,2,5,ts-global_detected_seizures,19245,19269,24
Jensen_Eisai_groupB,2,5,ts-global_detected_seizures,19385,19417,32
Jensen_Eisai_groupB,1,4,ts-global_detected_seizures,19403,19425,22
Jensen_Eisai_groupB,1,4,ts-global_detected_seizures,19484,19553,69
Jensen_Eisai_groupB,2,5,ts-global_detected_seizures,19491,19556,65
Jensen_Eisai_groupB,1,4,ts-global_detected_seizures,19560,19605,45
Jensen_Eisai_groupB,2,5,ts-global_detected_seizures,19575,19617,42
Jensen_Eisai_groupB,1,4,ts-global_detected_seizures,19617,19650,33
Jensen_Eisai_groupB,1,4,ts-global_detected_seizures,19669,19698,29
Jensen_Eisai_groupB,1,4,ts-global_detected_seizures,19724,19753,29
Jensen_Eisai_groupB,2,5,ts-global_detected_seizures,19763,19785,22
Jensen_Eisai_groupB,1,4,ts-global_detected_seizures,19796,19836,40
Jensen_Eisai_groupB,2,5,ts-global_detected_seizures,19840,19864,24
Jensen_Eisai_groupB,1,4,ts-global_detected_seizures,19848,19899,51
Jensen_Eisai_groupB,2,5,ts-global_detected_seizures,19865,19907,42
Jensen_Eisai_groupB,1,4,ts-global_detected_seizures,19924,19953,29
Jensen_Eisai_groupB,1,4,ts-global_detected_seizures,19954,19979,25
Jensen_Eisai_groupB,1,4,ts-global_detected_seizures,19982,20031,49
Jensen_Eisai_groupB,2,5,ts-global_detected_seizures,20008,20032,24
Jensen_Eisai_groupB,1,4,ts-global_detected_seizures,20040,20121,81
Jensen_Eisai_groupB,2,5,ts-global_detected_seizures,20060,20092,32
Jensen_Eisai_groupB,2,5,ts-global_detected_seizures,20110,20144,34
Jensen_Eisai_groupB,1,4,ts-global_detected_seizures,20137,20183,46
Jensen_Eisai_groupB,2,5,ts-global_detected_seizures,20163,20185,22
Jensen_Eisai_groupB,2,5,ts-global_detected_seizures,20204,20228,24
Jensen_Eisai_groupB,1,4,ts-global_detected_seizures,20212,20459,247
Jensen_Eisai_groupB,2,5,ts-global_detected_seizures,20287,20332,45
Jensen_Eisai_groupB,2,5,ts-global_detected_seizures,20360,20396,36
Jensen_Eisai_groupB,2,5,ts-global_detected_seizures,20397,20422,25
Jensen_Eisai_groupB,2,5,ts-global_detected_seizures,20461,20532,71
Jensen_Eisai_groupB,1,4,ts-global_detected_seizures,20501,20621,120
Jensen_Eisai_groupB,2,5,ts-global_detected_seizures,20601,20633,32
Jensen_Eisai_groupB,1,4,ts-global_detected_seizures,20623,20668,45
Jensen_Eisai_groupB,2,5,ts-global_detected_seizures,20653,20703,50
Jensen_Eisai_groupB,1,4,ts-global_detected_seizures,20669,20722,53
Jensen_Eisai_groupB,2,5,ts-global_detected_seizures,20748,20782,34
Jensen_Eisai_groupB,1,4,ts-global_detected_seizures,20763,20816,53
Jensen_Eisai_groupB,2,5,ts-global_detected_seizures,20809,20846,37
Jensen_Eisai_groupB,1,4,ts-global_detected_seizures,20817,20865,48
Jensen_Eisai_groupB,2,5,ts-global_detected_seizures,20849,20878,29
Jensen_Eisai_groupB,1,4,ts-global_detected_seizures,20866,20893,27
Jensen_Eisai_groupB,2,5,ts-global_detected_seizures,20897,20924,27
Jensen_Eisai_groupB,1,4,ts-global_detected_seizures,20904,20975,71
Jensen_Eisai_groupB,2,5,ts-global_detected_seizures,20945,20969,24
Jensen_Eisai_groupB,1,4,ts-global_detected_seizures,20987,21031,44
Jensen_Eisai_groupB,2,5,ts-global_detected_seizures,21005,21059,54
Jensen_Eisai_groupB,1,4,ts-global_detected_seizures,21032,21065,33
Jensen_Eisai_groupB,1,4,ts-global_detected_seizures,21070,21126,56
Jensen_Eisai_groupB,2,5,ts-global_detected_seizures,21117,21150,33
Jensen_Eisai_groupB,2,5,ts-global_detected_seizures,21151,21196,45
Jensen_Eisai_groupB,1,4,ts-global_detected_seizures,21152,21222,70
Jensen_Eisai_groupB,2,5,ts-global_detected_seizures,21197,21266,69
Jensen_Eisai_groupB,1,4,ts-global_detected_seizures,21279,21426,147
Jensen_Eisai_groupB,2,5,ts-global_detected_seizures,21312,21378,66
Jensen_Eisai_groupB,2,5,ts-global_detected_seizures,21418,21440,22
Jensen_Eisai_groupB,1,4,ts-global_detected_seizures,21427,21626,199
Jensen_Eisai_groupB,2,5,ts-global_detected_seizures,21458,21483,25
Jensen_Eisai_groupB,2,5,ts-global_detected_seizures,21507,21530,23
Jensen_Eisai_groupB,2,5,ts-global_detected_seizures,21561,21585,24
Jensen_Eisai_groupB,1,4,ts-global_detected_seizures,21627,21654,27
Jensen_Eisai_groupB,2,5,ts-global_detected_seizures,21646,21677,31
Jensen_Eisai_groupB,1,4,ts-global_detected_seizures,21693,21748,55
Jensen_Eisai_groupB,2,5,ts-global_detected_seizures,21742,21840,98
Jensen_Eisai_groupB,1,4,ts-global_detected_seizures,21787,21836,49
Jensen_Eisai_groupB,1,4,ts-global_detected_seizures,21838,21878,40
Jensen_Eisai_groupB,2,5,ts-global_detected_seizures,21860,21886,26
Jensen_Eisai_groupB,1,4,ts-global_detected_seizures,21880,21911,31
Jensen_Eisai_groupB,2,5,ts-global_detected_seizures,21887,21982,95
Jensen_Eisai_groupB,1,4,ts-global_detected_seizures,21912,21935,23
Jensen_Eisai_groupB,1,4,ts-global_detected_seizures,21939,21977,38
Jensen_Eisai_groupB,1,4,ts-global_detected_seizures,21978,22000,22
Jensen_Eisai_groupB,2,5,ts-global_detected_seizures,22013,22043,30
Jensen_Eisai_groupB,1,4,ts-global_detected_seizures,22030,22064,34
Jensen_Eisai_groupB,3,6,ts-global_detected_seizures,22058,29993,7935
Jensen_Eisai_groupB,1,4,ts-global_detected_seizures,22068,22215,147
Jensen_Eisai_groupB,2,5,ts-global_detected_seizures,22084,22107,23
Jensen_Eisai_groupB,2,5,ts-global_detected_seizures,22154,22176,22
Jensen_Eisai_groupB,2,5,ts-global_detected_seizures,22188,22210,22
Jensen_Eisai_groupB,1,4,ts-global_detected_seizures,22217,22258,41
Jensen_Eisai_groupB,1,4,ts-global_detected_seizures,22259,22327,68
Jensen_Eisai_groupB,2,5,ts-global_detected_seizures,22267,22314,47
Jensen_Eisai_groupB,1,4,ts-global_detected_seizures,22335,22393,58
Jensen_Eisai_groupB,2,5,ts-global_detected_seizures,22338,22393,55
Jensen_Eisai_groupB,1,4,ts-global_detected_seizures,22404,22521,117
Jensen_Eisai_groupB,2,5,ts-global_detected_seizures,22418,22449,31
Jensen_Eisai_groupB,1,4,ts-global_detected_seizures,22522,22558,36
Jensen_Eisai_groupB,2,5,ts-global_detected_seizures,22526,22554,28
Jensen_Eisai_groupB,1,4,ts-global_detected_seizures,22567,22596,29
Jensen_Eisai_groupB,2,5,ts-global_detected_seizures,22595,22634,39
Jensen_Eisai_groupB,1,4,ts-global_detected_seizures,22597,22668,71
Jensen_Eisai_groupB,2,5,ts-global_detected_seizures,22702,22739,37
Jensen_Eisai_groupB,1,4,ts-global_detected_seizures,22756,22783,27
Jensen_Eisai_groupB,2,5,ts-global_detected_seizures,22786,22984,198
Jensen_Eisai_groupB,1,4,ts-global_detected_seizures,22802,22935,133
Jensen_Eisai_groupB,1,4,ts-global_detected_seizures,22945,23008,63
Jensen_Eisai_groupB,2,5,ts-global_detected_seizures,22985,23021,36
Jensen_Eisai_groupB,1,4,ts-global_detected_seizures,23021,23069,48
Jensen_Eisai_groupB,2,5,ts-global_detected_seizures,23022,23230,208
Jensen_Eisai_groupB,1,4,ts-global_detected_seizures,23084,23113,29
Jensen_Eisai_groupB,1,4,ts-global_detected_seizures,23152,23198,46
Jensen_Eisai_groupB,2,5,ts-global_detected_seizures,23231,23555,324
Jensen_Eisai_groupB,1,4,ts-global_detected_seizures,23233,23393,160
Jensen_Eisai_groupB,1,4,ts-global_detected_seizures,23452,23663,211
Jensen_Eisai_groupB,2,5,ts-global_detected_seizures,23556,23588,32
Jensen_Eisai_groupB,2,5,ts-global_detected_seizures,23670,23700,30
Jensen_Eisai_groupB,1,4,ts-global_detected_seizures,23678,23737,59
Jensen_Eisai_groupB,1,4,ts-global_detected_seizures,23742,23796,54
Jensen_Eisai_groupB,1,4,ts-global_detected_seizures,23866,23966,100
Jensen_Eisai_groupB,2,5,ts-global_detected_seizures,23874,23902,28
Jensen_Eisai_groupB,2,5,ts-global_detected_seizures,23917,23964,47
Jensen_Eisai_groupB,1,4,ts-global_detected_seizures,23967,23996,29
Jensen_Eisai_groupB,2,5,ts-global_detected_seizures,23988,24018,30
Jensen_Eisai_groupB,1,4,ts-global_detected_seizures,24035,24153,118
Jensen_Eisai_groupB,2,5,ts-global_detected_seizures,24088,24259,171
Jensen_Eisai_groupB,1,4,ts-global_detected_seizures,24172,24235,63
Jensen_Eisai_groupB,2,5,ts-global_detected_seizures,24277,24299,22
Jensen_Eisai_groupB,1,4,ts-global_detected_seizures,24284,24330,46
Jensen_Eisai_groupB,1,4,ts-global_detected_seizures,24346,24409,63
Jensen_Eisai_groupB,1,4,ts-global_detected_seizures,24425,24543,118
Jensen_Eisai_groupB,1,4,ts-global_detected_seizures,24545,24639,94
Jensen_Eisai_groupB,2,5,ts-global_detected_seizures,24559,24590,31
Jensen_Eisai_groupB,2,5,ts-global_detected_seizures,24615,24641,26
Jensen_Eisai_groupB,1,4,ts-global_detected_seizures,24643,24697,54
Jensen_Eisai_groupB,2,5,ts-global_detected_seizures,24657,24682,25
Jensen_Eisai_groupB,1,4,ts-global_detected_seizures,24715,24766,51
Jensen_Eisai_groupB,2,5,ts-global_detected_seizures,24722,24748,26
Jensen_Eisai_groupB,1,4,ts-global_detected_seizures,24808,24933,125
Jensen_Eisai_groupB,2,5,ts-global_detected_seizures,24863,24904,41
Jensen_Eisai_groupB,2,5,ts-global_detected_seizures,24926,24959,33
Jensen_Eisai_groupB,1,4,ts-global_detected_seizures,24937,24972,35
Jensen_Eisai_groupB,1,4,ts-global_detected_seizures,24988,25055,67
Jensen_Eisai_groupB,2,5,ts-global_detected_seizures,25051,25075,24
Jensen_Eisai_groupB,1,4,ts-global_detected_seizures,25074,25103,29
Jensen_Eisai_groupB,2,5,ts-global_detected_seizures,25105,25134,29
Jensen_Eisai_groupB,1,4,ts-global_detected_seizures,25141,25233,92
Jensen_Eisai_groupB,2,5,ts-global_detected_seizures,25145,25167,22
Jensen_Eisai_groupB,1,4,ts-global_detected_seizures,25250,25283,33
Jensen_Eisai_groupB,1,4,ts-global_detected_seizures,25297,25324,27
Jensen_Eisai_groupB,2,5,ts-global_detected_seizures,25312,25337,25
Jensen_Eisai_groupB,1,4,ts-global_detected_seizures,25326,25372,46
Jensen_Eisai_groupB,2,5,ts-global_detected_seizures,25383,25405,22
Jensen_Eisai_groupB,1,4,ts-global_detected_seizures,25415,25817,402
Jensen_Eisai_groupB,2,5,ts-global_detected_seizures,25479,25505,26
Jensen_Eisai_groupB,2,5,ts-global_detected_seizures,25524,25549,25
Jensen_Eisai_groupB,2,5,ts-global_detected_seizures,25712,25764,52
Jensen_Eisai_groupB,2,5,ts-global_detected_seizures,25795,25819,24
Jensen_Eisai_groupB,1,4,ts-global_detected_seizures,25818,25875,57
Jensen_Eisai_groupB,1,4,ts-global_detected_seizures,25894,25949,55
Jensen_Eisai_groupB,2,5,ts-global_detected_seizures,25906,25932,26
Jensen_Eisai_groupB,2,5,ts-global_detected_seizures,25961,25983,22
Jensen_Eisai_groupB,2,5,ts-global_detected_seizures,25984,26006,22
Jensen_Eisai_groupB,1,4,ts-global_detected_seizures,25997,26061,64
Jensen_Eisai_groupB,2,5,ts-global_detected_seizures,26008,26037,29
Jensen_Eisai_groupB,2,5,ts-global_detected_seizures,26079,26108,29
Jensen_Eisai_groupB,1,4,ts-global_detected_seizures,26103,26149,46
Jensen_Eisai_groupB,2,5,ts-global_detected_seizures,26127,26161,34
Jensen_Eisai_groupB,1,4,ts-global_detected_seizures,26150,26182,32
Jensen_Eisai_groupB,2,5,ts-global_detected_seizures,26178,26290,112
Jensen_Eisai_groupB,1,4,ts-global_detected_seizures,26217,26255,38
Jensen_Eisai_groupB,1,4,ts-global_detected_seizures,26260,26336,76
Jensen_Eisai_groupB,2,5,ts-global_detected_seizures,26294,26316,22
Jensen_Eisai_groupB,2,5,ts-global_detected_seizures,26322,26347,25
Jensen_Eisai_groupB,2,5,ts-global_detected_seizures,26350,26374,24
Jensen_Eisai_groupB,1,4,ts-global_detected_seizures,26358,26401,43
Jensen_Eisai_groupB,1,4,ts-global_detected_seizures,26402,26429,27
Jensen_Eisai_groupB,2,5,ts-global_detected_seizures,26433,26465,32
Jensen_Eisai_groupB,1,4,ts-global_detected_seizures,26451,26475,24
Jensen_Eisai_groupB,1,4,ts-global_detected_seizures,26477,26658,181
Jensen_Eisai_groupB,2,5,ts-global_detected_seizures,26556,26587,31
Jensen_Eisai_groupB,1,4,ts-global_detected_seizures,26659,29222,2563
Jensen_Eisai_groupB,2,5,ts-global_detected_seizures,26670,26770,100
Jensen_Eisai_groupB,2,5,ts-global_detected_seizures,26776,26802,26
Jensen_Eisai_groupB,2,5,ts-global_detected_seizures,26813,26839,26
Jensen_Eisai_groupB,2,5,ts-global_detected_seizures,26840,28062,1222
Jensen_Eisai_groupB,2,5,ts-global_detected_seizures,28314,28336,22
Jensen_Eisai_groupB,2,5,ts-global_detected_seizures,28428,28453,25
Jensen_Eisai_groupB,2,5,ts-global_detected_seizures,28594,28616,22
Jensen_Eisai_groupB,2,5,ts-global_detected_seizures,28618,28677,59
Jensen_Eisai_groupB,2,5,ts-global_detected_seizures,28715,28768,53
Jensen_Eisai_groupB,2,5,ts-global_detected_seizures,28781,28810,29
Jensen_Eisai_groupB,2,5,ts-global_detected_seizures,29051,29107,56
Jensen_Eisai_groupB,2,5,ts-global_detected_seizures,29116,29141,25
Jensen_Eisai_groupB,2,5,ts-global_detected_seizures,29183,29217,34
Jensen_Eisai_groupB,1,4,ts-global_detected_seizures,29223,29259,36
Jensen_Eisai_groupB,2,5,ts-global_detected_seizures,29262,29285,23
Jensen_Eisai_groupB,1,4,ts-global_detected_seizures,29264,29365,101
Jensen_Eisai_groupB,2,5,ts-global_detected_seizures,29286,29382,96
Jensen_Eisai_groupB,1,4,ts-global_detected_seizures,29368,29396,28
Jensen_Eisai_groupB,2,5,ts-global_detected_seizures,29410,29435,25
Jensen_Eisai_groupB,1,4,ts-global_detected_seizures,29421,29447,26
Jensen_Eisai_groupB,2,5,ts-global_detected_seizures,29446,29474,28
Jensen_Eisai_groupB,1,4,ts-global_detected_seizures,29497,29572,75
Jensen_Eisai_groupB,2,5,ts-global_detected_seizures,29602,29640,38
Jensen_Eisai_groupB,1,4,ts-global_detected_seizures,29624,29668,44
Jensen_Eisai_groupB,2,5,ts-global_detected_seizures,29670,29711,41
Jensen_Eisai_groupB,1,4,ts-global_detected_seizures,29682,29733,51
Jensen_Eisai_groupB,1,4,ts-global_detected_seizures,29754,29786,32
Jensen_Eisai_groupB,2,5,ts-global_detected_seizures,29760,29792,32
Jensen_Eisai_groupB,1,4,ts-global_detected_seizures,29835,29874,39
Jensen_Eisai_groupB,2,5,ts-global_detected_seizures,29852,29882,30
Jensen_Eisai_groupB,1,4,ts-global_detected_seizures,29904,30005,101
Jensen_Eisai_groupB,2,5,ts-global_detected_seizures,29913,29937,24
Jensen_Eisai_groupB,2,5,ts-global_detected_seizures,29966,29998,32
Jensen_Eisai_groupB,3,6,ts-global_detected_seizures,29994,32922,2928
Jensen_Eisai_groupB,2,5,ts-global_detected_seizures,29999,30043,44
Jensen_Eisai_groupB,1,4,ts-global_detected_seizures,30016,30095,79
Jensen_Eisai_groupB,2,5,ts-global_detected_seizures,30045,30089,44
Jensen_Eisai_groupB,2,5,ts-global_detected_seizures,30107,30129,22
Jensen_Eisai_groupB,1,4,ts-global_detected_seizures,30125,30223,98
Jensen_Eisai_groupB,1,4,ts-global_detected_seizures,30224,30254,30
Jensen_Eisai_groupB,2,5,ts-global_detected_seizures,30240,30285,45
Jensen_Eisai_groupB,1,4,ts-global_detected_seizures,30288,30312,24
Jensen_Eisai_groupB,2,5,ts-global_detected_seizures,30314,30343,29
Jensen_Eisai_groupB,1,4,ts-global_detected_seizures,30350,30379,29
Jensen_Eisai_groupB,2,5,ts-global_detected_seizures,30355,30386,31
Jensen_Eisai_groupB,2,5,ts-global_detected_seizures,30432,30474,42
Jensen_Eisai_groupB,1,4,ts-global_detected_seizures,30452,30523,71
Jensen_Eisai_groupB,1,4,ts-global_detected_seizures,30568,30655,87
Jensen_Eisai_groupB,2,5,ts-global_detected_seizures,30695,30719,24
Jensen_Eisai_groupB,1,4,ts-global_detected_seizures,30720,30777,57
Jensen_Eisai_groupB,2,5,ts-global_detected_seizures,30749,30790,41
Jensen_Eisai_groupB,1,4,ts-global_detected_seizures,30779,30836,57
Jensen_Eisai_groupB,2,5,ts-global_detected_seizures,30832,30857,25
Jensen_Eisai_groupB,1,4,ts-global_detected_seizures,30858,30961,103
Jensen_Eisai_groupB,2,5,ts-global_detected_seizures,30920,30957,37
Jensen_Eisai_groupB,1,4,ts-global_detected_seizures,30992,31039,47
Jensen_Eisai_groupB,1,4,ts-global_detected_seizures,31054,31109,55
Jensen_Eisai_groupB,2,5,ts-global_detected_seizures,31074,31264,190
Jensen_Eisai_groupB,1,4,ts-global_detected_seizures,31128,31213,85
Jensen_Eisai_groupB,1,4,ts-global_detected_seizures,31215,31244,29
Jensen_Eisai_groupB,1,4,ts-global_detected_seizures,31245,31284,39
Jensen_Eisai_groupB,2,5,ts-global_detected_seizures,31314,31340,26
Jensen_Eisai_groupB,1,4,ts-global_detected_seizures,31317,31404,87
Jensen_Eisai_groupB,2,5,ts-global_detected_seizures,31413,31468,55
Jensen_Eisai_groupB,1,4,ts-global_detected_seizures,31416,31500,84
Jensen_Eisai_groupB,1,4,ts-global_detected_seizures,31508,31568,60
Jensen_Eisai_groupB,2,5,ts-global_detected_seizures,31528,31691,163
Jensen_Eisai_groupB,1,4,ts-global_detected_seizures,31602,31628,26
Jensen_Eisai_groupB,1,4,ts-global_detected_seizures,31652,31798,146
Jensen_Eisai_groupB,2,5,ts-global_detected_seizures,31700,31736,36
Jensen_Eisai_groupB,2,5,ts-global_detected_seizures,31790,31818,28
Jensen_Eisai_groupB,1,4,ts-global_detected_seizures,31805,31918,113
Jensen_Eisai_groupB,2,5,ts-global_detected_seizures,31843,31865,22
Jensen_Eisai_groupB,2,5,ts-global_detected_seizures,31883,31907,24
Jensen_Eisai_groupB,1,4,ts-global_detected_seizures,31919,32044,125
Jensen_Eisai_groupB,2,5,ts-global_detected_seizures,32007,32040,33
Jensen_Eisai_groupB,1,4,ts-global_detected_seizures,32045,32073,28
Jensen_Eisai_groupB,1,4,ts-global_detected_seizures,32074,32244,170
Jensen_Eisai_groupB,2,5,ts-global_detected_seizures,32099,32121,22
Jensen_Eisai_groupB,2,5,ts-global_detected_seizures,32154,32968,814
Jensen_Eisai_groupB,1,4,ts-global_detected_seizures,32263,32485,222
Jensen_Eisai_groupB,1,4,ts-global_detected_seizures,32491,32590,99
Jensen_Eisai_groupB,1,4,ts-global_detected_seizures,32628,32664,36
Jensen_Eisai_groupB,1,4,ts-global_detected_seizures,32675,32714,39
Jensen_Eisai_groupB,1,4,ts-global_detected_seizures,32784,32810,26
Jensen_Eisai_groupB,1,4,ts-global_detected_seizures,32811,32931,120
Jensen_Eisai_groupB,3,6,ts-global_detected_seizures,32923,39019,6096
Jensen_Eisai_groupB,1,4,ts-global_detected_seizures,32951,32997,46
Jensen_Eisai_groupB,1,4,ts-global_detected_seizures,32998,33043,45
Jensen_Eisai_groupB,1,4,ts-global_detected_seizures,33049,33134,85
Jensen_Eisai_groupB,2,5,ts-global_detected_seizures,33085,33107,22
Jensen_Eisai_groupB,2,5,ts-global_detected_seizures,33128,33152,24
Jensen_Eisai_groupB,1,4,ts-global_detected_seizures,33149,33198,49
Jensen_Eisai_groupB,1,4,ts-global_detected_seizures,33215,33321,106
Jensen_Eisai_groupB,2,5,ts-global_detected_seizures,33316,33344,28
Jensen_Eisai_groupB,1,4,ts-global_detected_seizures,33333,33369,36
Jensen_Eisai_groupB,1,4,ts-global_detected_seizures,33381,33491,110
Jensen_Eisai_groupB,2,5,ts-global_detected_seizures,33388,33417,29
Jensen_Eisai_groupB,1,4,ts-global_detected_seizures,33492,33593,101
Jensen_Eisai_groupB,1,4,ts-global_detected_seizures,33612,33634,22
Jensen_Eisai_groupB,2,5,ts-global_detected_seizures,33655,33710,55
Jensen_Eisai_groupB,1,4,ts-global_detected_seizures,33678,33744,66
Jensen_Eisai_groupB,1,4,ts-global_detected_seizures,33766,33803,37
Jensen_Eisai_groupB,2,5,ts-global_detected_seizures,33803,33826,23
Jensen_Eisai_groupB,1,4,ts-global_detected_seizures,33805,33838,33
Jensen_Eisai_groupB,1,4,ts-global_detected_seizures,33839,33947,108
Jensen_Eisai_groupB,1,4,ts-global_detected_seizures,33949,34000,51
Jensen_Eisai_groupB,1,4,ts-global_detected_seizures,34019,34062,43
Jensen_Eisai_groupB,1,4,ts-global_detected_seizures,34074,34104,30
Jensen_Eisai_groupB,2,5,ts-global_detected_seizures,34086,34149,63
Jensen_Eisai_groupB,1,4,ts-global_detected_seizures,34136,34162,26
Jensen_Eisai_groupB,1,4,ts-global_detected_seizures,34185,34224,39
Jensen_Eisai_groupB,1,4,ts-global_detected_seizures,34229,34524,295
Jensen_Eisai_groupB,2,5,ts-global_detected_seizures,34305,34329,24
Jensen_Eisai_groupB,2,5,ts-global_detected_seizures,34411,34456,45
Jensen_Eisai_groupB,2,5,ts-global_detected_seizures,34493,34519,26
Jensen_Eisai_groupB,2,5,ts-global_detected_seizures,34521,34549,28
Jensen_Eisai_groupB,1,4,ts-global_detected_seizures,34525,34680,155
Jensen_Eisai_groupB,2,5,ts-global_detected_seizures,34578,34730,152
Jensen_Eisai_groupB,1,4,ts-global_detected_seizures,34691,34751,60
Jensen_Eisai_groupB,1,4,ts-global_detected_seizures,34772,34850,78
Jensen_Eisai_groupB,2,5,ts-global_detected_seizures,34794,34825,31
Jensen_Eisai_groupB,2,5,ts-global_detected_seizures,34853,34887,34
Jensen_Eisai_groupB,1,4,ts-global_detected_seizures,34900,34944,44
Jensen_Eisai_groupB,2,5,ts-global_detected_seizures,34901,35996,1095
Jensen_Eisai_groupB,1,4,ts-global_detected_seizures,34963,35002,39
Jensen_Eisai_groupB,1,4,ts-global_detected_seizures,35046,35095,49
Jensen_Eisai_groupB,1,4,ts-global_detected_seizures,35134,35192,58
Jensen_Eisai_groupB,1,4,ts-global_detected_seizures,35204,35229,25
Jensen_Eisai_groupB,1,4,ts-global_detected_seizures,35235,35291,56
Jensen_Eisai_groupB,1,4,ts-global_detected_seizures,35314,35539,225
Jensen_Eisai_groupB,1,4,ts-global_detected_seizures,35540,35607,67
Jensen_Eisai_groupB,1,4,ts-global_detected_seizures,35675,35697,22
Jensen_Eisai_groupB,1,4,ts-global_detected_seizures,35756,35873,117
Jensen_Eisai_groupB,1,4,ts-global_detected_seizures,35874,35962,88
Jensen_Eisai_groupB,1,4,ts-global_detected_seizures,35971,36012,41
Jensen_Eisai_groupB,1,4,ts-global_detected_seizures,36016,36131,115
Jensen_Eisai_groupB,2,5,ts-global_detected_seizures,36054,36088,34
Jensen_Eisai_groupB,2,5,ts-global_detected_seizures,36106,36132,26
Jensen_Eisai_groupB,1,4,ts-global_detected_seizures,36132,37329,1197
Jensen_Eisai_groupB,2,5,ts-global_detected_seizures,36189,36221,32
Jensen_Eisai_groupB,2,5,ts-global_detected_seizures,36273,36306,33
Jensen_Eisai_groupB,2,5,ts-global_detected_seizures,36455,36486,31
Jensen_Eisai_groupB,2,5,ts-global_detected_seizures,36535,36564,29
Jensen_Eisai_groupB,2,5,ts-global_detected_seizures,36890,36918,28
Jensen_Eisai_groupB,2,5,ts-global_detected_seizures,37014,37037,23
Jensen_Eisai_groupB,2,5,ts-global_detected_seizures,37118,37184,66
Jensen_Eisai_groupB,2,5,ts-global_detected_seizures,37199,37223,24
Jensen_Eisai_groupB,2,5,ts-global_detected_seizures,37241,37268,27
Jensen_Eisai_groupB,2,5,ts-global_detected_seizures,37291,37313,22
Jensen_Eisai_groupB,1,4,ts-global_detected_seizures,37343,37384,41
Jensen_Eisai_groupB,2,5,ts-global_detected_seizures,37351,37373,22
Jensen_Eisai_groupB,1,4,ts-global_detected_seizures,37389,37463,74
Jensen_Eisai_groupB,2,5,ts-global_detected_seizures,37412,37435,23
Jensen_Eisai_groupB,2,5,ts-global_detected_seizures,37489,37517,28
Jensen_Eisai_groupB,1,4,ts-global_detected_seizures,37502,37525,23
Jensen_Eisai_groupB,1,4,ts-global_detected_seizures,37538,37566,28
Jensen_Eisai_groupB,1,4,ts-global_detected_seizures,37567,37602,35
Jensen_Eisai_groupB,1,4,ts-global_detected_seizures,37635,37694,59
Jensen_Eisai_groupB,2,5,ts-global_detected_seizures,37651,37678,27
Jensen_Eisai_groupB,1,4,ts-global_detected_seizures,37730,38675,945
Jensen_Eisai_groupB,2,5,ts-global_detected_seizures,37739,37783,44
Jensen_Eisai_groupB,2,5,ts-global_detected_seizures,37784,37842,58
Jensen_Eisai_groupB,2,5,ts-global_detected_seizures,37854,37879,25
Jensen_Eisai_groupB,2,5,ts-global_detected_seizures,37880,37906,26
Jensen_Eisai_groupB,2,5,ts-global_detected_seizures,37942,37967,25
Jensen_Eisai_groupB,2,5,ts-global_detected_seizures,38003,38030,27
Jensen_Eisai_groupB,2,5,ts-global_detected_seizures,38048,38088,40
Jensen_Eisai_groupB,2,5,ts-global_detected_seizures,38108,38153,45
Jensen_Eisai_groupB,2,5,ts-global_detected_seizures,38171,38213,42
Jensen_Eisai_groupB,2,5,ts-global_detected_seizures,38221,38757,536
Jensen_Eisai_groupB,1,4,ts-global_detected_seizures,38726,38756,30
Jensen_Eisai_groupB,2,5,ts-global_detected_seizures,38758,38799,41
Jensen_Eisai_groupB,1,4,ts-global_detected_seizures,38769,38833,64
Jensen_Eisai_groupB,2,5,ts-global_detected_seizures,38800,38878,78
Jensen_Eisai_groupB,1,4,ts-global_detected_seizures,38872,38901,29
Jensen_Eisai_groupB,1,4,ts-global_detected_seizures,38902,39114,212
Jensen_Eisai_groupB,2,5,ts-global_detected_seizures,38906,38941,35
Jensen_Eisai_groupB,2,5,ts-global_detected_seizures,38968,38990,22
Jensen_Eisai_groupB,2,5,ts-global_detected_seizures,39041,39068,27
Jensen_Eisai_groupB,3,6,ts-global_detected_seizures,39068,41754,2686
Jensen_Eisai_groupB,2,5,ts-global_detected_seizures,39088,39113,25
Jensen_Eisai_groupB,1,4,ts-global_detected_seizures,39133,39156,23
Jensen_Eisai_groupB,2,5,ts-global_detected_seizures,39217,39243,26
Jensen_Eisai_groupB,1,4,ts-global_detected_seizures,39220,39280,60
Jensen_Eisai_groupB,2,5,ts-global_detected_seizures,39278,39318,40
Jensen_Eisai_groupB,1,4,ts-global_detected_seizures,39296,39323,27
Jensen_Eisai_groupB,2,5,ts-global_detected_seizures,39356,39385,29
Jensen_Eisai_groupB,1,4,ts-global_detected_seizures,39357,39385,28
Jensen_Eisai_groupB,1,4,ts-global_detected_seizures,39401,39445,44
Jensen_Eisai_groupB,2,5,ts-global_detected_seizures,39468,39503,35
Jensen_Eisai_groupB,1,4,ts-global_detected_seizures,39548,39590,42
Jensen_Eisai_groupB,2,5,ts-global_detected_seizures,39584,39624,40
Jensen_Eisai_groupB,1,4,ts-global_detected_seizures,39638,39699,61
Jensen_Eisai_groupB,1,4,ts-global_detected_seizures,39703,39727,24
Jensen_Eisai_groupB,1,4,ts-global_detected_seizures,39741,39777,36
Jensen_Eisai_groupB,2,5,ts-global_detected_seizures,39780,39830,50
Jensen_Eisai_groupB,1,4,ts-global_detected_seizures,39829,39878,49
Jensen_Eisai_groupB,2,5,ts-global_detected_seizures,39856,39962,106
Jensen_Eisai_groupB,1,4,ts-global_detected_seizures,39931,39975,44
Jensen_Eisai_groupB,2,5,ts-global_detected_seizures,39972,39996,24
Jensen_Eisai_groupB,1,4,ts-global_detected_seizures,39983,40014,31
Jensen_Eisai_groupB,1,4,ts-global_detected_seizures,40059,40174,115
Jensen_Eisai_groupB,2,5,ts-global_detected_seizures,40136,40161,25
Jensen_Eisai_groupB,1,4,ts-global_detected_seizures,40180,40279,99
Jensen_Eisai_groupB,1,4,ts-global_detected_seizures,40292,40332,40
Jensen_Eisai_groupB,1,4,ts-global_detected_seizures,40333,40403,70
Jensen_Eisai_groupB,1,4,ts-global_detected_seizures,40416,40502,86
Jensen_Eisai_groupB,1,4,ts-global_detected_seizures,40504,40769,265
Jensen_Eisai_groupB,2,5,ts-global_detected_seizures,40730,40754,24
Jensen_Eisai_groupB,1,4,ts-global_detected_seizures,40770,40865,95
Jensen_Eisai_groupB,1,4,ts-global_detected_seizures,40869,40893,24
Jensen_Eisai_groupB,2,5,ts-global_detected_seizures,40871,40895,24
Jensen_Eisai_groupB,1,4,ts-global_detected_seizures,40904,40954,50
Jensen_Eisai_groupB,2,5,ts-global_detected_seizures,40915,40948,33
Jensen_Eisai_groupB,2,5,ts-global_detected_seizures,40959,40985,26
Jensen_Eisai_groupB,1,4,ts-global_detected_seizures,40966,41052,86
Jensen_Eisai_groupB,2,5,ts-global_detected_seizures,40986,41544,558
Jensen_Eisai_groupB,1,4,ts-global_detected_seizures,41053,41084,31
Jensen_Eisai_groupB,1,4,ts-global_detected_seizures,41085,41108,23
Jensen_Eisai_groupB,1,4,ts-global_detected_seizures,41116,41178,62
Jensen_Eisai_groupB,1,4,ts-global_detected_seizures,41232,41257,25
Jensen_Eisai_groupB,1,4,ts-global_detected_seizures,41259,41301,42
Jensen_Eisai_groupB,1,4,ts-global_detected_seizures,41314,41384,70
Jensen_Eisai_groupB,1,4,ts-global_detected_seizures,41385,41417,32
Jensen_Eisai_groupB,1,4,ts-global_detected_seizures,41484,41519,35
Jensen_Eisai_groupB,2,5,ts-global_detected_seizures,41555,41802,247
Jensen_Eisai_groupB,1,4,ts-global_detected_seizures,41590,41637,47
Jensen_Eisai_groupB,1,4,ts-global_detected_seizures,41646,41681,35
Jensen_Eisai_groupB,1,4,ts-global_detected_seizures,41691,41726,35
Jensen_Eisai_groupB,1,4,ts-global_detected_seizures,41727,41817,90
Jensen_Eisai_groupB,3,6,ts-global_detected_seizures,41771,42457,686
Jensen_Eisai_groupB,2,5,ts-global_detected_seizures,41803,41901,98
Jensen_Eisai_groupB,1,4,ts-global_detected_seizures,41840,43979,2139
Jensen_Eisai_groupB,2,5,ts-global_detected_seizures,41907,43081,1174
Jensen_Eisai_groupB,3,6,ts-global_detected_seizures,42458,44858,2400
Jensen_Eisai_groupB,2,5,ts-global_detected_seizures,43082,43119,37
Jensen_Eisai_groupB,2,5,ts-global_detected_seizures,43208,43230,22
Jensen_Eisai_groupB,2,5,ts-global_detected_seizures,43582,43606,24
Jensen_Eisai_groupB,2,5,ts-global_detected_seizures,43645,43670,25
Jensen_Eisai_groupB,2,5,ts-global_detected_seizures,43924,44293,369
Jensen_Eisai_groupB,1,4,ts-global_detected_seizures,43980,45221,1241
Jensen_Eisai_groupB,2,5,ts-global_detected_seizures,44305,44388,83
Jensen_Eisai_groupB,2,5,ts-global_detected_seizures,44392,44883,491
Jensen_Eisai_groupB,3,6,ts-global_detected_seizures,44859,44960,101
Jensen_Eisai_groupB,3,6,ts-global_detected_seizures,44961,51309,6348
Jensen_Eisai_groupB,2,5,ts-global_detected_seizures,45158,45182,24
Jensen_Eisai_groupB,1,4,ts-global_detected_seizures,45222,46378,1156
Jensen_Eisai_groupB,2,5,ts-global_detected_seizures,45399,45422,23
Jensen_Eisai_groupB,2,5,ts-global_detected_seizures,45438,45463,25
Jensen_Eisai_groupB,2,5,ts-global_detected_seizures,45502,45964,462
Jensen_Eisai_groupB,2,5,ts-global_detected_seizures,46008,46031,23
Jensen_Eisai_groupB,2,5,ts-global_detected_seizures,46148,46173,25
Jensen_Eisai_groupB,2,5,ts-global_detected_seizures,46262,46290,28
Jensen_Eisai_groupB,2,5,ts-global_detected_seizures,46333,46709,376
Jensen_Eisai_groupB,1,4,ts-global_detected_seizures,46380,48054,1674
Jensen_Eisai_groupB,2,5,ts-global_detected_seizures,46778,46803,25
Jensen_Eisai_groupB,2,5,ts-global_detected_seizures,46897,46924,27
Jensen_Eisai_groupB,2,5,ts-global_detected_seizures,46975,47002,27
Jensen_Eisai_groupB,2,5,ts-global_detected_seizures,47143,47165,22
Jensen_Eisai_groupB,2,5,ts-global_detected_seizures,47232,47274,42
Jensen_Eisai_groupB,2,5,ts-global_detected_seizures,47324,47657,333
Jensen_Eisai_groupB,2,5,ts-global_detected_seizures,47658,47980,322
Jensen_Eisai_groupB,1,4,ts-global_detected_seizures,48055,53377,5322
Jensen_Eisai_groupB,2,5,ts-global_detected_seizures,48242,48681,439
Jensen_Eisai_groupB,2,5,ts-global_detected_seizures,48883,48905,22
Jensen_Eisai_groupB,2,5,ts-global_detected_seizures,48914,48936,22
Jensen_Eisai_groupB,2,5,ts-global_detected_seizures,48948,48970,22
Jensen_Eisai_groupB,2,5,ts-global_detected_seizures,48973,49229,256
Jensen_Eisai_groupB,2,5,ts-global_detected_seizures,49424,49455,31
Jensen_Eisai_groupB,2,5,ts-global_detected_seizures,49508,49889,381
Jensen_Eisai_groupB,2,5,ts-global_detected_seizures,49923,49946,23
Jensen_Eisai_groupB,2,5,ts-global_detected_seizures,50103,50130,27
Jensen_Eisai_groupB,2,5,ts-global_detected_seizures,50202,50230,28
Jensen_Eisai_groupB,2,5,ts-global_detected_seizures,50377,50401,24
Jensen_Eisai_groupB,2,5,ts-global_detected_seizures,50415,50441,26
Jensen_Eisai_groupB,2,5,ts-global_detected_seizures,50472,50657,185
Jensen_Eisai_groupB,2,5,ts-global_detected_seizures,50680,50961,281
Jensen_Eisai_groupB,2,5,ts-global_detected_seizures,51141,51165,24
Jensen_Eisai_groupB,2,5,ts-global_detected_seizures,51200,51590,390
Jensen_Eisai_groupB,3,6,ts-global_detected_seizures,51310,51497,187
Jensen_Eisai_groupB,3,6,ts-global_detected_seizures,51498,53378,1880
Jensen_Eisai_groupB,2,5,ts-global_detected_seizures,51591,51712,121
Jensen_Eisai_groupB,2,5,ts-global_detected_seizures,51801,51823,22
Jensen_Eisai_groupB,2,5,ts-global_detected_seizures,52029,52274,245
Jensen_Eisai_groupB,2,5,ts-global_detected_seizures,52294,52318,24
Jensen_Eisai_groupB,2,5,ts-global_detected_seizures,52338,52361,23
Jensen_Eisai_groupB,2,5,ts-global_detected_seizures,52368,52391,23
Jensen_Eisai_groupB,2,5,ts-global_detected_seizures,52515,52538,23
Jensen_Eisai_groupB,2,5,ts-global_detected_seizures,52564,53418,854
Jensen_Eisai_groupB,1,4,ts-global_detected_seizures,53378,54738,1360
Jensen_Eisai_groupB,3,6,ts-global_detected_seizures,53379,55395,2016
Jensen_Eisai_groupB,2,5,ts-global_detected_seizures,53419,53454,35
Jensen_Eisai_groupB,2,5,ts-global_detected_seizures,53463,53500,37
Jensen_Eisai_groupB,2,5,ts-global_detected_seizures,53555,53577,22
Jensen_Eisai_groupB,2,5,ts-global_detected_seizures,53597,53622,25
Jensen_Eisai_groupB,2,5,ts-global_detected_seizures,53764,53790,26
Jensen_Eisai_groupB,2,5,ts-global_detected_seizures,53974,53998,24
Jensen_Eisai_groupB,2,5,ts-global_detected_seizures,54121,54233,112
Jensen_Eisai_groupB,2,5,ts-global_detected_seizures,54284,54306,22
Jensen_Eisai_groupB,2,5,ts-global_detected_seizures,54351,55768,1417
Jensen_Eisai_groupB,1,4,ts-global_detected_seizures,54751,54791,40
Jensen_Eisai_groupB,1,4,ts-global_detected_seizures,54801,55348,547
Jensen_Eisai_groupB,1,4,ts-global_detected_seizures,55349,56485,1136
Jensen_Eisai_groupB,3,6,ts-global_detected_seizures,55396,61265,5869
Jensen_Eisai_groupB,2,5,ts-global_detected_seizures,55772,55803,31
Jensen_Eisai_groupB,2,5,ts-global_detected_seizures,55860,55882,22
Jensen_Eisai_groupB,2,5,ts-global_detected_seizures,55965,55989,24
Jensen_Eisai_groupB,2,5,ts-global_detected_seizures,56051,56075,24
Jensen_Eisai_groupB,2,5,ts-global_detected_seizures,56154,56188,34
Jensen_Eisai_groupB,2,5,ts-global_detected_seizures,56226,56249,23
Jensen_Eisai_groupB,2,5,ts-global_detected_seizures,56354,56435,81
Jensen_Eisai_groupB,2,5,ts-global_detected_seizures,56467,56499,32
Jensen_Eisai_groupB,1,4,ts-global_detected_seizures,56486,57462,976
Jensen_Eisai_groupB,2,5,ts-global_detected_seizures,56546,56569,23
Jensen_Eisai_groupB,2,5,ts-global_detected_seizures,56650,56672,22
Jensen_Eisai_groupB,2,5,ts-global_detected_seizures,56742,56767,25
Jensen_Eisai_groupB,2,5,ts-global_detected_seizures,56816,57088,272
Jensen_Eisai_groupB,2,5,ts-global_detected_seizures,57348,57798,450
Jensen_Eisai_groupB,1,4,ts-global_detected_seizures,57463,59081,1618
Jensen_Eisai_groupB,2,5,ts-global_detected_seizures,57799,57897,98
Jensen_Eisai_groupB,2,5,ts-global_detected_seizures,57898,57930,32
Jensen_Eisai_groupB,2,5,ts-global_detected_seizures,57982,58023,41
Jensen_Eisai_groupB,2,5,ts-global_detected_seizures,58043,58065,22
Jensen_Eisai_groupB,2,5,ts-global_detected_seizures,58309,58343,34
Jensen_Eisai_groupB,2,5,ts-global_detected_seizures,58344,58376,32
Jensen_Eisai_groupB,2,5,ts-global_detected_seizures,58392,58420,28
Jensen_Eisai_groupB,2,5,ts-global_detected_seizures,58533,58560,27
Jensen_Eisai_groupB,2,5,ts-global_detected_seizures,58573,59108,535
Jensen_Eisai_groupB,1,4,ts-global_detected_seizures,59082,59193,111
Jensen_Eisai_groupB,2,5,ts-global_detected_seizures,59109,59856,747
Jensen_Eisai_groupB,1,4,ts-global_detected_seizures,59263,59319,56
Jensen_Eisai_groupB,1,4,ts-global_detected_seizures,59328,59493,165
Jensen_Eisai_groupB,1,4,ts-global_detected_seizures,59494,59525,31
Jensen_Eisai_groupB,1,4,ts-global_detected_seizures,59527,59570,43
Jensen_Eisai_groupB,1,4,ts-global_detected_seizures,59645,59693,48
Jensen_Eisai_groupB,1,4,ts-global_detected_seizures,59694,59958,264
Jensen_Eisai_groupB,2,5,ts-global_detected_seizures,59893,60093,200
Jensen_Eisai_groupB,1,4,ts-global_detected_seizures,59960,60267,307
Jensen_Eisai_groupB,2,5,ts-global_detected_seizures,60094,60354,260
Jensen_Eisai_groupB,1,4,ts-global_detected_seizures,60268,60731,463
Jensen_Eisai_groupB,2,5,ts-global_detected_seizures,60430,60456,26
Jensen_Eisai_groupB,2,5,ts-global_detected_seizures,60609,60652,43
Jensen_Eisai_groupB,2,5,ts-global_detected_seizures,60714,60739,25
Jensen_Eisai_groupB,1,4,ts-global_detected_seizures,60732,65071,4339
Jensen_Eisai_groupB,2,5,ts-global_detected_seizures,60758,60800,42
Jensen_Eisai_groupB,2,5,ts-global_detected_seizures,60854,60880,26
Jensen_Eisai_groupB,2,5,ts-global_detected_seizures,60900,60936,36
Jensen_Eisai_groupB,2,5,ts-global_detected_seizures,60959,60981,22
Jensen_Eisai_groupB,2,5,ts-global_detected_seizures,60989,61865,876
Jensen_Eisai_groupB,3,6,ts-global_detected_seizures,61287,61378,91
Jensen_Eisai_groupB,3,6,ts-global_detected_seizures,61379,61446,67
Jensen_Eisai_groupB,3,6,ts-global_detected_seizures,61465,61707,242
Jensen_Eisai_groupB,3,6,ts-global_detected_seizures,61708,63138,1430
Jensen_Eisai_groupB,2,5,ts-global_detected_seizures,61896,61954,58
Jensen_Eisai_groupB,2,5,ts-global_detected_seizures,61960,62200,240
Jensen_Eisai_groupB,2,5,ts-global_detected_seizures,62232,62261,29
Jensen_Eisai_groupB,2,5,ts-global_detected_seizures,62285,62308,23
Jensen_Eisai_groupB,2,5,ts-global_detected_seizures,62404,62427,23
Jensen_Eisai_groupB,2,5,ts-global_detected_seizures,62474,62498,24
Jensen_Eisai_groupB,2,5,ts-global_detected_seizures,62520,62543,23
Jensen_Eisai_groupB,2,5,ts-global_detected_seizures,62642,62666,24
Jensen_Eisai_groupB,2,5,ts-global_detected_seizures,62706,62750,44
Jensen_Eisai_groupB,2,5,ts-global_detected_seizures,62806,62847,41
Jensen_Eisai_groupB,2,5,ts-global_detected_seizures,62984,63498,514
Jensen_Eisai_groupB,3,6,ts-global_detected_seizures,63139,65209,2070
Jensen_Eisai_groupB,2,5,ts-global_detected_seizures,63543,64302,759
Jensen_Eisai_groupB,2,5,ts-global_detected_seizures,64378,64415,37
Jensen_Eisai_groupB,2,5,ts-global_detected_seizures,64542,64572,30
Jensen_Eisai_groupB,2,5,ts-global_detected_seizures,64683,64718,35
Jensen_Eisai_groupB,2,5,ts-global_detected_seizures,64720,64743,23
Jensen_Eisai_groupB,2,5,ts-global_detected_seizures,64776,64805,29
Jensen_Eisai_groupB,2,5,ts-global_detected_seizures,64834,64856,22
Jensen_Eisai_groupB,2,5,ts-global_detected_seizures,64895,64917,22
Jensen_Eisai_groupB,2,5,ts-global_detected_seizures,64958,65137,179
Jensen_Eisai_groupB,1,4,ts-global_detected_seizures,65073,65105,32
Jensen_Eisai_groupB,2,5,ts-global_detected_seizures,65138,65601,463
Jensen_Eisai_groupB,1,4,ts-global_detected_seizures,65208,65507,299
Jensen_Eisai_groupB,3,6,ts-global_detected_seizures,65210,68009,2799
Jensen_Eisai_groupB,1,4,ts-global_detected_seizures,65528,65586,58
Jensen_Eisai_groupB,2,5,ts-global_detected_seizures,65602,66654,1052
Jensen_Eisai_groupB,1,4,ts-global_detected_seizures,66071,66243,172
Jensen_Eisai_groupB,2,5,ts-global_detected_seizures,66677,68554,1877
Jensen_Eisai_groupB,1,4,ts-global_detected_seizures,66782,66870,88
Jensen_Eisai_groupB,1,4,ts-global_detected_seizures,66872,66895,23
Jensen_Eisai_groupB,1,4,ts-global_detected_seizures,67097,67136,39
Jensen_Eisai_groupB,1,4,ts-global_detected_seizures,67244,67271,27
Jensen_Eisai_groupB,1,4,ts-global_detected_seizures,67312,67369,57
Jensen_Eisai_groupB,1,4,ts-global_detected_seizures,67404,67432,28
Jensen_Eisai_groupB,1,4,ts-global_detected_seizures,67536,67562,26
Jensen_Eisai_groupB,1,4,ts-global_detected_seizures,67563,67650,87
Jensen_Eisai_groupB,1,4,ts-global_detected_seizures,67660,67683,23
Jensen_Eisai_groupB,1,4,ts-global_detected_seizures,67702,67726,24
Jensen_Eisai_groupB,1,4,ts-global_detected_seizures,67779,67830,51
Jensen_Eisai_groupB,1,4,ts-global_detected_seizures,67926,67965,39
Jensen_Eisai_groupB,3,6,ts-global_detected_seizures,68010,72651,4641
Jensen_Eisai_groupB,1,4,ts-global_detected_seizures,68065,68097,32
Jensen_Eisai_groupB,1,4,ts-global_detected_seizures,68146,68168,22
Jensen_Eisai_groupB,1,4,ts-global_detected_seizures,68261,68299,38
Jensen_Eisai_groupB,1,4,ts-global_detected_seizures,68371,68505,134
Jensen_Eisai_groupB,1,4,ts-global_detected_seizures,68506,68559,53
Jensen_Eisai_groupB,1,4,ts-global_detected_seizures,68569,68634,65
Jensen_Eisai_groupB,2,5,ts-global_detected_seizures,68607,68634,27
Jensen_Eisai_groupB,1,4,ts-global_detected_seizures,68675,68708,33
Jensen_Eisai_groupB,1,4,ts-global_detected_seizures,68721,68766,45
Jensen_Eisai_groupB,1,4,ts-global_detected_seizures,68786,68830,44
Jensen_Eisai_groupB,1,4,ts-global_detected_seizures,68832,68856,24
Jensen_Eisai_groupB,2,5,ts-global_detected_seizures,68899,68921,22
Jensen_Eisai_groupB,2,5,ts-global_detected_seizures,68940,68972,32
Jensen_Eisai_groupB,1,4,ts-global_detected_seizures,68960,68982,22
Jensen_Eisai_groupB,2,5,ts-global_detected_seizures,68993,69046,53
Jensen_Eisai_groupB,1,4,ts-global_detected_seizures,69032,69084,52
Jensen_Eisai_groupB,2,5,ts-global_detected_seizures,69078,69493,415
Jensen_Eisai_groupB,1,4,ts-global_detected_seizures,69188,69212,24
Jensen_Eisai_groupB,1,4,ts-global_detected_seizures,69221,69269,48
Jensen_Eisai_groupB,1,4,ts-global_detected_seizures,69270,69308,38
Jensen_Eisai_groupB,1,4,ts-global_detected_seizures,69309,69368,59
Jensen_Eisai_groupB,1,4,ts-global_detected_seizures,69405,69434,29
Jensen_Eisai_groupB,1,4,ts-global_detected_seizures,69476,69545,69
Jensen_Eisai_groupB,2,5,ts-global_detected_seizures,69542,69567,25
Jensen_Eisai_groupB,1,4,ts-global_detected_seizures,69547,69673,126
Jensen_Eisai_groupB,2,5,ts-global_detected_seizures,69625,69666,41
Jensen_Eisai_groupB,1,4,ts-global_detected_seizures,69674,71272,1598
Jensen_Eisai_groupB,2,5,ts-global_detected_seizures,69680,69702,22
Jensen_Eisai_groupB,2,5,ts-global_detected_seizures,69832,69900,68
Jensen_Eisai_groupB,2,5,ts-global_detected_seizures,70046,70095,49
Jensen_Eisai_groupB,2,5,ts-global_detected_seizures,70146,70174,28
Jensen_Eisai_groupB,2,5,ts-global_detected_seizures,70193,70488,295
Jensen_Eisai_groupB,2,5,ts-global_detected_seizures,70489,70530,41
Jensen_Eisai_groupB,2,5,ts-global_detected_seizures,70532,75938,5406
Jensen_Eisai_groupB,1,4,ts-global_detected_seizures,71273,73625,2352
Jensen_Eisai_groupB,3,6,ts-global_detected_seizures,72663,72735,72
Jensen_Eisai_groupB,3,6,ts-global_detected_seizures,72767,72946,179
Jensen_Eisai_groupB,3,6,ts-global_detected_seizures,72947,77123,4176
Jensen_Eisai_groupB,1,4,ts-global_detected_seizures,73626,77962,4336
Jensen_Eisai_groupB,2,5,ts-global_detected_seizures,75954,76018,64
Jensen_Eisai_groupB,2,5,ts-global_detected_seizures,76357,76394,37
Jensen_Eisai_groupB,2,5,ts-global_detected_seizures,76597,76626,29
Jensen_Eisai_groupB,2,5,ts-global_detected_seizures,76684,76711,27
Jensen_Eisai_groupB,2,5,ts-global_detected_seizures,76809,76845,36
Jensen_Eisai_groupB,2,5,ts-global_detected_seizures,76884,76906,22
Jensen_Eisai_groupB,2,5,ts-global_detected_seizures,76958,76983,25
Jensen_Eisai_groupB,2,5,ts-global_detected_seizures,76958,76983,25
Jensen_Eisai_groupB,2,5,ts-global_detected_seizures,77036,77062,26
Jensen_Eisai_groupB,2,5,ts-global_detected_seizures,77096,77132,36
Jensen_Eisai_groupB,3,6,ts-global_detected_seizures,77124,80796,3672
Jensen_Eisai_groupB,2,5,ts-global_detected_seizures,77263,77286,23
Jensen_Eisai_groupB,2,5,ts-global_detected_seizures,77348,77376,28
Jensen_Eisai_groupB,2,5,ts-global_detected_seizures,77462,77486,24
Jensen_Eisai_groupB,2,5,ts-global_detected_seizures,77526,77590,64
Jensen_Eisai_groupB,2,5,ts-global_detected_seizures,77636,77667,31
Jensen_Eisai_groupB,2,5,ts-global_detected_seizures,77761,77795,34
Jensen_Eisai_groupB,2,5,ts-global_detected_seizures,77894,77962,68
Jensen_Eisai_groupB,1,4,ts-global_detected_seizures,77970,77996,26
Jensen_Eisai_groupB,2,5,ts-global_detected_seizures,77995,78093,98
Jensen_Eisai_groupB,2,5,ts-global_detected_seizures,78394,78442,48
Jensen_Eisai_groupB,1,4,ts-global_detected_seizures,78473,78516,43
Jensen_Eisai_groupB,2,5,ts-global_detected_seizures,78501,78526,25
Jensen_Eisai_groupB,1,4,ts-global_detected_seizures,78544,78567,23
Jensen_Eisai_groupB,1,4,ts-global_detected_seizures,78590,78629,39
Jensen_Eisai_groupB,2,5,ts-global_detected_seizures,78642,78666,24
Jensen_Eisai_groupB,1,4,ts-global_detected_seizures,78892,78947,55
Jensen_Eisai_groupB,2,5,ts-global_detected_seizures,78925,79007,82
Jensen_Eisai_groupB,1,4,ts-global_detected_seizures,78952,78975,23
Jensen_Eisai_groupB,1,4,ts-global_detected_seizures,79013,79233,220
Jensen_Eisai_groupB,2,5,ts-global_detected_seizures,79186,79652,466
Jensen_Eisai_groupB,1,4,ts-global_detected_seizures,79236,81107,1871
Jensen_Eisai_groupB,2,5,ts-global_detected_seizures,79671,79698,27
Jensen_Eisai_groupB,2,5,ts-global_detected_seizures,79835,79858,23
Jensen_Eisai_groupB,2,5,ts-global_detected_seizures,79928,79957,29
Jensen_Eisai_groupB,2,5,ts-global_detected_seizures,80078,80129,51
Jensen_Eisai_groupB,2,5,ts-global_detected_seizures,80130,80214,84
Jensen_Eisai_groupB,2,5,ts-global_detected_seizures,80256,80278,22
Jensen_Eisai_groupB,2,5,ts-global_detected_seizures,80340,80398,58
Jensen_Eisai_groupB,2,5,ts-global_detected_seizures,80531,80556,25
Jensen_Eisai_groupB,2,5,ts-global_detected_seizures,80632,80667,35
Jensen_Eisai_groupB,2,5,ts-global_detected_seizures,80682,80705,23
Jensen_Eisai_groupB,3,6,ts-global_detected_seizures,80797,82165,1368
Jensen_Eisai_groupB,2,5,ts-global_detected_seizures,80866,81532,666
Jensen_Eisai_groupB,1,4,ts-global_detected_seizures,81108,83088,1980
Jensen_Eisai_groupB,2,5,ts-global_detected_seizures,81533,81927,394
Jensen_Eisai_groupB,2,5,ts-global_detected_seizures,81928,82003,75
Jensen_Eisai_groupB,2,5,ts-global_detected_seizures,82077,82106,29
Jensen_Eisai_groupB,2,5,ts-global_detected_seizures,82112,86370,4258
Jensen_Eisai_groupB,3,6,ts-global_detected_seizures,82166,84980,2814
Jensen_Eisai_groupB,1,4,ts-global_detected_seizures,83122,83222,100
Jensen_Eisai_groupB,1,4,ts-global_detected_seizures,83309,83343,34
Jensen_Eisai_groupB,1,4,ts-global_detected_seizures,83390,83432,42
Jensen_Eisai_groupB,1,4,ts-global_detected_seizures,83481,83527,46
Jensen_Eisai_groupB,1,4,ts-global_detected_seizures,83785,83823,38
Jensen_Eisai_groupB,1,4,ts-global_detected_seizures,83824,83848,24
Jensen_Eisai_groupB,1,4,ts-global_detected_seizures,83879,83910,31
Jensen_Eisai_groupB,1,4,ts-global_detected_seizures,84073,84113,40
Jensen_Eisai_groupB,1,4,ts-global_detected_seizures,84115,84204,89
Jensen_Eisai_groupB,1,4,ts-global_detected_seizures,84230,84257,27
Jensen_Eisai_groupB,1,4,ts-global_detected_seizures,84280,84309,29
Jensen_Eisai_groupB,1,4,ts-global_detected_seizures,84310,84349,39
Jensen_Eisai_groupB,1,4,ts-global_detected_seizures,84388,84432,44
Jensen_Eisai_groupB,1,4,ts-global_detected_seizures,84489,85112,623
Jensen_Eisai_groupB,3,6,ts-global_detected_seizures,85058,85098,40
Jensen_Eisai_groupB,3,6,ts-global_detected_seizures,85099,85125,26
Jensen_Eisai_groupB,1,4,ts-global_detected_seizures,85113,86083,970
Jensen_Eisai_groupB,3,6,ts-global_detected_seizures,85126,86370,1244
Jensen_Eisai_groupB,1,4,ts-global_detected_seizures,86084,86370,286
Jensen_Eisai_groupB,3,6,ts-global_detected_seizures,86910,93359,6449
Jensen_Eisai_groupB,2,5,ts-global_detected_seizures,87036,87077,41
Jensen_Eisai_groupB,2,5,ts-global_detected_seizures,87088,87120,32
Jensen_Eisai_groupB,2,5,ts-global_detected_seizures,87140,87244,104
Jensen_Eisai_groupB,2,5,ts-global_detected_seizures,87246,87270,24
Jensen_Eisai_groupB,2,5,ts-global_detected_seizures,87271,87296,25
Jensen_Eisai_groupB,2,5,ts-global_detected_seizures,87297,87333,36
Jensen_Eisai_groupB,2,5,ts-global_detected_seizures,87334,87434,100
Jensen_Eisai_groupB,2,5,ts-global_detected_seizures,87445,87507,62
Jensen_Eisai_groupB,2,5,ts-global_detected_seizures,87508,87540,32
Jensen_Eisai_groupB,2,5,ts-global_detected_seizures,87558,87586,28
Jensen_Eisai_groupB,2,5,ts-global_detected_seizures,87619,87661,42
Jensen_Eisai_groupB,2,5,ts-global_detected_seizures,87671,87697,26
Jensen_Eisai_groupB,2,5,ts-global_detected_seizures,87772,87821,49
Jensen_Eisai_groupB,2,5,ts-global_detected_seizures,87822,88278,456
Jensen_Eisai_groupB,2,5,ts-global_detected_seizures,88292,88496,204
Jensen_Eisai_groupB,2,5,ts-global_detected_seizures,88497,88588,91
Jensen_Eisai_groupB,2,5,ts-global_detected_seizures,88603,88745,142
Jensen_Eisai_groupB,2,5,ts-global_detected_seizures,88746,88782,36
Jensen_Eisai_groupB,2,5,ts-global_detected_seizures,88783,88939,156
Jensen_Eisai_groupB,2,5,ts-global_detected_seizures,88940,88983,43
Jensen_Eisai_groupB,2,5,ts-global_detected_seizures,88984,89006,22
Jensen_Eisai_groupB,2,5,ts-global_detected_seizures,89008,89440,432
Jensen_Eisai_groupB,1,4,ts-global_detected_seizures,89101,89483,382
Jensen_Eisai_groupB,2,5,ts-global_detected_seizures,89441,89479,38
Jensen_Eisai_groupB,2,5,ts-global_detected_seizures,89480,89506,26
Jensen_Eisai_groupB,1,4,ts-global_detected_seizures,89488,89863,375
Jensen_Eisai_groupB,2,5,ts-global_detected_seizures,89521,89620,99
Jensen_Eisai_groupB,2,5,ts-global_detected_seizures,89621,89818,197
Jensen_Eisai_groupB,2,5,ts-global_detected_seizures,89819,89884,65
Jensen_Eisai_groupB,1,4,ts-global_detected_seizures,89864,90373,509
Jensen_Eisai_groupB,2,5,ts-global_detected_seizures,89885,89931,46
Jensen_Eisai_groupB,2,5,ts-global_detected_seizures,89932,90160,228
Jensen_Eisai_groupB,2,5,ts-global_detected_seizures,90161,90265,104
Jensen_Eisai_groupB,2,5,ts-global_detected_seizures,90266,90378,112
Jensen_Eisai_groupB,1,4,ts-global_detected_seizures,90374,90598,224
Jensen_Eisai_groupB,2,5,ts-global_detected_seizures,90379,90569,190
Jensen_Eisai_groupB,2,5,ts-global_detected_seizures,90570,90628,58
Jensen_Eisai_groupB,1,4,ts-global_detected_seizures,90599,91301,702
Jensen_Eisai_groupB,2,5,ts-global_detected_seizures,90629,90675,46
Jensen_Eisai_groupB,2,5,ts-global_detected_seizures,90700,90922,222
Jensen_Eisai_groupB,2,5,ts-global_detected_seizures,90923,90997,74
Jensen_Eisai_groupB,2,5,ts-global_detected_seizures,90998,91038,40
Jensen_Eisai_groupB,2,5,ts-global_detected_seizures,91040,91081,41
Jensen_Eisai_groupB,2,5,ts-global_detected_seizures,91090,91117,27
Jensen_Eisai_groupB,2,5,ts-global_detected_seizures,91118,91148,30
Jensen_Eisai_groupB,2,5,ts-global_detected_seizures,91168,91212,44
Jensen_Eisai_groupB,2,5,ts-global_detected_seizures,91214,91251,37
Jensen_Eisai_groupB,2,5,ts-global_detected_seizures,91252,91282,30
Jensen_Eisai_groupB,2,5,ts-global_detected_seizures,91302,91332,30
Jensen_Eisai_groupB,1,4,ts-global_detected_seizures,91331,91367,36
Jensen_Eisai_groupB,2,5,ts-global_detected_seizures,91390,91512,122
Jensen_Eisai_groupB,1,4,ts-global_detected_seizures,91465,91583,118
Jensen_Eisai_groupB,2,5,ts-global_detected_seizures,91513,91615,102
Jensen_Eisai_groupB,1,4,ts-global_detected_seizures,91584,91697,113
Jensen_Eisai_groupB,2,5,ts-global_detected_seizures,91616,91662,46
Jensen_Eisai_groupB,2,5,ts-global_detected_seizures,91663,91718,55
Jensen_Eisai_groupB,1,4,ts-global_detected_seizures,91700,91745,45
Jensen_Eisai_groupB,2,5,ts-global_detected_seizures,91719,91755,36
Jensen_Eisai_groupB,1,4,ts-global_detected_seizures,91746,91768,22
Jensen_Eisai_groupB,1,4,ts-global_detected_seizures,91769,92168,399
Jensen_Eisai_groupB,2,5,ts-global_detected_seizures,91808,92130,322
Jensen_Eisai_groupB,2,5,ts-global_detected_seizures,92153,92206,53
Jensen_Eisai_groupB,2,5,ts-global_detected_seizures,92207,92287,80
Jensen_Eisai_groupB,1,4,ts-global_detected_seizures,92218,92250,32
Jensen_Eisai_groupB,1,4,ts-global_detected_seizures,92269,92294,25
Jensen_Eisai_groupB,2,5,ts-global_detected_seizures,92288,92350,62
Jensen_Eisai_groupB,2,5,ts-global_detected_seizures,92351,92386,35
Jensen_Eisai_groupB,2,5,ts-global_detected_seizures,92387,92479,92
Jensen_Eisai_groupB,1,4,ts-global_detected_seizures,92414,92442,28
Jensen_Eisai_groupB,1,4,ts-global_detected_seizures,92443,92468,25
Jensen_Eisai_groupB,2,5,ts-global_detected_seizures,92512,92612,100
Jensen_Eisai_groupB,2,5,ts-global_detected_seizures,92618,92648,30
Jensen_Eisai_groupB,2,5,ts-global_detected_seizures,92649,92674,25
Jensen_Eisai_groupB,2,5,ts-global_detected_seizures,92675,92754,79
Jensen_Eisai_groupB,2,5,ts-global_detected_seizures,92755,92939,184
Jensen_Eisai_groupB,1,4,ts-global_detected_seizures,92817,92903,86
Jensen_Eisai_groupB,2,5,ts-global_detected_seizures,92959,92988,29
Jensen_Eisai_groupB,1,4,ts-global_detected_seizures,92975,93016,41
Jensen_Eisai_groupB,2,5,ts-global_detected_seizures,93004,93065,61
Jensen_Eisai_groupB,1,4,ts-global_detected_seizures,93035,93057,22
Jensen_Eisai_groupB,2,5,ts-global_detected_seizures,93071,93182,111
Jensen_Eisai_groupB,1,4,ts-global_detected_seizures,93149,93180,31
Jensen_Eisai_groupB,2,5,ts-global_detected_seizures,93216,93241,25
Jensen_Eisai_groupB,2,5,ts-global_detected_seizures,93243,93269,26
Jensen_Eisai_groupB,2,5,ts-global_detected_seizures,93285,93312,27
Jensen_Eisai_groupB,1,4,ts-global_detected_seizures,93296,93393,97
Jensen_Eisai_groupB,3,6,ts-global_detected_seizures,93360,102805,9445
Jensen_Eisai_groupB,1,4,ts-global_detected_seizures,93438,93472,34
Jensen_Eisai_groupB,2,5,ts-global_detected_seizures,93476,93744,268
Jensen_Eisai_groupB,1,4,ts-global_detected_seizures,93532,93561,29
Jensen_Eisai_groupB,2,5,ts-global_detected_seizures,93767,93814,47
Jensen_Eisai_groupB,1,4,ts-global_detected_seizures,93768,93851,83
Jensen_Eisai_groupB,1,4,ts-global_detected_seizures,93868,93895,27
Jensen_Eisai_groupB,1,4,ts-global_detected_seizures,94019,94117,98
Jensen_Eisai_groupB,2,5,ts-global_detected_seizures,94112,94146,34
Jensen_Eisai_groupB,1,4,ts-global_detected_seizures,94167,94193,26
Jensen_Eisai_groupB,2,5,ts-global_detected_seizures,94204,94234,30
Jensen_Eisai_groupB,1,4,ts-global_detected_seizures,94224,94262,38
Jensen_Eisai_groupB,2,5,ts-global_detected_seizures,94258,94302,44
Jensen_Eisai_groupB,2,5,ts-global_detected_seizures,94303,94336,33
Jensen_Eisai_groupB,2,5,ts-global_detected_seizures,94339,94382,43
Jensen_Eisai_groupB,2,5,ts-global_detected_seizures,94383,94891,508
Jensen_Eisai_groupB,1,4,ts-global_detected_seizures,94499,94534,35
Jensen_Eisai_groupB,1,4,ts-global_detected_seizures,94598,94718,120
Jensen_Eisai_groupB,1,4,ts-global_detected_seizures,94719,94827,108
Jensen_Eisai_groupB,1,4,ts-global_detected_seizures,94854,94887,33
Jensen_Eisai_groupB,2,5,ts-global_detected_seizures,94892,95130,238
Jensen_Eisai_groupB,1,4,ts-global_detected_seizures,94938,94962,24
Jensen_Eisai_groupB,1,4,ts-global_detected_seizures,95012,95048,36
Jensen_Eisai_groupB,1,4,ts-global_detected_seizures,95061,95101,40
Jensen_Eisai_groupB,1,4,ts-global_detected_seizures,95134,95189,55
Jensen_Eisai_groupB,2,5,ts-global_detected_seizures,95155,95185,30
Jensen_Eisai_groupB,1,4,ts-global_detected_seizures,95200,95258,58
Jensen_Eisai_groupB,1,4,ts-global_detected_seizures,95267,95299,32
Jensen_Eisai_groupB,1,4,ts-global_detected_seizures,95325,95365,40
Jensen_Eisai_groupB,2,5,ts-global_detected_seizures,95343,95430,87
Jensen_Eisai_groupB,1,4,ts-global_detected_seizures,95396,95420,24
Jensen_Eisai_groupB,2,5,ts-global_detected_seizures,95440,95464,24
Jensen_Eisai_groupB,1,4,ts-global_detected_seizures,95484,95527,43
Jensen_Eisai_groupB,1,4,ts-global_detected_seizures,95547,95673,126
Jensen_Eisai_groupB,2,5,ts-global_detected_seizures,95588,95623,35
Jensen_Eisai_groupB,1,4,ts-global_detected_seizures,95688,95743,55
Jensen_Eisai_groupB,1,4,ts-global_detected_seizures,95792,95908,116
Jensen_Eisai_groupB,2,5,ts-global_detected_seizures,95871,96101,230
Jensen_Eisai_groupB,1,4,ts-global_detected_seizures,95921,95985,64
Jensen_Eisai_groupB,1,4,ts-global_detected_seizures,96048,96094,46
Jensen_Eisai_groupB,2,5,ts-global_detected_seizures,96102,96627,525
Jensen_Eisai_groupB,1,4,ts-global_detected_seizures,96138,96171,33
Jensen_Eisai_groupB,1,4,ts-global_detected_seizures,96218,96298,80
Jensen_Eisai_groupB,1,4,ts-global_detected_seizures,96314,96350,36
Jensen_Eisai_groupB,1,4,ts-global_detected_seizures,96437,96482,45
Jensen_Eisai_groupB,1,4,ts-global_detected_seizures,96502,96533,31
Jensen_Eisai_groupB,1,4,ts-global_detected_seizures,96562,96584,22
Jensen_Eisai_groupB,1,4,ts-global_detected_seizures,96585,96609,24
Jensen_Eisai_groupB,2,5,ts-global_detected_seizures,96629,96653,24
Jensen_Eisai_groupB,1,4,ts-global_detected_seizures,96672,96914,242
Jensen_Eisai_groupB,2,5,ts-global_detected_seizures,96760,96814,54
Jensen_Eisai_groupB,1,4,ts-global_detected_seizures,96919,96977,58
Jensen_Eisai_groupB,1,4,ts-global_detected_seizures,96979,99759,2780
Jensen_Eisai_groupB,2,5,ts-global_detected_seizures,97092,97124,32
Jensen_Eisai_groupB,2,5,ts-global_detected_seizures,97185,97214,29
Jensen_Eisai_groupB,2,5,ts-global_detected_seizures,97301,97340,39
Jensen_Eisai_groupB,2,5,ts-global_detected_seizures,97404,97456,52
Jensen_Eisai_groupB,2,5,ts-global_detected_seizures,97465,97487,22
Jensen_Eisai_groupB,2,5,ts-global_detected_seizures,97661,97685,24
Jensen_Eisai_groupB,2,5,ts-global_detected_seizures,97711,97744,33
Jensen_Eisai_groupB,2,5,ts-global_detected_seizures,97790,97818,28
Jensen_Eisai_groupB,2,5,ts-global_detected_seizures,97875,97925,50
Jensen_Eisai_groupB,2,5,ts-global_detected_seizures,97981,98006,25
Jensen_Eisai_groupB,2,5,ts-global_detected_seizures,98011,98053,42
Jensen_Eisai_groupB,2,5,ts-global_detected_seizures,98106,98143,37
Jensen_Eisai_groupB,2,5,ts-global_detected_seizures,98178,98202,24
Jensen_Eisai_groupB,2,5,ts-global_detected_seizures,98241,98309,68
Jensen_Eisai_groupB,2,5,ts-global_detected_seizures,98310,98453,143
Jensen_Eisai_groupB,2,5,ts-global_detected_seizures,98507,98529,22
Jensen_Eisai_groupB,2,5,ts-global_detected_seizures,98672,98695,23
Jensen_Eisai_groupB,2,5,ts-global_detected_seizures,98837,98867,30
Jensen_Eisai_groupB,2,5,ts-global_detected_seizures,98982,99004,22
Jensen_Eisai_groupB,2,5,ts-global_detected_seizures,99087,99121,34
Jensen_Eisai_groupB,2,5,ts-global_detected_seizures,99209,99251,42
Jensen_Eisai_groupB,2,5,ts-global_detected_seizures,99252,99354,102
Jensen_Eisai_groupB,2,5,ts-global_detected_seizures,99547,99579,32
Jensen_Eisai_groupB,2,5,ts-global_detected_seizures,99691,99714,23
Jensen_Eisai_groupB,2,5,ts-global_detected_seizures,99743,99874,131
Jensen_Eisai_groupB,1,4,ts-global_detected_seizures,99781,99849,68
Jensen_Eisai_groupB,1,4,ts-global_detected_seizures,99867,99891,24
Jensen_Eisai_groupB,2,5,ts-global_detected_seizures,99926,99954,28
Jensen_Eisai_groupB,1,4,ts-global_detected_seizures,99985,100008,23
Jensen_Eisai_groupB,2,5,ts-global_detected_seizures,99987,100011,24
Jensen_Eisai_groupB,1,4,ts-global_detected_seizures,100010,100056,46
Jensen_Eisai_groupB,2,5,ts-global_detected_seizures,100014,100044,30
Jensen_Eisai_groupB,2,5,ts-global_detected_seizures,100058,100100,42
Jensen_Eisai_groupB,1,4,ts-global_detected_seizures,100080,100128,48
Jensen_Eisai_groupB,2,5,ts-global_detected_seizures,100157,100185,28
Jensen_Eisai_groupB,2,5,ts-global_detected_seizures,100193,100225,32
Jensen_Eisai_groupB,2,5,ts-global_detected_seizures,100307,100331,24
Jensen_Eisai_groupB,1,4,ts-global_detected_seizures,100328,100358,30
Jensen_Eisai_groupB,1,4,ts-global_detected_seizures,100381,100403,22
Jensen_Eisai_groupB,1,4,ts-global_detected_seizures,100381,100403,22
Jensen_Eisai_groupB,2,5,ts-global_detected_seizures,100398,100434,36
Jensen_Eisai_groupB,1,4,ts-global_detected_seizures,100483,100519,36
Jensen_Eisai_groupB,2,5,ts-global_detected_seizures,100484,100523,39
Jensen_Eisai_groupB,1,4,ts-global_detected_seizures,100520,100556,36
Jensen_Eisai_groupB,1,4,ts-global_detected_seizures,100559,100600,41
Jensen_Eisai_groupB,1,4,ts-global_detected_seizures,100617,100652,35
Jensen_Eisai_groupB,2,5,ts-global_detected_seizures,100637,100674,37
Jensen_Eisai_groupB,1,4,ts-global_detected_seizures,100655,100719,64
Jensen_Eisai_groupB,2,5,ts-global_detected_seizures,100737,100779,42
Jensen_Eisai_groupB,1,4,ts-global_detected_seizures,100742,100786,44
Jensen_Eisai_groupB,1,4,ts-global_detected_seizures,100828,100850,22
Jensen_Eisai_groupB,1,4,ts-global_detected_seizures,100915,100956,41
Jensen_Eisai_groupB,2,5,ts-global_detected_seizures,100937,100977,40
Jensen_Eisai_groupB,1,4,ts-global_detected_seizures,100999,101033,34
Jensen_Eisai_groupB,1,4,ts-global_detected_seizures,101034,101060,26
Jensen_Eisai_groupB,2,5,ts-global_detected_seizures,101079,101111,32
Jensen_Eisai_groupB,1,4,ts-global_detected_seizures,101118,101149,31
Jensen_Eisai_groupB,2,5,ts-global_detected_seizures,101147,101171,24
Jensen_Eisai_groupB,1,4,ts-global_detected_seizures,101150,101187,37
Jensen_Eisai_groupB,1,4,ts-global_detected_seizures,101205,101241,36
Jensen_Eisai_groupB,1,4,ts-global_detected_seizures,101292,101363,71
Jensen_Eisai_groupB,2,5,ts-global_detected_seizures,101298,101458,160
Jensen_Eisai_groupB,1,4,ts-global_detected_seizures,101364,101432,68
Jensen_Eisai_groupB,1,4,ts-global_detected_seizures,101433,101468,35
Jensen_Eisai_groupB,1,4,ts-global_detected_seizures,101471,101497,26
Jensen_Eisai_groupB,1,4,ts-global_detected_seizures,101502,101534,32
Jensen_Eisai_groupB,2,5,ts-global_detected_seizures,101528,101556,28
Jensen_Eisai_groupB,1,4,ts-global_detected_seizures,101544,101604,60
Jensen_Eisai_groupB,1,4,ts-global_detected_seizures,101627,101665,38
Jensen_Eisai_groupB,1,4,ts-global_detected_seizures,101667,101693,26
Jensen_Eisai_groupB,2,5,ts-global_detected_seizures,101677,101700,23
Jensen_Eisai_groupB,2,5,ts-global_detected_seizures,101734,101793,59
Jensen_Eisai_groupB,1,4,ts-global_detected_seizures,101751,101815,64
Jensen_Eisai_groupB,2,5,ts-global_detected_seizures,101812,101855,43
Jensen_Eisai_groupB,1,4,ts-global_detected_seizures,101830,101863,33
Jensen_Eisai_groupB,1,4,ts-global_detected_seizures,101864,101964,100
Jensen_Eisai_groupB,2,5,ts-global_detected_seizures,101949,101982,33
Jensen_Eisai_groupB,1,4,ts-global_detected_seizures,101993,102024,31
Jensen_Eisai_groupB,2,5,ts-global_detected_seizures,102012,102034,22
Jensen_Eisai_groupB,1,4,ts-global_detected_seizures,102025,102071,46
Jensen_Eisai_groupB,2,5,ts-global_detected_seizures,102050,102096,46
Jensen_Eisai_groupB,1,4,ts-global_detected_seizures,102084,102164,80
Jensen_Eisai_groupB,1,4,ts-global_detected_seizures,102171,102454,283
Jensen_Eisai_groupB,2,5,ts-global_detected_seizures,102192,102299,107
Jensen_Eisai_groupB,2,5,ts-global_detected_seizures,102415,102462,47
Jensen_Eisai_groupB,1,4,ts-global_detected_seizures,102455,102593,138
Jensen_Eisai_groupB,2,5,ts-global_detected_seizures,102537,102575,38
Jensen_Eisai_groupB,2,5,ts-global_detected_seizures,102586,102609,23
Jensen_Eisai_groupB,1,4,ts-global_detected_seizures,102594,102742,148
Jensen_Eisai_groupB,2,5,ts-global_detected_seizures,102642,102697,55
Jensen_Eisai_groupB,2,5,ts-global_detected_seizures,102708,102766,58
Jensen_Eisai_groupB,1,4,ts-global_detected_seizures,102759,102796,37
Jensen_Eisai_groupB,3,6,ts-global_detected_seizures,102806,107187,4381
Jensen_Eisai_groupB,1,4,ts-global_detected_seizures,102807,102832,25
Jensen_Eisai_groupB,2,5,ts-global_detected_seizures,102841,102986,145
Jensen_Eisai_groupB,1,4,ts-global_detected_seizures,102902,102971,69
Jensen_Eisai_groupB,1,4,ts-global_detected_seizures,102985,103009,24
Jensen_Eisai_groupB,2,5,ts-global_detected_seizures,102987,103047,60
Jensen_Eisai_groupB,1,4,ts-global_detected_seizures,103029,103067,38
Jensen_Eisai_groupB,2,5,ts-global_detected_seizures,103048,103523,475
Jensen_Eisai_groupB,1,4,ts-global_detected_seizures,103127,103207,80
Jensen_Eisai_groupB,1,4,ts-global_detected_seizures,103208,103232,24
Jensen_Eisai_groupB,1,4,ts-global_detected_seizures,103275,103427,152
Jensen_Eisai_groupB,1,4,ts-global_detected_seizures,103461,103540,79
Jensen_Eisai_groupB,2,5,ts-global_detected_seizures,103533,103679,146
Jensen_Eisai_groupB,1,4,ts-global_detected_seizures,103541,103592,51
Jensen_Eisai_groupB,1,4,ts-global_detected_seizures,103596,103647,51
Jensen_Eisai_groupB,1,4,ts-global_detected_seizures,103651,103711,60
Jensen_Eisai_groupB,2,5,ts-global_detected_seizures,103680,103729,49
Jensen_Eisai_groupB,2,5,ts-global_detected_seizures,103730,104590,860
Jensen_Eisai_groupB,1,4,ts-global_detected_seizures,103743,103908,165
Jensen_Eisai_groupB,1,4,ts-global_detected_seizures,103921,103964,43
Jensen_Eisai_groupB,1,4,ts-global_detected_seizures,103975,104022,47
Jensen_Eisai_groupB,1,4,ts-global_detected_seizures,104033,104066,33
Jensen_Eisai_groupB,1,4,ts-global_detected_seizures,104067,104143,76
Jensen_Eisai_groupB,1,4,ts-global_detected_seizures,104171,104200,29
Jensen_Eisai_groupB,1,4,ts-global_detected_seizures,104202,104261,59
Jensen_Eisai_groupB,1,4,ts-global_detected_seizures,104262,104319,57
Jensen_Eisai_groupB,1,4,ts-global_detected_seizures,104341,104434,93
Jensen_Eisai_groupB,1,4,ts-global_detected_seizures,104443,107205,2762
Jensen_Eisai_groupB,2,5,ts-global_detected_seizures,104617,104851,234
Jensen_Eisai_groupB,2,5,ts-global_detected_seizures,105088,105113,25
Jensen_Eisai_groupB,2,5,ts-global_detected_seizures,105149,105193,44
Jensen_Eisai_groupB,2,5,ts-global_detected_seizures,105265,105298,33
Jensen_Eisai_groupB,2,5,ts-global_detected_seizures,105357,105382,25
Jensen_Eisai_groupB,2,5,ts-global_detected_seizures,105618,105721,103
Jensen_Eisai_groupB,2,5,ts-global_detected_seizures,105722,105808,86
Jensen_Eisai_groupB,2,5,ts-global_detected_seizures,105909,105938,29
Jensen_Eisai_groupB,2,5,ts-global_detected_seizures,105991,106023,32
Jensen_Eisai_groupB,2,5,ts-global_detected_seizures,106073,106104,31
Jensen_Eisai_groupB,2,5,ts-global_detected_seizures,106114,106144,30
Jensen_Eisai_groupB,2,5,ts-global_detected_seizures,106193,106219,26
Jensen_Eisai_groupB,2,5,ts-global_detected_seizures,106313,106338,25
Jensen_Eisai_groupB,2,5,ts-global_detected_seizures,106398,106435,37
Jensen_Eisai_groupB,2,5,ts-global_detected_seizures,106498,106528,30
Jensen_Eisai_groupB,2,5,ts-global_detected_seizures,106541,106565,24
Jensen_Eisai_groupB,2,5,ts-global_detected_seizures,106576,106600,24
Jensen_Eisai_groupB,2,5,ts-global_detected_seizures,106637,106668,31
Jensen_Eisai_groupB,2,5,ts-global_detected_seizures,106705,106729,24
Jensen_Eisai_groupB,2,5,ts-global_detected_seizures,106767,106803,36
Jensen_Eisai_groupB,2,5,ts-global_detected_seizures,106812,106850,38
Jensen_Eisai_groupB,2,5,ts-global_detected_seizures,106871,107008,137
Jensen_Eisai_groupB,2,5,ts-global_detected_seizures,107025,107062,37
Jensen_Eisai_groupB,2,5,ts-global_detected_seizures,107099,107137,38
Jensen_Eisai_groupB,2,5,ts-global_detected_seizures,107159,107187,28
Jensen_Eisai_groupB,3,6,ts-global_detected_seizures,107188,112453,5265
Jensen_Eisai_groupB,1,4,ts-global_detected_seizures,107206,107277,71
Jensen_Eisai_groupB,2,5,ts-global_detected_seizures,107250,107276,26
Jensen_Eisai_groupB,2,5,ts-global_detected_seizures,107314,107375,61
Jensen_Eisai_groupB,1,4,ts-global_detected_seizures,107316,107351,35
Jensen_Eisai_groupB,1,4,ts-global_detected_seizures,107355,107422,67
Jensen_Eisai_groupB,1,4,ts-global_detected_seizures,107423,107450,27
Jensen_Eisai_groupB,2,5,ts-global_detected_seizures,107437,107469,32
Jensen_Eisai_groupB,1,4,ts-global_detected_seizures,107451,107487,36
Jensen_Eisai_groupB,2,5,ts-global_detected_seizures,107483,107527,44
Jensen_Eisai_groupB,1,4,ts-global_detected_seizures,107488,107512,24
Jensen_Eisai_groupB,2,5,ts-global_detected_seizures,107549,107722,173
Jensen_Eisai_groupB,1,4,ts-global_detected_seizures,107636,107701,65
Jensen_Eisai_groupB,2,5,ts-global_detected_seizures,107743,107770,27
Jensen_Eisai_groupB,2,5,ts-global_detected_seizures,107802,107882,80
Jensen_Eisai_groupB,1,4,ts-global_detected_seizures,107819,107849,30
Jensen_Eisai_groupB,1,4,ts-global_detected_seizures,107894,107917,23
Jensen_Eisai_groupB,2,5,ts-global_detected_seizures,107906,107965,59
Jensen_Eisai_groupB,1,4,ts-global_detected_seizures,107946,107985,39
Jensen_Eisai_groupB,2,5,ts-global_detected_seizures,107987,108015,28
Jensen_Eisai_groupB,1,4,ts-global_detected_seizures,108044,108088,44
Jensen_Eisai_groupB,2,5,ts-global_detected_seizures,108050,108072,22
Jensen_Eisai_groupB,2,5,ts-global_detected_seizures,108140,108170,30
Jensen_Eisai_groupB,1,4,ts-global_detected_seizures,108266,108335,69
Jensen_Eisai_groupB,2,5,ts-global_detected_seizures,108283,108313,30
Jensen_Eisai_groupB,2,5,ts-global_detected_seizures,108382,108516,134
Jensen_Eisai_groupB,1,4,ts-global_detected_seizures,108395,108459,64
Jensen_Eisai_groupB,1,4,ts-global_detected_seizures,108509,108559,50
Jensen_Eisai_groupB,2,5,ts-global_detected_seizures,108573,108605,32
Jensen_Eisai_groupB,1,4,ts-global_detected_seizures,108584,108612,28
Jensen_Eisai_groupB,1,4,ts-global_detected_seizures,108647,108711,64
Jensen_Eisai_groupB,2,5,ts-global_detected_seizures,108677,108733,56
Jensen_Eisai_groupB,1,4,ts-global_detected_seizures,108735,108782,47
Jensen_Eisai_groupB,2,5,ts-global_detected_seizures,108759,108796,37
Jensen_Eisai_groupB,1,4,ts-global_detected_seizures,108788,108854,66
Jensen_Eisai_groupB,2,5,ts-global_detected_seizures,108824,108853,29
Jensen_Eisai_groupB,1,4,ts-global_detected_seizures,108866,108893,27
Jensen_Eisai_groupB,2,5,ts-global_detected_seizures,108923,108971,48
Jensen_Eisai_groupB,1,4,ts-global_detected_seizures,108952,109012,60
Jensen_Eisai_groupB,2,5,ts-global_detected_seizures,108997,109031,34
Jensen_Eisai_groupB,1,4,ts-global_detected_seizures,109030,109077,47
Jensen_Eisai_groupB,2,5,ts-global_detected_seizures,109044,109100,56
Jensen_Eisai_groupB,1,4,ts-global_detected_seizures,109107,109131,24
Jensen_Eisai_groupB,2,5,ts-global_detected_seizures,109147,109206,59
Jensen_Eisai_groupB,1,4,ts-global_detected_seizures,109149,109183,34
Jensen_Eisai_groupB,1,4,ts-global_detected_seizures,109215,109259,44
Jensen_Eisai_groupB,2,5,ts-global_detected_seizures,109249,109275,26
Jensen_Eisai_groupB,1,4,ts-global_detected_seizures,109304,109400,96
Jensen_Eisai_groupB,2,5,ts-global_detected_seizures,109384,109408,24
Jensen_Eisai_groupB,1,4,ts-global_detected_seizures,109401,109428,27
Jensen_Eisai_groupB,1,4,ts-global_detected_seizures,109460,109576,116
Jensen_Eisai_groupB,2,5,ts-global_detected_seizures,109515,109539,24
Jensen_Eisai_groupB,2,5,ts-global_detected_seizures,109560,109589,29
Jensen_Eisai_groupB,1,4,ts-global_detected_seizures,109607,109635,28
Jensen_Eisai_groupB,2,5,ts-global_detected_seizures,109618,109646,28
Jensen_Eisai_groupB,1,4,ts-global_detected_seizures,109683,109875,192
Jensen_Eisai_groupB,2,5,ts-global_detected_seizures,109715,109737,22
Jensen_Eisai_groupB,2,5,ts-global_detected_seizures,109766,109793,27
Jensen_Eisai_groupB,2,5,ts-global_detected_seizures,109873,109960,87
Jensen_Eisai_groupB,1,4,ts-global_detected_seizures,109876,109930,54
Jensen_Eisai_groupB,1,4,ts-global_detected_seizures,109945,109978,33
Jensen_Eisai_groupB,2,5,ts-global_detected_seizures,110002,110027,25
Jensen_Eisai_groupB,1,4,ts-global_detected_seizures,110017,110104,87
Jensen_Eisai_groupB,2,5,ts-global_detected_seizures,110053,110135,82
Jensen_Eisai_groupB,1,4,ts-global_detected_seizures,110123,110176,53
Jensen_Eisai_groupB,2,5,ts-global_detected_seizures,110157,110191,34
Jensen_Eisai_groupB,1,4,ts-global_detected_seizures,110198,110236,38
Jensen_Eisai_groupB,2,5,ts-global_detected_seizures,110226,110259,33
Jensen_Eisai_groupB,1,4,ts-global_detected_seizures,110264,110339,75
Jensen_Eisai_groupB,2,5,ts-global_detected_seizures,110316,110343,27
Jensen_Eisai_groupB,1,4,ts-global_detected_seizures,110341,110412,71
Jensen_Eisai_groupB,2,5,ts-global_detected_seizures,110352,110383,31
Jensen_Eisai_groupB,1,4,ts-global_detected_seizures,110414,110461,47
Jensen_Eisai_groupB,2,5,ts-global_detected_seizures,110455,110481,26
Jensen_Eisai_groupB,1,4,ts-global_detected_seizures,110509,110535,26
Jensen_Eisai_groupB,1,4,ts-global_detected_seizures,110538,110668,130
Jensen_Eisai_groupB,2,5,ts-global_detected_seizures,110541,110585,44
Jensen_Eisai_groupB,2,5,ts-global_detected_seizures,110613,110642,29
Jensen_Eisai_groupB,2,5,ts-global_detected_seizures,110660,110710,50
Jensen_Eisai_groupB,1,4,ts-global_detected_seizures,110669,110736,67
Jensen_Eisai_groupB,1,4,ts-global_detected_seizures,110738,110784,46
Jensen_Eisai_groupB,1,4,ts-global_detected_seizures,110785,110827,42
Jensen_Eisai_groupB,2,5,ts-global_detected_seizures,110797,110829,32
Jensen_Eisai_groupB,1,4,ts-global_detected_seizures,110828,110860,32
Jensen_Eisai_groupB,2,5,ts-global_detected_seizures,110847,110876,29
Jensen_Eisai_groupB,1,4,ts-global_detected_seizures,110861,110944,83
Jensen_Eisai_groupB,2,5,ts-global_detected_seizures,110933,110959,26
Jensen_Eisai_groupB,1,4,ts-global_detected_seizures,110945,111067,122
Jensen_Eisai_groupB,2,5,ts-global_detected_seizures,110973,111006,33
Jensen_Eisai_groupB,2,5,ts-global_detected_seizures,111025,111071,46
Jensen_Eisai_groupB,2,5,ts-global_detected_seizures,111080,111102,22
Jensen_Eisai_groupB,1,4,ts-global_detected_seizures,111129,111187,58
Jensen_Eisai_groupB,2,5,ts-global_detected_seizures,111143,111171,28
Jensen_Eisai_groupB,1,4,ts-global_detected_seizures,111190,111283,93
Jensen_Eisai_groupB,2,5,ts-global_detected_seizures,111238,111298,60
Jensen_Eisai_groupB,1,4,ts-global_detected_seizures,111314,111370,56
Jensen_Eisai_groupB,2,5,ts-global_detected_seizures,111330,111354,24
Jensen_Eisai_groupB,2,5,ts-global_detected_seizures,111409,111437,28
Jensen_Eisai_groupB,1,4,ts-global_detected_seizures,111460,111731,271
Jensen_Eisai_groupB,2,5,ts-global_detected_seizures,111461,111498,37
Jensen_Eisai_groupB,2,5,ts-global_detected_seizures,111551,111647,96
Jensen_Eisai_groupB,2,5,ts-global_detected_seizures,111664,111744,80
Jensen_Eisai_groupB,1,4,ts-global_detected_seizures,111732,111847,115
Jensen_Eisai_groupB,2,5,ts-global_detected_seizures,111783,111806,23
Jensen_Eisai_groupB,2,5,ts-global_detected_seizures,111821,111843,22
Jensen_Eisai_groupB,1,4,ts-global_detected_seizures,111861,111953,92
Jensen_Eisai_groupB,2,5,ts-global_detected_seizures,111871,111964,93
Jensen_Eisai_groupB,1,4,ts-global_detected_seizures,111956,111979,23
Jensen_Eisai_groupB,2,5,ts-global_detected_seizures,111975,112020,45
Jensen_Eisai_groupB,1,4,ts-global_detected_seizures,112005,112034,29
Jensen_Eisai_groupB,2,5,ts-global_detected_seizures,112021,112043,22
Jensen_Eisai_groupB,1,4,ts-global_detected_seizures,112035,112118,83
Jensen_Eisai_groupB,1,4,ts-global_detected_seizures,112119,112143,24
Jensen_Eisai_groupB,2,5,ts-global_detected_seizures,112131,112164,33
Jensen_Eisai_groupB,1,4,ts-global_detected_seizures,112167,112192,25
Jensen_Eisai_groupB,1,4,ts-global_detected_seizures,112211,112388,177
Jensen_Eisai_groupB,2,5,ts-global_detected_seizures,112279,112348,69
Jensen_Eisai_groupB,1,4,ts-global_detected_seizures,112395,112460,65
Jensen_Eisai_groupB,2,5,ts-global_detected_seizures,112407,112431,24
Jensen_Eisai_groupB,2,5,ts-global_detected_seizures,112441,112468,27
Jensen_Eisai_groupB,3,6,ts-global_detected_seizures,112454,118425,5971
Jensen_Eisai_groupB,1,4,ts-global_detected_seizures,112462,112499,37
Jensen_Eisai_groupB,1,4,ts-global_detected_seizures,112500,114336,1836
Jensen_Eisai_groupB,2,5,ts-global_detected_seizures,112532,112611,79
Jensen_Eisai_groupB,2,5,ts-global_detected_seizures,112765,112787,22
Jensen_Eisai_groupB,2,5,ts-global_detected_seizures,112798,112852,54
Jensen_Eisai_groupB,2,5,ts-global_detected_seizures,112867,112908,41
Jensen_Eisai_groupB,2,5,ts-global_detected_seizures,112914,112955,41
Jensen_Eisai_groupB,2,5,ts-global_detected_seizures,113007,113031,24
Jensen_Eisai_groupB,2,5,ts-global_detected_seizures,113054,113080,26
Jensen_Eisai_groupB,2,5,ts-global_detected_seizures,113087,113110,23
Jensen_Eisai_groupB,2,5,ts-global_detected_seizures,113134,113160,26
Jensen_Eisai_groupB,2,5,ts-global_detected_seizures,113200,113227,27
Jensen_Eisai_groupB,2,5,ts-global_detected_seizures,113281,113308,27
Jensen_Eisai_groupB,2,5,ts-global_detected_seizures,113334,113358,24
Jensen_Eisai_groupB,2,5,ts-global_detected_seizures,113390,113474,84
Jensen_Eisai_groupB,2,5,ts-global_detected_seizures,113475,113507,32
Jensen_Eisai_groupB,2,5,ts-global_detected_seizures,113508,113532,24
Jensen_Eisai_groupB,2,5,ts-global_detected_seizures,113548,113687,139
Jensen_Eisai_groupB,2,5,ts-global_detected_seizures,113689,113806,117
Jensen_Eisai_groupB,2,5,ts-global_detected_seizures,113812,114043,231
Jensen_Eisai_groupB,2,5,ts-global_detected_seizures,114044,114076,32
Jensen_Eisai_groupB,2,5,ts-global_detected_seizures,114102,114127,25
Jensen_Eisai_groupB,2,5,ts-global_detected_seizures,114168,114191,23
Jensen_Eisai_groupB,2,5,ts-global_detected_seizures,114201,114245,44
Jensen_Eisai_groupB,2,5,ts-global_detected_seizures,114273,114299,26
Jensen_Eisai_groupB,2,5,ts-global_detected_seizures,114371,114404,33
Jensen_Eisai_groupB,1,4,ts-global_detected_seizures,114378,114415,37
Jensen_Eisai_groupB,1,4,ts-global_detected_seizures,114423,114452,29
Jensen_Eisai_groupB,2,5,ts-global_detected_seizures,114433,114469,36
Jensen_Eisai_groupB,1,4,ts-global_detected_seizures,114518,114555,37
Jensen_Eisai_groupB,2,5,ts-global_detected_seizures,114561,114626,65
Jensen_Eisai_groupB,1,4,ts-global_detected_seizures,114616,114682,66
Jensen_Eisai_groupB,2,5,ts-global_detected_seizures,114651,114680,29
Jensen_Eisai_groupB,2,5,ts-global_detected_seizures,114720,114759,39
Jensen_Eisai_groupB,1,4,ts-global_detected_seizures,114745,114781,36
Jensen_Eisai_groupB,2,5,ts-global_detected_seizures,114780,114816,36
Jensen_Eisai_groupB,1,4,ts-global_detected_seizures,114828,114862,34
Jensen_Eisai_groupB,2,5,ts-global_detected_seizures,114831,114859,28
Jensen_Eisai_groupB,2,5,ts-global_detected_seizures,114877,114906,29
Jensen_Eisai_groupB,1,4,ts-global_detected_seizures,114878,114907,29
Jensen_Eisai_groupB,1,4,ts-global_detected_seizures,114917,114972,55
Jensen_Eisai_groupB,2,5,ts-global_detected_seizures,114985,115014,29
Jensen_Eisai_groupB,1,4,ts-global_detected_seizures,115054,115081,27
Jensen_Eisai_groupB,2,5,ts-global_detected_seizures,115060,115190,130
Jensen_Eisai_groupB,1,4,ts-global_detected_seizures,115129,115253,124
Jensen_Eisai_groupB,2,5,ts-global_detected_seizures,115252,115307,55
Jensen_Eisai_groupB,1,4,ts-global_detected_seizures,115256,115278,22
Jensen_Eisai_groupB,1,4,ts-global_detected_seizures,115295,115353,58
Jensen_Eisai_groupB,2,5,ts-global_detected_seizures,115323,115357,34
Jensen_Eisai_groupB,2,5,ts-global_detected_seizures,115391,115423,32
Jensen_Eisai_groupB,1,4,ts-global_detected_seizures,115414,115510,96
Jensen_Eisai_groupB,2,5,ts-global_detected_seizures,115497,115522,25
Jensen_Eisai_groupB,1,4,ts-global_detected_seizures,115511,115573,62
Jensen_Eisai_groupB,2,5,ts-global_detected_seizures,115533,115562,29
Jensen_Eisai_groupB,1,4,ts-global_detected_seizures,115585,115626,41
Jensen_Eisai_groupB,2,5,ts-global_detected_seizures,115600,115637,37
Jensen_Eisai_groupB,2,5,ts-global_detected_seizures,115664,115694,30
Jensen_Eisai_groupB,1,4,ts-global_detected_seizures,115666,115707,41
Jensen_Eisai_groupB,1,4,ts-global_detected_seizures,115719,115802,83
Jensen_Eisai_groupB,2,5,ts-global_detected_seizures,115732,115774,42
Jensen_Eisai_groupB,1,4,ts-global_detected_seizures,115818,115848,30
Jensen_Eisai_groupB,2,5,ts-global_detected_seizures,115828,115854,26
Jensen_Eisai_groupB,2,5,ts-global_detected_seizures,115869,115897,28
Jensen_Eisai_groupB,1,4,ts-global_detected_seizures,115922,116084,162
Jensen_Eisai_groupB,2,5,ts-global_detected_seizures,115930,115953,23
Jensen_Eisai_groupB,2,5,ts-global_detected_seizures,115997,116036,39
Jensen_Eisai_groupB,2,5,ts-global_detected_seizures,116037,116128,91
Jensen_Eisai_groupB,1,4,ts-global_detected_seizures,116096,116229,133
Jensen_Eisai_groupB,2,5,ts-global_detected_seizures,116133,116182,49
Jensen_Eisai_groupB,2,5,ts-global_detected_seizures,116206,116229,23
Jensen_Eisai_groupB,2,5,ts-global_detected_seizures,116248,116280,32
Jensen_Eisai_groupB,1,4,ts-global_detected_seizures,116252,116343,91
Jensen_Eisai_groupB,2,5,ts-global_detected_seizures,116292,116316,24
Jensen_Eisai_groupB,1,4,ts-global_detected_seizures,116378,116424,46
Jensen_Eisai_groupB,2,5,ts-global_detected_seizures,116430,116458,28
Jensen_Eisai_groupB,1,4,ts-global_detected_seizures,116447,116526,79
Jensen_Eisai_groupB,1,4,ts-global_detected_seizures,116540,116588,48
Jensen_Eisai_groupB,2,5,ts-global_detected_seizures,116542,116566,24
Jensen_Eisai_groupB,1,4,ts-global_detected_seizures,116601,116642,41
Jensen_Eisai_groupB,2,5,ts-global_detected_seizures,116623,116646,23
Jensen_Eisai_groupB,1,4,ts-global_detected_seizures,116643,116684,41
Jensen_Eisai_groupB,1,4,ts-global_detected_seizures,116690,116737,47
Jensen_Eisai_groupB,2,5,ts-global_detected_seizures,116719,116747,28
Jensen_Eisai_groupB,1,4,ts-global_detected_seizures,116752,117014,262
Jensen_Eisai_groupB,2,5,ts-global_detected_seizures,116787,116838,51
Jensen_Eisai_groupB,2,5,ts-global_detected_seizures,116853,116883,30
Jensen_Eisai_groupB,2,5,ts-global_detected_seizures,116949,117006,57
Jensen_Eisai_groupB,2,5,ts-global_detected_seizures,117009,117054,45
Jensen_Eisai_groupB,1,4,ts-global_detected_seizures,117059,117200,141
Jensen_Eisai_groupB,2,5,ts-global_detected_seizures,117081,117106,25
Jensen_Eisai_groupB,2,5,ts-global_detected_seizures,117111,117137,26
Jensen_Eisai_groupB,2,5,ts-global_detected_seizures,117164,117190,26
Jensen_Eisai_groupB,2,5,ts-global_detected_seizures,117229,117266,37
Jensen_Eisai_groupB,1,4,ts-global_detected_seizures,117242,117407,165
Jensen_Eisai_groupB,2,5,ts-global_detected_seizures,117272,117294,22
Jensen_Eisai_groupB,1,4,ts-global_detected_seizures,117408,117453,45
Jensen_Eisai_groupB,2,5,ts-global_detected_seizures,117430,117453,23
Jensen_Eisai_groupB,1,4,ts-global_detected_seizures,117476,117515,39
Jensen_Eisai_groupB,2,5,ts-global_detected_seizures,117526,117550,24
Jensen_Eisai_groupB,1,4,ts-global_detected_seizures,117539,117617,78
Jensen_Eisai_groupB,2,5,ts-global_detected_seizures,117604,117631,27
Jensen_Eisai_groupB,1,4,ts-global_detected_seizures,117618,117703,85
Jensen_Eisai_groupB,1,4,ts-global_detected_seizures,117718,117767,49
Jensen_Eisai_groupB,2,5,ts-global_detected_seizures,117769,117806,37
Jensen_Eisai_groupB,1,4,ts-global_detected_seizures,117777,117845,68
Jensen_Eisai_groupB,2,5,ts-global_detected_seizures,117816,117844,28
Jensen_Eisai_groupB,1,4,ts-global_detected_seizures,117866,117897,31
Jensen_Eisai_groupB,2,5,ts-global_detected_seizures,117881,118125,244
Jensen_Eisai_groupB,1,4,ts-global_detected_seizures,117911,117951,40
Jensen_Eisai_groupB,1,4,ts-global_detected_seizures,117982,118228,246
Jensen_Eisai_groupB,2,5,ts-global_detected_seizures,118157,118179,22
Jensen_Eisai_groupB,2,5,ts-global_detected_seizures,118221,118251,30
Jensen_Eisai_groupB,1,4,ts-global_detected_seizures,118229,118470,241
Jensen_Eisai_groupB,2,5,ts-global_detected_seizures,118253,118286,33
Jensen_Eisai_groupB,2,5,ts-global_detected_seizures,118321,118349,28
Jensen_Eisai_groupB,2,5,ts-global_detected_seizures,118354,118381,27
Jensen_Eisai_groupB,2,5,ts-global_detected_seizures,118406,118440,34
Jensen_Eisai_groupB,3,6,ts-global_detected_seizures,118426,118560,134
Jensen_Eisai_groupB,2,5,ts-global_detected_seizures,118452,118479,27
Jensen_Eisai_groupB,1,4,ts-global_detected_seizures,118479,118526,47
Jensen_Eisai_groupB,1,4,ts-global_detected_seizures,118528,120010,1482
Jensen_Eisai_groupB,2,5,ts-global_detected_seizures,118545,119576,1031
Jensen_Eisai_groupB,3,6,ts-global_detected_seizures,118612,128122,9510
Jensen_Eisai_groupB,2,5,ts-global_detected_seizures,119577,119830,253
Jensen_Eisai_groupB,2,5,ts-global_detected_seizures,119899,119922,23
Jensen_Eisai_groupB,2,5,ts-global_detected_seizures,119950,119986,36
Jensen_Eisai_groupB,1,4,ts-global_detected_seizures,120012,120056,44
Jensen_Eisai_groupB,2,5,ts-global_detected_seizures,120033,120058,25
Jensen_Eisai_groupB,1,4,ts-global_detected_seizures,120142,120199,57
Jensen_Eisai_groupB,2,5,ts-global_detected_seizures,120177,120207,30
Jensen_Eisai_groupB,1,4,ts-global_detected_seizures,120200,120314,114
Jensen_Eisai_groupB,2,5,ts-global_detected_seizures,120264,120290,26
Jensen_Eisai_groupB,2,5,ts-global_detected_seizures,120340,120364,24
Jensen_Eisai_groupB,1,4,ts-global_detected_seizures,120366,120410,44
Jensen_Eisai_groupB,2,5,ts-global_detected_seizures,120420,120443,23
Jensen_Eisai_groupB,1,4,ts-global_detected_seizures,120443,120479,36
Jensen_Eisai_groupB,1,4,ts-global_detected_seizures,120480,120503,23
Jensen_Eisai_groupB,1,4,ts-global_detected_seizures,120511,120571,60
Jensen_Eisai_groupB,2,5,ts-global_detected_seizures,120562,120637,75
Jensen_Eisai_groupB,1,4,ts-global_detected_seizures,120581,120628,47
Jensen_Eisai_groupB,1,4,ts-global_detected_seizures,120652,120685,33
Jensen_Eisai_groupB,2,5,ts-global_detected_seizures,120667,120694,27
Jensen_Eisai_groupB,1,4,ts-global_detected_seizures,120704,120838,134
Jensen_Eisai_groupB,1,4,ts-global_detected_seizures,120839,120861,22
Jensen_Eisai_groupB,2,5,ts-global_detected_seizures,120943,120971,28
Jensen_Eisai_groupB,1,4,ts-global_detected_seizures,120988,121066,78
Jensen_Eisai_groupB,2,5,ts-global_detected_seizures,120990,121020,30
Jensen_Eisai_groupB,2,5,ts-global_detected_seizures,121072,121126,54
Jensen_Eisai_groupB,1,4,ts-global_detected_seizures,121084,121137,53
Jensen_Eisai_groupB,2,5,ts-global_detected_seizures,121135,121167,32
Jensen_Eisai_groupB,1,4,ts-global_detected_seizures,121176,121226,50
Jensen_Eisai_groupB,2,5,ts-global_detected_seizures,121208,121231,23
Jensen_Eisai_groupB,1,4,ts-global_detected_seizures,121228,121287,59
Jensen_Eisai_groupB,1,4,ts-global_detected_seizures,121358,121384,26
Jensen_Eisai_groupB,2,5,ts-global_detected_seizures,121362,121386,24
Jensen_Eisai_groupB,1,4,ts-global_detected_seizures,121416,121443,27
Jensen_Eisai_groupB,2,5,ts-global_detected_seizures,121450,121472,22
Jensen_Eisai_groupB,1,4,ts-global_detected_seizures,121484,121680,196
Jensen_Eisai_groupB,2,5,ts-global_detected_seizures,121486,121517,31
Jensen_Eisai_groupB,2,5,ts-global_detected_seizures,121553,121599,46
Jensen_Eisai_groupB,2,5,ts-global_detected_seizures,121600,121625,25
Jensen_Eisai_groupB,2,5,ts-global_detected_seizures,121679,121704,25
Jensen_Eisai_groupB,1,4,ts-global_detected_seizures,121681,122546,865
Jensen_Eisai_groupB,2,5,ts-global_detected_seizures,121726,121768,42
Jensen_Eisai_groupB,2,5,ts-global_detected_seizures,121789,121814,25
Jensen_Eisai_groupB,2,5,ts-global_detected_seizures,121855,121883,28
Jensen_Eisai_groupB,2,5,ts-global_detected_seizures,121901,121934,33
Jensen_Eisai_groupB,2,5,ts-global_detected_seizures,121959,121984,25
Jensen_Eisai_groupB,2,5,ts-global_detected_seizures,122038,122087,49
Jensen_Eisai_groupB,2,5,ts-global_detected_seizures,122098,122549,451
Jensen_Eisai_groupB,1,4,ts-global_detected_seizures,122547,122584,37
Jensen_Eisai_groupB,2,5,ts-global_detected_seizures,122571,122595,24
Jensen_Eisai_groupB,2,5,ts-global_detected_seizures,122622,122652,30
Jensen_Eisai_groupB,2,5,ts-global_detected_seizures,122658,122692,34
Jensen_Eisai_groupB,1,4,ts-global_detected_seizures,122670,122730,60
Jensen_Eisai_groupB,2,5,ts-global_detected_seizures,122730,122814,84
Jensen_Eisai_groupB,1,4,ts-global_detected_seizures,122787,122839,52
Jensen_Eisai_groupB,2,5,ts-global_detected_seizures,122820,122847,27
Jensen_Eisai_groupB,1,4,ts-global_detected_seizures,122842,122868,26
Jensen_Eisai_groupB,2,5,ts-global_detected_seizures,122873,122908,35
Jensen_Eisai_groupB,1,4,ts-global_detected_seizures,122967,123125,158
Jensen_Eisai_groupB,2,5,ts-global_detected_seizures,122974,123001,27
Jensen_Eisai_groupB,2,5,ts-global_detected_seizures,123043,123115,72
Jensen_Eisai_groupB,2,5,ts-global_detected_seizures,123132,123161,29
Jensen_Eisai_groupB,2,5,ts-global_detected_seizures,123169,123191,22
Jensen_Eisai_groupB,1,4,ts-global_detected_seizures,123233,123395,162
Jensen_Eisai_groupB,2,5,ts-global_detected_seizures,123265,123291,26
Jensen_Eisai_groupB,2,5,ts-global_detected_seizures,123327,123351,24
Jensen_Eisai_groupB,1,4,ts-global_detected_seizures,123467,123525,58
Jensen_Eisai_groupB,2,5,ts-global_detected_seizures,123506,123538,32
Jensen_Eisai_groupB,1,4,ts-global_detected_seizures,123526,123579,53
Jensen_Eisai_groupB,1,4,ts-global_detected_seizures,123612,123645,33
Jensen_Eisai_groupB,2,5,ts-global_detected_seizures,123660,123691,31
Jensen_Eisai_groupB,1,4,ts-global_detected_seizures,123673,123712,39
Jensen_Eisai_groupB,1,4,ts-global_detected_seizures,123740,123768,28
Jensen_Eisai_groupB,1,4,ts-global_detected_seizures,123807,123843,36
Jensen_Eisai_groupB,2,5,ts-global_detected_seizures,123845,123931,86
Jensen_Eisai_groupB,1,4,ts-global_detected_seizures,123846,123922,76
Jensen_Eisai_groupB,1,4,ts-global_detected_seizures,123925,123965,40
Jensen_Eisai_groupB,2,5,ts-global_detected_seizures,123936,123977,41
Jensen_Eisai_groupB,2,5,ts-global_detected_seizures,123985,124007,22
Jensen_Eisai_groupB,1,4,ts-global_detected_seizures,124011,124047,36
Jensen_Eisai_groupB,2,5,ts-global_detected_seizures,124086,124118,32
Jensen_Eisai_groupB,1,4,ts-global_detected_seizures,124116,124154,38
Jensen_Eisai_groupB,2,5,ts-global_detected_seizures,124144,124183,39
Jensen_Eisai_groupB,1,4,ts-global_detected_seizures,124202,124369,167
Jensen_Eisai_groupB,2,5,ts-global_detected_seizures,124223,124252,29
Jensen_Eisai_groupB,2,5,ts-global_detected_seizures,124283,124307,24
Jensen_Eisai_groupB,2,5,ts-global_detected_seizures,124336,124359,23
Jensen_Eisai_groupB,2,5,ts-global_detected_seizures,124369,124400,31
Jensen_Eisai_groupB,1,4,ts-global_detected_seizures,124384,124450,66
Jensen_Eisai_groupB,2,5,ts-global_detected_seizures,124424,124494,70
Jensen_Eisai_groupB,1,4,ts-global_detected_seizures,124451,124590,139
Jensen_Eisai_groupB,2,5,ts-global_detected_seizures,124499,124539,40
Jensen_Eisai_groupB,2,5,ts-global_detected_seizures,124579,124604,25
Jensen_Eisai_groupB,1,4,ts-global_detected_seizures,124591,125084,493
Jensen_Eisai_groupB,2,5,ts-global_detected_seizures,124615,124742,127
Jensen_Eisai_groupB,2,5,ts-global_detected_seizures,124744,124827,83
Jensen_Eisai_groupB,2,5,ts-global_detected_seizures,124884,124907,23
Jensen_Eisai_groupB,2,5,ts-global_detected_seizures,124930,124956,26
Jensen_Eisai_groupB,2,5,ts-global_detected_seizures,124991,125024,33
Jensen_Eisai_groupB,2,5,ts-global_detected_seizures,125184,125209,25
Jensen_Eisai_groupB,2,5,ts-global_detected_seizures,125210,125232,22
Jensen_Eisai_groupB,1,4,ts-global_detected_seizures,125212,125251,39
Jensen_Eisai_groupB,2,5,ts-global_detected_seizures,125278,126080,802
Jensen_Eisai_groupB,1,4,ts-global_detected_seizures,125283,125313,30
Jensen_Eisai_groupB,1,4,ts-global_detected_seizures,125330,125361,31
Jensen_Eisai_groupB,1,4,ts-global_detected_seizures,125362,125390,28
Jensen_Eisai_groupB,1,4,ts-global_detected_seizures,125410,125462,52
Jensen_Eisai_groupB,1,4,ts-global_detected_seizures,125480,125505,25
Jensen_Eisai_groupB,1,4,ts-global_detected_seizures,125538,125561,23
Jensen_Eisai_groupB,1,4,ts-global_detected_seizures,125630,125682,52
Jensen_Eisai_groupB,1,4,ts-global_detected_seizures,125706,125733,27
Jensen_Eisai_groupB,1,4,ts-global_detected_seizures,125763,125798,35
Jensen_Eisai_groupB,1,4,ts-global_detected_seizures,125829,125859,30
Jensen_Eisai_groupB,1,4,ts-global_detected_seizures,125872,125897,25
Jensen_Eisai_groupB,1,4,ts-global_detected_seizures,125898,125937,39
Jensen_Eisai_groupB,1,4,ts-global_detected_seizures,125951,125990,39
Jensen_Eisai_groupB,1,4,ts-global_detected_seizures,126029,126055,26
Jensen_Eisai_groupB,1,4,ts-global_detected_seizures,126056,126142,86
Jensen_Eisai_groupB,2,5,ts-global_detected_seizures,126082,126125,43
Jensen_Eisai_groupB,2,5,ts-global_detected_seizures,126147,126172,25
Jensen_Eisai_groupB,1,4,ts-global_detected_seizures,126152,126197,45
Jensen_Eisai_groupB,1,4,ts-global_detected_seizures,126220,126264,44
Jensen_Eisai_groupB,2,5,ts-global_detected_seizures,126268,126290,22
Jensen_Eisai_groupB,1,4,ts-global_detected_seizures,126311,126340,29
Jensen_Eisai_groupB,1,4,ts-global_detected_seizures,126357,126977,620
Jensen_Eisai_groupB,2,5,ts-global_detected_seizures,126374,126401,27
Jensen_Eisai_groupB,2,5,ts-global_detected_seizures,126472,126496,24
Jensen_Eisai_groupB,2,5,ts-global_detected_seizures,126634,126659,25
Jensen_Eisai_groupB,2,5,ts-global_detected_seizures,126728,126758,30
Jensen_Eisai_groupB,2,5,ts-global_detected_seizures,126878,126900,22
Jensen_Eisai_groupB,1,4,ts-global_detected_seizures,126980,127015,35
Jensen_Eisai_groupB,2,5,ts-global_detected_seizures,126993,127019,26
Jensen_Eisai_groupB,1,4,ts-global_detected_seizures,127026,127062,36
Jensen_Eisai_groupB,2,5,ts-global_detected_seizures,127032,127077,45
Jensen_Eisai_groupB,1,4,ts-global_detected_seizures,127101,127158,57
Jensen_Eisai_groupB,2,5,ts-global_detected_seizures,127205,127502,297
Jensen_Eisai_groupB,1,4,ts-global_detected_seizures,127277,127301,24
Jensen_Eisai_groupB,1,4,ts-global_detected_seizures,127346,127373,27
Jensen_Eisai_groupB,1,4,ts-global_detected_seizures,127397,127428,31
Jensen_Eisai_groupB,2,5,ts-global_detected_seizures,127503,127579,76
Jensen_Eisai_groupB,1,4,ts-global_detected_seizures,127527,127551,24
Jensen_Eisai_groupB,1,4,ts-global_detected_seizures,127566,127597,31
Jensen_Eisai_groupB,2,5,ts-global_detected_seizures,127586,127611,25
Jensen_Eisai_groupB,1,4,ts-global_detected_seizures,127618,127795,177
Jensen_Eisai_groupB,2,5,ts-global_detected_seizures,127658,127682,24
Jensen_Eisai_groupB,2,5,ts-global_detected_seizures,127740,127765,25
Jensen_Eisai_groupB,2,5,ts-global_detected_seizures,127773,127796,23
Jensen_Eisai_groupB,1,4,ts-global_detected_seizures,127800,127999,199
Jensen_Eisai_groupB,2,5,ts-global_detected_seizures,127810,127862,52
Jensen_Eisai_groupB,2,5,ts-global_detected_seizures,127884,127931,47
Jensen_Eisai_groupB,2,5,ts-global_detected_seizures,127958,128243,285
Jensen_Eisai_groupB,1,4,ts-global_detected_seizures,128003,128025,22
Jensen_Eisai_groupB,1,4,ts-global_detected_seizures,128049,128088,39
Jensen_Eisai_groupB,1,4,ts-global_detected_seizures,128090,128181,91
Jensen_Eisai_groupB,3,6,ts-global_detected_seizures,128142,148370,20228
Jensen_Eisai_groupB,1,4,ts-global_detected_seizures,128183,128209,26
Jensen_Eisai_groupB,1,4,ts-global_detected_seizures,128210,128985,775
Jensen_Eisai_groupB,2,5,ts-global_detected_seizures,128288,131441,3153
Jensen_Eisai_groupB,1,4,ts-global_detected_seizures,128986,130916,1930
Jensen_Eisai_groupB,1,4,ts-global_detected_seizures,130917,130949,32
Jensen_Eisai_groupB,1,4,ts-global_detected_seizures,130950,131883,933
Jensen_Eisai_groupB,2,5,ts-global_detected_seizures,131442,131653,211
Jensen_Eisai_groupB,2,5,ts-global_detected_seizures,131654,131889,235
Jensen_Eisai_groupB,1,4,ts-global_detected_seizures,131884,132043,159
Jensen_Eisai_groupB,2,5,ts-global_detected_seizures,131890,132519,629
Jensen_Eisai_groupB,1,4,ts-global_detected_seizures,132044,135773,3729
Jensen_Eisai_groupB,2,5,ts-global_detected_seizures,132520,132983,463
Jensen_Eisai_groupB,2,5,ts-global_detected_seizures,132992,133519,527
Jensen_Eisai_groupB,2,5,ts-global_detected_seizures,133520,133652,132
Jensen_Eisai_groupB,2,5,ts-global_detected_seizures,133662,133698,36
Jensen_Eisai_groupB,2,5,ts-global_detected_seizures,133699,133852,153
Jensen_Eisai_groupB,2,5,ts-global_detected_seizures,133869,133899,30
Jensen_Eisai_groupB,2,5,ts-global_detected_seizures,133900,134046,146
Jensen_Eisai_groupB,2,5,ts-global_detected_seizures,134047,134481,434
Jensen_Eisai_groupB,2,5,ts-global_detected_seizures,134482,134620,138
Jensen_Eisai_groupB,2,5,ts-global_detected_seizures,134621,134861,240
Jensen_Eisai_groupB,2,5,ts-global_detected_seizures,134862,134972,110
Jensen_Eisai_groupB,2,5,ts-global_detected_seizures,134973,135064,91
Jensen_Eisai_groupB,2,5,ts-global_detected_seizures,135069,135096,27
Jensen_Eisai_groupB,2,5,ts-global_detected_seizures,135097,135201,104
Jensen_Eisai_groupB,2,5,ts-global_detected_seizures,135221,135324,103
Jensen_Eisai_groupB,2,5,ts-global_detected_seizures,135333,135434,101
Jensen_Eisai_groupB,2,5,ts-global_detected_seizures,135439,135476,37
Jensen_Eisai_groupB,2,5,ts-global_detected_seizures,135477,135612,135
Jensen_Eisai_groupB,2,5,ts-global_detected_seizures,135623,135669,46
Jensen_Eisai_groupB,2,5,ts-global_detected_seizures,135670,135706,36
Jensen_Eisai_groupB,2,5,ts-global_detected_seizures,135722,135989,267
Jensen_Eisai_groupB,1,4,ts-global_detected_seizures,135774,136202,428
Jensen_Eisai_groupB,2,5,ts-global_detected_seizures,136010,136344,334
Jensen_Eisai_groupB,1,4,ts-global_detected_seizures,136203,137155,952
Jensen_Eisai_groupB,2,5,ts-global_detected_seizures,136354,136418,64
Jensen_Eisai_groupB,2,5,ts-global_detected_seizures,136419,136461,42
Jensen_Eisai_groupB,2,5,ts-global_detected_seizures,136462,136564,102
Jensen_Eisai_groupB,2,5,ts-global_detected_seizures,136573,136605,32
Jensen_Eisai_groupB,2,5,ts-global_detected_seizures,136606,136676,70
Jensen_Eisai_groupB,2,5,ts-global_detected_seizures,136677,136725,48
Jensen_Eisai_groupB,2,5,ts-global_detected_seizures,136790,136849,59
Jensen_Eisai_groupB,2,5,ts-global_detected_seizures,136870,136941,71
Jensen_Eisai_groupB,2,5,ts-global_detected_seizures,136942,136986,44
Jensen_Eisai_groupB,2,5,ts-global_detected_seizures,137023,137479,456
Jensen_Eisai_groupB,1,4,ts-global_detected_seizures,137173,137862,689
Jensen_Eisai_groupB,2,5,ts-global_detected_seizures,137481,137551,70
Jensen_Eisai_groupB,2,5,ts-global_detected_seizures,137555,137626,71
Jensen_Eisai_groupB,2,5,ts-global_detected_seizures,137646,137672,26
Jensen_Eisai_groupB,2,5,ts-global_detected_seizures,137720,137800,80
Jensen_Eisai_groupB,1,4,ts-global_detected_seizures,137863,138295,432
Jensen_Eisai_groupB,2,5,ts-global_detected_seizures,137870,137895,25
Jensen_Eisai_groupB,2,5,ts-global_detected_seizures,137905,138009,104
Jensen_Eisai_groupB,2,5,ts-global_detected_seizures,138027,138067,40
Jensen_Eisai_groupB,2,5,ts-global_detected_seizures,138085,138120,35
Jensen_Eisai_groupB,2,5,ts-global_detected_seizures,138163,138223,60
Jensen_Eisai_groupB,2,5,ts-global_detected_seizures,138234,138287,53
Jensen_Eisai_groupB,2,5,ts-global_detected_seizures,138295,138330,35
Jensen_Eisai_groupB,1,4,ts-global_detected_seizures,138296,138628,332
Jensen_Eisai_groupB,2,5,ts-global_detected_seizures,138338,138379,41
Jensen_Eisai_groupB,2,5,ts-global_detected_seizures,138446,138498,52
Jensen_Eisai_groupB,2,5,ts-global_detected_seizures,138521,138563,42
Jensen_Eisai_groupB,2,5,ts-global_detected_seizures,138572,138631,59
Jensen_Eisai_groupB,1,4,ts-global_detected_seizures,138648,138728,80
Jensen_Eisai_groupB,2,5,ts-global_detected_seizures,138657,139682,1025
Jensen_Eisai_groupB,1,4,ts-global_detected_seizures,138729,138770,41
Jensen_Eisai_groupB,1,4,ts-global_detected_seizures,138771,138950,179
Jensen_Eisai_groupB,1,4,ts-global_detected_seizures,138951,140373,1422
Jensen_Eisai_groupB,2,5,ts-global_detected_seizures,139683,139829,146
Jensen_Eisai_groupB,2,5,ts-global_detected_seizures,139830,139906,76
Jensen_Eisai_groupB,2,5,ts-global_detected_seizures,139935,139958,23
Jensen_Eisai_groupB,2,5,ts-global_detected_seizures,139970,140031,61
Jensen_Eisai_groupB,2,5,ts-global_detected_seizures,140059,140129,70
Jensen_Eisai_groupB,2,5,ts-global_detected_seizures,140146,140173,27
Jensen_Eisai_groupB,2,5,ts-global_detected_seizures,140174,140205,31
Jensen_Eisai_groupB,2,5,ts-global_detected_seizures,140213,140236,23
Jensen_Eisai_groupB,2,5,ts-global_detected_seizures,140277,140338,61
Jensen_Eisai_groupB,1,4,ts-global_detected_seizures,140396,140420,24
Jensen_Eisai_groupB,2,5,ts-global_detected_seizures,140420,140444,24
Jensen_Eisai_groupB,1,4,ts-global_detected_seizures,140421,140472,51
Jensen_Eisai_groupB,2,5,ts-global_detected_seizures,140456,140479,23
Jensen_Eisai_groupB,1,4,ts-global_detected_seizures,140473,141293,820
Jensen_Eisai_groupB,2,5,ts-global_detected_seizures,140500,140526,26
Jensen_Eisai_groupB,2,5,ts-global_detected_seizures,140539,140562,23
Jensen_Eisai_groupB,2,5,ts-global_detected_seizures,140571,140593,22
Jensen_Eisai_groupB,2,5,ts-global_detected_seizures,140619,140643,24
Jensen_Eisai_groupB,2,5,ts-global_detected_seizures,140683,140708,25
Jensen_Eisai_groupB,2,5,ts-global_detected_seizures,140731,141366,635
Jensen_Eisai_groupB,1,4,ts-global_detected_seizures,141294,141522,228
Jensen_Eisai_groupB,2,5,ts-global_detected_seizures,141382,141532,150
Jensen_Eisai_groupB,1,4,ts-global_detected_seizures,141523,141758,235
Jensen_Eisai_groupB,2,5,ts-global_detected_seizures,141533,141732,199
Jensen_Eisai_groupB,2,5,ts-global_detected_seizures,141733,141757,24
Jensen_Eisai_groupB,1,4,ts-global_detected_seizures,141759,142121,362
Jensen_Eisai_groupB,2,5,ts-global_detected_seizures,141767,141798,31
Jensen_Eisai_groupB,2,5,ts-global_detected_seizures,141805,141999,194
Jensen_Eisai_groupB,2,5,ts-global_detected_seizures,142000,142034,34
Jensen_Eisai_groupB,2,5,ts-global_detected_seizures,142043,142096,53
Jensen_Eisai_groupB,2,5,ts-global_detected_seizures,142097,142121,24
Jensen_Eisai_groupB,1,4,ts-global_detected_seizures,142122,142839,717
Jensen_Eisai_groupB,2,5,ts-global_detected_seizures,142155,142259,104
Jensen_Eisai_groupB,2,5,ts-global_detected_seizures,142272,142751,479
Jensen_Eisai_groupB,2,5,ts-global_detected_seizures,142758,142921,163
Jensen_Eisai_groupB,1,4,ts-global_detected_seizures,142840,143188,348
Jensen_Eisai_groupB,2,5,ts-global_detected_seizures,142922,143006,84
Jensen_Eisai_groupB,2,5,ts-global_detected_seizures,143057,143088,31
Jensen_Eisai_groupB,2,5,ts-global_detected_seizures,143102,143140,38
Jensen_Eisai_groupB,1,4,ts-global_detected_seizures,143203,143436,233
Jensen_Eisai_groupB,2,5,ts-global_detected_seizures,143242,143290,48
Jensen_Eisai_groupB,2,5,ts-global_detected_seizures,143242,143290,48
Jensen_Eisai_groupB,2,5,ts-global_detected_seizures,143362,143390,28
Jensen_Eisai_groupB,2,5,ts-global_detected_seizures,143426,143448,22
Jensen_Eisai_groupB,1,4,ts-global_detected_seizures,143455,143480,25
Jensen_Eisai_groupB,2,5,ts-global_detected_seizures,143481,143503,22
Jensen_Eisai_groupB,1,4,ts-global_detected_seizures,143606,143957,351
Jensen_Eisai_groupB,2,5,ts-global_detected_seizures,143642,143671,29
Jensen_Eisai_groupB,2,5,ts-global_detected_seizures,143693,143719,26
Jensen_Eisai_groupB,2,5,ts-global_detected_seizures,143798,143831,33
Jensen_Eisai_groupB,2,5,ts-global_detected_seizures,143862,143897,35
Jensen_Eisai_groupB,2,5,ts-global_detected_seizures,143907,144363,456
Jensen_Eisai_groupB,1,4,ts-global_detected_seizures,144266,144292,26
Jensen_Eisai_groupB,2,5,ts-global_detected_seizures,144373,144404,31
Jensen_Eisai_groupB,1,4,ts-global_detected_seizures,144390,144418,28
Jensen_Eisai_groupB,2,5,ts-global_detected_seizures,144407,144548,141
Jensen_Eisai_groupB,1,4,ts-global_detected_seizures,144537,144560,23
Jensen_Eisai_groupB,2,5,ts-global_detected_seizures,144555,144745,190
Jensen_Eisai_groupB,2,5,ts-global_detected_seizures,144758,144831,73
Jensen_Eisai_groupB,2,5,ts-global_detected_seizures,144894,145084,190
Jensen_Eisai_groupB,1,4,ts-global_detected_seizures,144910,144933,23
Jensen_Eisai_groupB,2,5,ts-global_detected_seizures,145111,145205,94
Jensen_Eisai_groupB,1,4,ts-global_detected_seizures,145139,145174,35
Jensen_Eisai_groupB,1,4,ts-global_detected_seizures,145192,145247,55
Jensen_Eisai_groupB,2,5,ts-global_detected_seizures,145242,145276,34
Jensen_Eisai_groupB,2,5,ts-global_detected_seizures,145318,145514,196
Jensen_Eisai_groupB,1,4,ts-global_detected_seizures,145433,145456,23
Jensen_Eisai_groupB,2,5,ts-global_detected_seizures,145515,145557,42
Jensen_Eisai_groupB,1,4,ts-global_detected_seizures,145567,145639,72
Jensen_Eisai_groupB,2,5,ts-global_detected_seizures,145620,145647,27
Jensen_Eisai_groupB,2,5,ts-global_detected_seizures,145648,145700,52
Jensen_Eisai_groupB,2,5,ts-global_detected_seizures,145789,145968,179
Jensen_Eisai_groupB,1,4,ts-global_detected_seizures,145806,145979,173
Jensen_Eisai_groupB,2,5,ts-global_detected_seizures,145990,146020,30
Jensen_Eisai_groupB,1,4,ts-global_detected_seizures,146070,146093,23
Jensen_Eisai_groupB,2,5,ts-global_detected_seizures,146083,146118,35
Jensen_Eisai_groupB,2,5,ts-global_detected_seizures,146144,146182,38
Jensen_Eisai_groupB,2,5,ts-global_detected_seizures,146304,146334,30
Jensen_Eisai_groupB,1,4,ts-global_detected_seizures,146334,146366,32
Jensen_Eisai_groupB,2,5,ts-global_detected_seizures,146364,146386,22
Jensen_Eisai_groupB,1,4,ts-global_detected_seizures,146474,146526,52
Jensen_Eisai_groupB,2,5,ts-global_detected_seizures,146518,146542,24
Jensen_Eisai_groupB,2,5,ts-global_detected_seizures,146584,146606,22
Jensen_Eisai_groupB,1,4,ts-global_detected_seizures,146612,147386,774
Jensen_Eisai_groupB,2,5,ts-global_detected_seizures,146665,146691,26
Jensen_Eisai_groupB,2,5,ts-global_detected_seizures,146743,146765,22
Jensen_Eisai_groupB,2,5,ts-global_detected_seizures,146807,146851,44
Jensen_Eisai_groupB,2,5,ts-global_detected_seizures,147010,147049,39
Jensen_Eisai_groupB,2,5,ts-global_detected_seizures,147069,147091,22
Jensen_Eisai_groupB,2,5,ts-global_detected_seizures,147172,147216,44
Jensen_Eisai_groupB,2,5,ts-global_detected_seizures,147250,147284,34
Jensen_Eisai_groupB,1,4,ts-global_detected_seizures,147387,148914,1527
Jensen_Eisai_groupB,2,5,ts-global_detected_seizures,147406,147476,70
Jensen_Eisai_groupB,2,5,ts-global_detected_seizures,147532,147593,61
Jensen_Eisai_groupB,2,5,ts-global_detected_seizures,147598,147621,23
Jensen_Eisai_groupB,2,5,ts-global_detected_seizures,147623,147773,150
Jensen_Eisai_groupB,2,5,ts-global_detected_seizures,147774,148436,662
Jensen_Eisai_groupB,3,6,ts-global_detected_seizures,148371,148479,108
Jensen_Eisai_groupB,2,5,ts-global_detected_seizures,148437,148536,99
Jensen_Eisai_groupB,3,6,ts-global_detected_seizures,148480,148507,27
Jensen_Eisai_groupB,3,6,ts-global_detected_seizures,148508,151365,2857
Jensen_Eisai_groupB,2,5,ts-global_detected_seizures,148542,148601,59
Jensen_Eisai_groupB,2,5,ts-global_detected_seizures,148602,148629,27
Jensen_Eisai_groupB,2,5,ts-global_detected_seizures,148664,148889,225
Jensen_Eisai_groupB,2,5,ts-global_detected_seizures,148897,148983,86
Jensen_Eisai_groupB,1,4,ts-global_detected_seizures,148915,149040,125
Jensen_Eisai_groupB,2,5,ts-global_detected_seizures,149036,149230,194
Jensen_Eisai_groupB,1,4,ts-global_detected_seizures,149041,149751,710
Jensen_Eisai_groupB,2,5,ts-global_detected_seizures,149246,149344,98
Jensen_Eisai_groupB,2,5,ts-global_detected_seizures,149350,149423,73
Jensen_Eisai_groupB,2,5,ts-global_detected_seizures,149431,149476,45
Jensen_Eisai_groupB,2,5,ts-global_detected_seizures,149584,149612,28
Jensen_Eisai_groupB,2,5,ts-global_detected_seizures,149652,149686,34
Jensen_Eisai_groupB,2,5,ts-global_detected_seizures,149698,149744,46
Jensen_Eisai_groupB,1,4,ts-global_detected_seizures,149753,150880,1127
Jensen_Eisai_groupB,2,5,ts-global_detected_seizures,149814,149837,23
Jensen_Eisai_groupB,2,5,ts-global_detected_seizures,149880,149908,28
Jensen_Eisai_groupB,2,5,ts-global_detected_seizures,149986,150015,29
Jensen_Eisai_groupB,2,5,ts-global_detected_seizures,150159,150198,39
Jensen_Eisai_groupB,2,5,ts-global_detected_seizures,150218,150240,22
Jensen_Eisai_groupB,2,5,ts-global_detected_seizures,150326,150356,30
Jensen_Eisai_groupB,2,5,ts-global_detected_seizures,150474,150505,31
Jensen_Eisai_groupB,2,5,ts-global_detected_seizures,150578,150617,39
Jensen_Eisai_groupB,2,5,ts-global_detected_seizures,150737,150762,25
Jensen_Eisai_groupB,2,5,ts-global_detected_seizures,150763,150787,24
Jensen_Eisai_groupB,2,5,ts-global_detected_seizures,150788,150820,32
Jensen_Eisai_groupB,2,5,ts-global_detected_seizures,150835,150859,24
Jensen_Eisai_groupB,1,4,ts-global_detected_seizures,150881,151396,515
Jensen_Eisai_groupB,2,5,ts-global_detected_seizures,150924,150961,37
Jensen_Eisai_groupB,2,5,ts-global_detected_seizures,151138,151171,33
Jensen_Eisai_groupB,2,5,ts-global_detected_seizures,151321,151345,24
Jensen_Eisai_groupB,3,6,ts-global_detected_seizures,151366,157507,6141
Jensen_Eisai_groupB,2,5,ts-global_detected_seizures,151396,151422,26
Jensen_Eisai_groupB,1,4,ts-global_detected_seizures,151397,153496,2099
Jensen_Eisai_groupB,2,5,ts-global_detected_seizures,151441,151608,167
Jensen_Eisai_groupB,2,5,ts-global_detected_seizures,151609,151631,22
Jensen_Eisai_groupB,2,5,ts-global_detected_seizures,151646,152348,702
Jensen_Eisai_groupB,2,5,ts-global_detected_seizures,152419,152447,28
Jensen_Eisai_groupB,2,5,ts-global_detected_seizures,152472,152501,29
Jensen_Eisai_groupB,2,5,ts-global_detected_seizures,152530,152578,48
Jensen_Eisai_groupB,2,5,ts-global_detected_seizures,152583,152613,30
Jensen_Eisai_groupB,2,5,ts-global_detected_seizures,152624,152650,26
Jensen_Eisai_groupB,2,5,ts-global_detected_seizures,152703,152752,49
Jensen_Eisai_groupB,2,5,ts-global_detected_seizures,152819,152848,29
Jensen_Eisai_groupB,2,5,ts-global_detected_seizures,152882,152904,22
Jensen_Eisai_groupB,2,5,ts-global_detected_seizures,152929,152951,22
Jensen_Eisai_groupB,2,5,ts-global_detected_seizures,152987,153028,41
Jensen_Eisai_groupB,2,5,ts-global_detected_seizures,153071,153117,46
Jensen_Eisai_groupB,2,5,ts-global_detected_seizures,153139,153181,42
Jensen_Eisai_groupB,2,5,ts-global_detected_seizures,153266,153289,23
Jensen_Eisai_groupB,2,5,ts-global_detected_seizures,153423,153807,384
Jensen_Eisai_groupB,1,4,ts-global_detected_seizures,153497,153545,48
Jensen_Eisai_groupB,1,4,ts-global_detected_seizures,153546,156744,3198
Jensen_Eisai_groupB,2,5,ts-global_detected_seizures,153837,153873,36
Jensen_Eisai_groupB,2,5,ts-global_detected_seizures,153902,153942,40
Jensen_Eisai_groupB,2,5,ts-global_detected_seizures,153947,154120,173
Jensen_Eisai_groupB,2,5,ts-global_detected_seizures,154122,154215,93
Jensen_Eisai_groupB,2,5,ts-global_detected_seizures,154303,154471,168
Jensen_Eisai_groupB,2,5,ts-global_detected_seizures,154472,154501,29
Jensen_Eisai_groupB,2,5,ts-global_detected_seizures,154536,154945,409
Jensen_Eisai_groupB,2,5,ts-global_detected_seizures,154946,155004,58
Jensen_Eisai_groupB,2,5,ts-global_detected_seizures,155062,155087,25
Jensen_Eisai_groupB,2,5,ts-global_detected_seizures,155120,155142,22
Jensen_Eisai_groupB,2,5,ts-global_detected_seizures,155160,155188,28
Jensen_Eisai_groupB,2,5,ts-global_detected_seizures,155407,155436,29
Jensen_Eisai_groupB,2,5,ts-global_detected_seizures,155541,155571,30
Jensen_Eisai_groupB,2,5,ts-global_detected_seizures,155807,155836,29
Jensen_Eisai_groupB,2,5,ts-global_detected_seizures,155864,155890,26
Jensen_Eisai_groupB,2,5,ts-global_detected_seizures,155912,155937,25
Jensen_Eisai_groupB,2,5,ts-global_detected_seizures,156007,156043,36
Jensen_Eisai_groupB,2,5,ts-global_detected_seizures,156121,156210,89
Jensen_Eisai_groupB,2,5,ts-global_detected_seizures,156237,156370,133
Jensen_Eisai_groupB,2,5,ts-global_detected_seizures,156416,156443,27
Jensen_Eisai_groupB,2,5,ts-global_detected_seizures,156519,156562,43
Jensen_Eisai_groupB,2,5,ts-global_detected_seizures,156563,157654,1091
Jensen_Eisai_groupB,1,4,ts-global_detected_seizures,156759,156782,23
Jensen_Eisai_groupB,1,4,ts-global_detected_seizures,156783,157249,466
Jensen_Eisai_groupB,1,4,ts-global_detected_seizures,157286,157320,34
Jensen_Eisai_groupB,1,4,ts-global_detected_seizures,157321,157442,121
Jensen_Eisai_groupB,1,4,ts-global_detected_seizures,157443,158467,1024
Jensen_Eisai_groupB,3,6,ts-global_detected_seizures,157508,157577,69
Jensen_Eisai_groupB,3,6,ts-global_detected_seizures,157578,158487,909
Jensen_Eisai_groupB,2,5,ts-global_detected_seizures,157655,157794,139
Jensen_Eisai_groupB,2,5,ts-global_detected_seizures,157795,157943,148
Jensen_Eisai_groupB,2,5,ts-global_detected_seizures,157968,157995,27
Jensen_Eisai_groupB,2,5,ts-global_detected_seizures,158003,158029,26
Jensen_Eisai_groupB,2,5,ts-global_detected_seizures,158115,158139,24
Jensen_Eisai_groupB,2,5,ts-global_detected_seizures,158147,158174,27
Jensen_Eisai_groupB,2,5,ts-global_detected_seizures,158198,158225,27
Jensen_Eisai_groupB,2,5,ts-global_detected_seizures,158329,158352,23
Jensen_Eisai_groupB,2,5,ts-global_detected_seizures,158477,158505,28
Jensen_Eisai_groupB,3,6,ts-global_detected_seizures,158488,158519,31
Jensen_Eisai_groupB,1,4,ts-global_detected_seizures,158518,158811,293
Jensen_Eisai_groupB,3,6,ts-global_detected_seizures,158520,158579,59
Jensen_Eisai_groupB,2,5,ts-global_detected_seizures,158571,158610,39
Jensen_Eisai_groupB,3,6,ts-global_detected_seizures,158601,158877,276
Jensen_Eisai_groupB,2,5,ts-global_detected_seizures,158683,158709,26
Jensen_Eisai_groupB,2,5,ts-global_detected_seizures,158737,158779,42
Jensen_Eisai_groupB,1,4,ts-global_detected_seizures,158814,158992,178
Jensen_Eisai_groupB,3,6,ts-global_detected_seizures,158878,160149,1271
Jensen_Eisai_groupB,2,5,ts-global_detected_seizures,158991,159019,28
Jensen_Eisai_groupB,2,5,ts-global_detected_seizures,159029,159052,23
Jensen_Eisai_groupB,1,4,ts-global_detected_seizures,159054,159082,28
Jensen_Eisai_groupB,2,5,ts-global_detected_seizures,159078,159100,22
Jensen_Eisai_groupB,1,4,ts-global_detected_seizures,159092,159141,49
Jensen_Eisai_groupB,2,5,ts-global_detected_seizures,159119,159143,24
Jensen_Eisai_groupB,2,5,ts-global_detected_seizures,159174,159276,102
Jensen_Eisai_groupB,2,5,ts-global_detected_seizures,159277,159375,98
Jensen_Eisai_groupB,1,4,ts-global_detected_seizures,159299,159777,478
Jensen_Eisai_groupB,2,5,ts-global_detected_seizures,159376,159420,44
Jensen_Eisai_groupB,2,5,ts-global_detected_seizures,159421,159542,121
Jensen_Eisai_groupB,2,5,ts-global_detected_seizures,159543,159658,115
Jensen_Eisai_groupB,2,5,ts-global_detected_seizures,159659,159733,74
Jensen_Eisai_groupB,2,5,ts-global_detected_seizures,159737,159769,32
Jensen_Eisai_groupB,2,5,ts-global_detected_seizures,159773,160625,852
Jensen_Eisai_groupB,3,6,ts-global_detected_seizures,160150,160373,223
Jensen_Eisai_groupB,1,4,ts-global_detected_seizures,160254,160283,29
Jensen_Eisai_groupB,1,4,ts-global_detected_seizures,160295,160324,29
Jensen_Eisai_groupB,3,6,ts-global_detected_seizures,160374,160443,69
Jensen_Eisai_groupB,3,6,ts-global_detected_seizures,160444,160546,102
Jensen_Eisai_groupB,3,6,ts-global_detected_seizures,160547,162389,1842
Jensen_Eisai_groupB,2,5,ts-global_detected_seizures,160626,160697,71
Jensen_Eisai_groupB,1,4,ts-global_detected_seizures,160666,160690,24
Jensen_Eisai_groupB,2,5,ts-global_detected_seizures,160698,161159,461
Jensen_Eisai_groupB,1,4,ts-global_detected_seizures,160877,160902,25
Jensen_Eisai_groupB,1,4,ts-global_detected_seizures,161036,161069,33
Jensen_Eisai_groupB,1,4,ts-global_detected_seizures,161109,161132,23
Jensen_Eisai_groupB,2,5,ts-global_detected_seizures,161177,161225,48
Jensen_Eisai_groupB,1,4,ts-global_detected_seizures,161225,161348,123
Jensen_Eisai_groupB,2,5,ts-global_detected_seizures,161243,161273,30
Jensen_Eisai_groupB,2,5,ts-global_detected_seizures,161282,161307,25
Jensen_Eisai_groupB,2,5,ts-global_detected_seizures,161341,161365,24
Jensen_Eisai_groupB,1,4,ts-global_detected_seizures,161376,161401,25
Jensen_Eisai_groupB,1,4,ts-global_detected_seizures,161434,161463,29
Jensen_Eisai_groupB,2,5,ts-global_detected_seizures,161493,161518,25
Jensen_Eisai_groupB,1,4,ts-global_detected_seizures,161540,161562,22
Jensen_Eisai_groupB,1,4,ts-global_detected_seizures,161564,161594,30
Jensen_Eisai_groupB,2,5,ts-global_detected_seizures,161635,161671,36
Jensen_Eisai_groupB,1,4,ts-global_detected_seizures,161678,161710,32
Jensen_Eisai_groupB,2,5,ts-global_detected_seizures,161748,161782,34
Jensen_Eisai_groupB,1,4,ts-global_detected_seizures,161754,161778,24
Jensen_Eisai_groupB,1,4,ts-global_detected_seizures,161796,161828,32
Jensen_Eisai_groupB,2,5,ts-global_detected_seizures,161813,162172,359
Jensen_Eisai_groupB,1,4,ts-global_detected_seizures,161851,161873,22
Jensen_Eisai_groupB,1,4,ts-global_detected_seizures,161900,161926,26
Jensen_Eisai_groupB,1,4,ts-global_detected_seizures,161987,162062,75
Jensen_Eisai_groupB,2,5,ts-global_detected_seizures,162195,162228,33
Jensen_Eisai_groupB,1,4,ts-global_detected_seizures,162201,162240,39
Jensen_Eisai_groupB,2,5,ts-global_detected_seizures,162281,162339,58
Jensen_Eisai_groupB,1,4,ts-global_detected_seizures,162333,162371,38
Jensen_Eisai_groupB,2,5,ts-global_detected_seizures,162348,162398,50
Jensen_Eisai_groupB,1,4,ts-global_detected_seizures,162372,162463,91
Jensen_Eisai_groupB,3,6,ts-global_detected_seizures,162390,165833,3443
Jensen_Eisai_groupB,2,5,ts-global_detected_seizures,162410,162483,73
Jensen_Eisai_groupB,1,4,ts-global_detected_seizures,162464,162503,39
Jensen_Eisai_groupB,2,5,ts-global_detected_seizures,162497,162919,422
Jensen_Eisai_groupB,1,4,ts-global_detected_seizures,162544,162611,67
Jensen_Eisai_groupB,1,4,ts-global_detected_seizures,162624,162672,48
Jensen_Eisai_groupB,1,4,ts-global_detected_seizures,162693,162726,33
Jensen_Eisai_groupB,1,4,ts-global_detected_seizures,162806,162831,25
Jensen_Eisai_groupB,1,4,ts-global_detected_seizures,162915,162943,28
Jensen_Eisai_groupB,2,5,ts-global_detected_seizures,162920,163227,307
Jensen_Eisai_groupB,1,4,ts-global_detected_seizures,162945,162970,25
Jensen_Eisai_groupB,1,4,ts-global_detected_seizures,163004,163052,48
Jensen_Eisai_groupB,1,4,ts-global_detected_seizures,163127,169641,6514
Jensen_Eisai_groupB,2,5,ts-global_detected_seizures,163240,163278,38
Jensen_Eisai_groupB,2,5,ts-global_detected_seizures,163316,163350,34
Jensen_Eisai_groupB,2,5,ts-global_detected_seizures,163467,163509,42
Jensen_Eisai_groupB,2,5,ts-global_detected_seizures,163747,163773,26
Jensen_Eisai_groupB,2,5,ts-global_detected_seizures,163853,163894,41
Jensen_Eisai_groupB,2,5,ts-global_detected_seizures,163958,164037,79
Jensen_Eisai_groupB,2,5,ts-global_detected_seizures,164158,164181,23
Jensen_Eisai_groupB,2,5,ts-global_detected_seizures,164201,164231,30
Jensen_Eisai_groupB,2,5,ts-global_detected_seizures,164300,164328,28
Jensen_Eisai_groupB,2,5,ts-global_detected_seizures,164434,164469,35
Jensen_Eisai_groupB,2,5,ts-global_detected_seizures,164617,164684,67
Jensen_Eisai_groupB,2,5,ts-global_detected_seizures,164750,164774,24
Jensen_Eisai_groupB,2,5,ts-global_detected_seizures,164830,164933,103
Jensen_Eisai_groupB,2,5,ts-global_detected_seizures,164949,164991,42
Jensen_Eisai_groupB,2,5,ts-global_detected_seizures,165023,165063,40
Jensen_Eisai_groupB,2,5,ts-global_detected_seizures,165177,165203,26
Jensen_Eisai_groupB,2,5,ts-global_detected_seizures,165304,165352,48
Jensen_Eisai_groupB,2,5,ts-global_detected_seizures,165353,165466,113
Jensen_Eisai_groupB,2,5,ts-global_detected_seizures,165553,165578,25
Jensen_Eisai_groupB,2,5,ts-global_detected_seizures,165830,165856,26
Jensen_Eisai_groupB,3,6,ts-global_detected_seizures,165834,166162,328
Jensen_Eisai_groupB,2,5,ts-global_detected_seizures,165951,166034,83
Jensen_Eisai_groupB,2,5,ts-global_detected_seizures,166036,166077,41
Jensen_Eisai_groupB,3,6,ts-global_detected_seizures,166163,166328,165
Jensen_Eisai_groupB,2,5,ts-global_detected_seizures,166170,166200,30
Jensen_Eisai_groupB,2,5,ts-global_detected_seizures,166369,166430,61
Jensen_Eisai_groupB,3,6,ts-global_detected_seizures,166400,169779,3379
Jensen_Eisai_groupB,2,5,ts-global_detected_seizures,166489,166515,26
Jensen_Eisai_groupB,2,5,ts-global_detected_seizures,166568,166694,126
Jensen_Eisai_groupB,2,5,ts-global_detected_seizures,166847,166869,22
Jensen_Eisai_groupB,2,5,ts-global_detected_seizures,166908,166932,24
Jensen_Eisai_groupB,2,5,ts-global_detected_seizures,167094,167121,27
Jensen_Eisai_groupB,2,5,ts-global_detected_seizures,167145,167169,24
Jensen_Eisai_groupB,2,5,ts-global_detected_seizures,167403,167467,64
Jensen_Eisai_groupB,2,5,ts-global_detected_seizures,167474,167523,49
Jensen_Eisai_groupB,2,5,ts-global_detected_seizures,167526,167553,27
Jensen_Eisai_groupB,2,5,ts-global_detected_seizures,167651,167673,22
Jensen_Eisai_groupB,2,5,ts-global_detected_seizures,167870,167899,29
Jensen_Eisai_groupB,2,5,ts-global_detected_seizures,168021,168044,23
Jensen_Eisai_groupB,2,5,ts-global_detected_seizures,168070,168534,464
Jensen_Eisai_groupB,2,5,ts-global_detected_seizures,168535,168778,243
Jensen_Eisai_groupB,2,5,ts-global_detected_seizures,168779,168997,218
Jensen_Eisai_groupB,2,5,ts-global_detected_seizures,168998,169061,63
Jensen_Eisai_groupB,2,5,ts-global_detected_seizures,169062,169108,46
Jensen_Eisai_groupB,2,5,ts-global_detected_seizures,169110,169189,79
Jensen_Eisai_groupB,2,5,ts-global_detected_seizures,169215,169269,54
Jensen_Eisai_groupB,2,5,ts-global_detected_seizures,169273,169302,29
Jensen_Eisai_groupB,2,5,ts-global_detected_seizures,169315,169359,44
Jensen_Eisai_groupB,2,5,ts-global_detected_seizures,169369,169393,24
Jensen_Eisai_groupB,2,5,ts-global_detected_seizures,169466,169492,26
Jensen_Eisai_groupB,2,5,ts-global_detected_seizures,169575,169610,35
Jensen_Eisai_groupB,1,4,ts-global_detected_seizures,169642,170336,694
Jensen_Eisai_groupB,2,5,ts-global_detected_seizures,169695,169749,54
Jensen_Eisai_groupB,3,6,ts-global_detected_seizures,169780,172791,3011
Jensen_Eisai_groupB,2,5,ts-global_detected_seizures,170074,171221,1147
Jensen_Eisai_groupB,1,4,ts-global_detected_seizures,170480,170563,83
Jensen_Eisai_groupB,1,4,ts-global_detected_seizures,170650,170678,28
Jensen_Eisai_groupB,1,4,ts-global_detected_seizures,170852,170894,42
Jensen_Eisai_groupB,1,4,ts-global_detected_seizures,170897,170927,30
Jensen_Eisai_groupB,1,4,ts-global_detected_seizures,170935,170957,22
Jensen_Eisai_groupB,1,4,ts-global_detected_seizures,170966,171016,50
Jensen_Eisai_groupB,1,4,ts-global_detected_seizures,171017,171068,51
Jensen_Eisai_groupB,1,4,ts-global_detected_seizures,171090,171115,25
Jensen_Eisai_groupB,1,4,ts-global_detected_seizures,171116,171183,67
Jensen_Eisai_groupB,2,5,ts-global_detected_seizures,171223,171449,226
Jensen_Eisai_groupB,1,4,ts-global_detected_seizures,171377,171469,92
Jensen_Eisai_groupB,2,5,ts-global_detected_seizures,171474,171496,22
Jensen_Eisai_groupB,1,4,ts-global_detected_seizures,171511,171537,26
Jensen_Eisai_groupB,1,4,ts-global_detected_seizures,171538,171567,29
Jensen_Eisai_groupB,2,5,ts-global_detected_seizures,171546,171598,52
Jensen_Eisai_groupB,1,4,ts-global_detected_seizures,171610,171676,66
Jensen_Eisai_groupB,2,5,ts-global_detected_seizures,171640,171667,27
Jensen_Eisai_groupB,2,5,ts-global_detected_seizures,171668,171699,31
Jensen_Eisai_groupB,1,4,ts-global_detected_seizures,171693,171726,33
Jensen_Eisai_groupB,2,5,ts-global_detected_seizures,171739,171883,144
Jensen_Eisai_groupB,1,4,ts-global_detected_seizures,171882,171944,62
Jensen_Eisai_groupB,2,5,ts-global_detected_seizures,171903,171925,22
Jensen_Eisai_groupB,2,5,ts-global_detected_seizures,171956,172692,736
Jensen_Eisai_groupB,1,4,ts-global_detected_seizures,171971,172056,85
Jensen_Eisai_groupB,1,4,ts-global_detected_seizures,172159,172209,50
Jensen_Eisai_groupB,1,4,ts-global_detected_seizures,172219,172677,458
Jensen_Eisai_groupB,1,4,ts-global_detected_seizures,172678,173358,680
Jensen_Eisai_groupB,2,5,ts-global_detected_seizures,172693,173358,665
Jensen_Eisai_groupB,3,6,ts-global_detected_seizures,172862,173358,496
Jensen_Eisai_groupB,3,6,ts-global_detected_seizures,173783,176447,2664
Jensen_Eisai_groupB,2,5,ts-global_detected_seizures,174012,174079,67
Jensen_Eisai_groupB,2,5,ts-global_detected_seizures,174080,174118,38
Jensen_Eisai_groupB,2,5,ts-global_detected_seizures,174140,174185,45
Jensen_Eisai_groupB,2,5,ts-global_detected_seizures,174214,174263,49
Jensen_Eisai_groupB,2,5,ts-global_detected_seizures,174265,174313,48
Jensen_Eisai_groupB,2,5,ts-global_detected_seizures,174314,174349,35
Jensen_Eisai_groupB,2,5,ts-global_detected_seizures,174350,174394,44
Jensen_Eisai_groupB,2,5,ts-global_detected_seizures,174395,174436,41
Jensen_Eisai_groupB,2,5,ts-global_detected_seizures,174437,174548,111
Jensen_Eisai_groupB,2,5,ts-global_detected_seizures,174549,174578,29
Jensen_Eisai_groupB,2,5,ts-global_detected_seizures,174579,174683,104
Jensen_Eisai_groupB,1,4,ts-global_detected_seizures,174601,174838,237
Jensen_Eisai_groupB,2,5,ts-global_detected_seizures,174684,174723,39
Jensen_Eisai_groupB,2,5,ts-global_detected_seizures,174726,174753,27
Jensen_Eisai_groupB,2,5,ts-global_detected_seizures,174754,174796,42
Jensen_Eisai_groupB,2,5,ts-global_detected_seizures,174797,174829,32
Jensen_Eisai_groupB,2,5,ts-global_detected_seizures,174830,174921,91
Jensen_Eisai_groupB,1,4,ts-global_detected_seizures,174862,175222,360
Jensen_Eisai_groupB,2,5,ts-global_detected_seizures,174935,175031,96
Jensen_Eisai_groupB,2,5,ts-global_detected_seizures,175033,175059,26
Jensen_Eisai_groupB,2,5,ts-global_detected_seizures,175060,175104,44
Jensen_Eisai_groupB,2,5,ts-global_detected_seizures,175105,175150,45
Jensen_Eisai_groupB,2,5,ts-global_detected_seizures,175151,175173,22
Jensen_Eisai_groupB,2,5,ts-global_detected_seizures,175174,175198,24
Jensen_Eisai_groupB,2,5,ts-global_detected_seizures,175199,175223,24
Jensen_Eisai_groupB,1,4,ts-global_detected_seizures,175223,175364,141
Jensen_Eisai_groupB,2,5,ts-global_detected_seizures,175225,175264,39
Jensen_Eisai_groupB,2,5,ts-global_detected_seizures,175265,175299,34
Jensen_Eisai_groupB,2,5,ts-global_detected_seizures,175340,175420,80
Jensen_Eisai_groupB,1,4,ts-global_detected_seizures,175365,175584,219
Jensen_Eisai_groupB,2,5,ts-global_detected_seizures,175421,175491,70
Jensen_Eisai_groupB,2,5,ts-global_detected_seizures,175492,175592,100
Jensen_Eisai_groupB,1,4,ts-global_detected_seizures,175585,175681,96
Jensen_Eisai_groupB,2,5,ts-global_detected_seizures,175610,175662,52
Jensen_Eisai_groupB,2,5,ts-global_detected_seizures,175663,175697,34
Jensen_Eisai_groupB,1,4,ts-global_detected_seizures,175682,175766,84
Jensen_Eisai_groupB,2,5,ts-global_detected_seizures,175698,175736,38
Jensen_Eisai_groupB,2,5,ts-global_detected_seizures,175737,175773,36
Jensen_Eisai_groupB,1,4,ts-global_detected_seizures,175774,175924,150
Jensen_Eisai_groupB,2,5,ts-global_detected_seizures,175786,175815,29
Jensen_Eisai_groupB,2,5,ts-global_detected_seizures,175817,175846,29
Jensen_Eisai_groupB,2,5,ts-global_detected_seizures,175899,175965,66
Jensen_Eisai_groupB,1,4,ts-global_detected_seizures,175943,175978,35
Jensen_Eisai_groupB,2,5,ts-global_detected_seizures,175983,176015,32
Jensen_Eisai_groupB,1,4,ts-global_detected_seizures,176006,176506,500
Jensen_Eisai_groupB,2,5,ts-global_detected_seizures,176036,176072,36
Jensen_Eisai_groupB,2,5,ts-global_detected_seizures,176073,176099,26
Jensen_Eisai_groupB,2,5,ts-global_detected_seizures,176100,176130,30
Jensen_Eisai_groupB,2,5,ts-global_detected_seizures,176131,176164,33
Jensen_Eisai_groupB,2,5,ts-global_detected_seizures,176176,176208,32
Jensen_Eisai_groupB,2,5,ts-global_detected_seizures,176209,176321,112
Jensen_Eisai_groupB,2,5,ts-global_detected_seizures,176414,176470,56
Jensen_Eisai_groupB,3,6,ts-global_detected_seizures,176448,187290,10842
Jensen_Eisai_groupB,2,5,ts-global_detected_seizures,176483,176524,41
Jensen_Eisai_groupB,1,4,ts-global_detected_seizures,176507,177108,601
Jensen_Eisai_groupB,2,5,ts-global_detected_seizures,176538,176607,69
Jensen_Eisai_groupB,2,5,ts-global_detected_seizures,176630,176694,64
Jensen_Eisai_groupB,2,5,ts-global_detected_seizures,176712,176741,29
Jensen_Eisai_groupB,2,5,ts-global_detected_seizures,176748,176791,43
Jensen_Eisai_groupB,2,5,ts-global_detected_seizures,176811,176861,50
Jensen_Eisai_groupB,2,5,ts-global_detected_seizures,176904,176942,38
Jensen_Eisai_groupB,2,5,ts-global_detected_seizures,176979,177045,66
Jensen_Eisai_groupB,2,5,ts-global_detected_seizures,177047,177135,88
Jensen_Eisai_groupB,1,4,ts-global_detected_seizures,177109,177354,245
Jensen_Eisai_groupB,2,5,ts-global_detected_seizures,177136,177180,44
Jensen_Eisai_groupB,2,5,ts-global_detected_seizures,177191,177348,157
Jensen_Eisai_groupB,2,5,ts-global_detected_seizures,177368,177413,45
Jensen_Eisai_groupB,2,5,ts-global_detected_seizures,177439,177480,41
Jensen_Eisai_groupB,1,4,ts-global_detected_seizures,177467,177503,36
Jensen_Eisai_groupB,2,5,ts-global_detected_seizures,177481,177556,75
Jensen_Eisai_groupB,1,4,ts-global_detected_seizures,177548,177986,438
Jensen_Eisai_groupB,2,5,ts-global_detected_seizures,177557,177581,24
Jensen_Eisai_groupB,2,5,ts-global_detected_seizures,177597,177629,32
Jensen_Eisai_groupB,2,5,ts-global_detected_seizures,177767,177792,25
Jensen_Eisai_groupB,2,5,ts-global_detected_seizures,177837,177876,39
Jensen_Eisai_groupB,2,5,ts-global_detected_seizures,177917,177957,40
Jensen_Eisai_groupB,2,5,ts-global_detected_seizures,177969,178009,40
Jensen_Eisai_groupB,1,4,ts-global_detected_seizures,177997,178034,37
Jensen_Eisai_groupB,2,5,ts-global_detected_seizures,178056,178081,25
Jensen_Eisai_groupB,1,4,ts-global_detected_seizures,178058,178089,31
Jensen_Eisai_groupB,2,5,ts-global_detected_seizures,178084,178165,81
Jensen_Eisai_groupB,1,4,ts-global_detected_seizures,178117,178172,55
Jensen_Eisai_groupB,2,5,ts-global_detected_seizures,178167,178206,39
Jensen_Eisai_groupB,1,4,ts-global_detected_seizures,178207,178352,145
Jensen_Eisai_groupB,2,5,ts-global_detected_seizures,178208,178502,294
Jensen_Eisai_groupB,1,4,ts-global_detected_seizures,178367,178513,146
Jensen_Eisai_groupB,1,4,ts-global_detected_seizures,178514,178588,74
Jensen_Eisai_groupB,2,5,ts-global_detected_seizures,178517,178586,69
Jensen_Eisai_groupB,2,5,ts-global_detected_seizures,178587,178622,35
Jensen_Eisai_groupB,2,5,ts-global_detected_seizures,178623,178646,23
Jensen_Eisai_groupB,1,4,ts-global_detected_seizures,178657,178695,38
Jensen_Eisai_groupB,2,5,ts-global_detected_seizures,178665,178707,42
Jensen_Eisai_groupB,2,5,ts-global_detected_seizures,178718,178743,25
Jensen_Eisai_groupB,1,4,ts-global_detected_seizures,178736,178840,104
Jensen_Eisai_groupB,2,5,ts-global_detected_seizures,178790,178815,25
Jensen_Eisai_groupB,1,4,ts-global_detected_seizures,178841,179001,160
Jensen_Eisai_groupB,2,5,ts-global_detected_seizures,178864,178900,36
Jensen_Eisai_groupB,2,5,ts-global_detected_seizures,179095,179123,28
Jensen_Eisai_groupB,2,5,ts-global_detected_seizures,179124,179466,342
Jensen_Eisai_groupB,1,4,ts-global_detected_seizures,179228,179254,26
Jensen_Eisai_groupB,1,4,ts-global_detected_seizures,179403,179472,69
Jensen_Eisai_groupB,2,5,ts-global_detected_seizures,179481,179509,28
Jensen_Eisai_groupB,2,5,ts-global_detected_seizures,179522,179595,73
Jensen_Eisai_groupB,2,5,ts-global_detected_seizures,179605,179843,238
Jensen_Eisai_groupB,1,4,ts-global_detected_seizures,179637,179690,53
Jensen_Eisai_groupB,1,4,ts-global_detected_seizures,179691,179732,41
Jensen_Eisai_groupB,1,4,ts-global_detected_seizures,179782,179832,50
Jensen_Eisai_groupB,2,5,ts-global_detected_seizures,179844,179879,35
Jensen_Eisai_groupB,1,4,ts-global_detected_seizures,179877,179911,34
Jensen_Eisai_groupB,2,5,ts-global_detected_seizures,179900,179950,50
Jensen_Eisai_groupB,2,5,ts-global_detected_seizures,179951,179985,34
Jensen_Eisai_groupB,1,4,ts-global_detected_seizures,179978,180028,50
Jensen_Eisai_groupB,1,4,ts-global_detected_seizures,180033,180091,58
Jensen_Eisai_groupB,1,4,ts-global_detected_seizures,180136,180207,71
Jensen_Eisai_groupB,2,5,ts-global_detected_seizures,180155,180202,47
Jensen_Eisai_groupB,1,4,ts-global_detected_seizures,180209,180233,24
Jensen_Eisai_groupB,1,4,ts-global_detected_seizures,180289,180322,33
Jensen_Eisai_groupB,2,5,ts-global_detected_seizures,180305,180328,23
Jensen_Eisai_groupB,1,4,ts-global_detected_seizures,180334,180363,29
Jensen_Eisai_groupB,1,4,ts-global_detected_seizures,180420,180462,42
Jensen_Eisai_groupB,1,4,ts-global_detected_seizures,180474,180520,46
Jensen_Eisai_groupB,2,5,ts-global_detected_seizures,180484,180508,24
Jensen_Eisai_groupB,2,5,ts-global_detected_seizures,180563,180595,32
Jensen_Eisai_groupB,1,4,ts-global_detected_seizures,180583,180608,25
Jensen_Eisai_groupB,1,4,ts-global_detected_seizures,180619,180656,37
Jensen_Eisai_groupB,1,4,ts-global_detected_seizures,180675,180755,80
Jensen_Eisai_groupB,2,5,ts-global_detected_seizures,180773,180828,55
Jensen_Eisai_groupB,1,4,ts-global_detected_seizures,180827,180882,55
Jensen_Eisai_groupB,2,5,ts-global_detected_seizures,180870,180896,26
Jensen_Eisai_groupB,2,5,ts-global_detected_seizures,180916,180998,82
Jensen_Eisai_groupB,1,4,ts-global_detected_seizures,180954,180988,34
Jensen_Eisai_groupB,1,4,ts-global_detected_seizures,180990,181017,27
Jensen_Eisai_groupB,2,5,ts-global_detected_seizures,180999,181083,84
Jensen_Eisai_groupB,1,4,ts-global_detected_seizures,181025,181052,27
Jensen_Eisai_groupB,1,4,ts-global_detected_seizures,181089,181119,30
Jensen_Eisai_groupB,1,4,ts-global_detected_seizures,181173,181200,27
Jensen_Eisai_groupB,2,5,ts-global_detected_seizures,181199,181230,31
Jensen_Eisai_groupB,2,5,ts-global_detected_seizures,181231,181266,35
Jensen_Eisai_groupB,1,4,ts-global_detected_seizures,181233,181259,26
Jensen_Eisai_groupB,1,4,ts-global_detected_seizures,181273,181357,84
Jensen_Eisai_groupB,1,4,ts-global_detected_seizures,181358,181381,23
Jensen_Eisai_groupB,1,4,ts-global_detected_seizures,181382,181404,22
Jensen_Eisai_groupB,2,5,ts-global_detected_seizures,181386,181412,26
Jensen_Eisai_groupB,2,5,ts-global_detected_seizures,181443,181468,25
Jensen_Eisai_groupB,1,4,ts-global_detected_seizures,181461,181544,83
Jensen_Eisai_groupB,2,5,ts-global_detected_seizures,181497,181529,32
Jensen_Eisai_groupB,2,5,ts-global_detected_seizures,181530,181554,24
Jensen_Eisai_groupB,2,5,ts-global_detected_seizures,181555,181599,44
Jensen_Eisai_groupB,1,4,ts-global_detected_seizures,181602,181631,29
Jensen_Eisai_groupB,1,4,ts-global_detected_seizures,181724,181853,129
Jensen_Eisai_groupB,2,5,ts-global_detected_seizures,181862,181887,25
Jensen_Eisai_groupB,1,4,ts-global_detected_seizures,181885,181920,35
Jensen_Eisai_groupB,1,4,ts-global_detected_seizures,181971,181999,28
Jensen_Eisai_groupB,2,5,ts-global_detected_seizures,182010,182044,34
Jensen_Eisai_groupB,1,4,ts-global_detected_seizures,182035,182069,34
Jensen_Eisai_groupB,1,4,ts-global_detected_seizures,182145,182173,28
Jensen_Eisai_groupB,2,5,ts-global_detected_seizures,182172,182194,22
Jensen_Eisai_groupB,1,4,ts-global_detected_seizures,182180,182215,35
Jensen_Eisai_groupB,1,4,ts-global_detected_seizures,182219,182245,26
Jensen_Eisai_groupB,2,5,ts-global_detected_seizures,182257,182290,33
Jensen_Eisai_groupB,1,4,ts-global_detected_seizures,182267,182296,29
Jensen_Eisai_groupB,2,5,ts-global_detected_seizures,182295,182319,24
Jensen_Eisai_groupB,1,4,ts-global_detected_seizures,182374,182491,117
Jensen_Eisai_groupB,2,5,ts-global_detected_seizures,182462,182497,35
Jensen_Eisai_groupB,1,4,ts-global_detected_seizures,182496,182606,110
Jensen_Eisai_groupB,2,5,ts-global_detected_seizures,182498,182526,28
Jensen_Eisai_groupB,2,5,ts-global_detected_seizures,182527,182595,68
Jensen_Eisai_groupB,1,4,ts-global_detected_seizures,182607,182650,43
Jensen_Eisai_groupB,2,5,ts-global_detected_seizures,182642,182674,32
Jensen_Eisai_groupB,1,4,ts-global_detected_seizures,182662,182684,22
Jensen_Eisai_groupB,1,4,ts-global_detected_seizures,182709,182744,35
Jensen_Eisai_groupB,1,4,ts-global_detected_seizures,182745,182770,25
Jensen_Eisai_groupB,1,4,ts-global_detected_seizures,182806,182838,32
Jensen_Eisai_groupB,2,5,ts-global_detected_seizures,182843,182877,34
Jensen_Eisai_groupB,1,4,ts-global_detected_seizures,182852,182889,37
Jensen_Eisai_groupB,2,5,ts-global_detected_seizures,182890,182932,42
Jensen_Eisai_groupB,1,4,ts-global_detected_seizures,182899,182941,42
Jensen_Eisai_groupB,1,4,ts-global_detected_seizures,182966,183019,53
Jensen_Eisai_groupB,2,5,ts-global_detected_seizures,182973,183002,29
Jensen_Eisai_groupB,2,5,ts-global_detected_seizures,183011,183073,62
Jensen_Eisai_groupB,1,4,ts-global_detected_seizures,183057,183084,27
Jensen_Eisai_groupB,1,4,ts-global_detected_seizures,183104,183138,34
Jensen_Eisai_groupB,1,4,ts-global_detected_seizures,183158,183262,104
Jensen_Eisai_groupB,2,5,ts-global_detected_seizures,183258,183283,25
Jensen_Eisai_groupB,1,4,ts-global_detected_seizures,183280,183421,141
Jensen_Eisai_groupB,1,4,ts-global_detected_seizures,183430,183461,31
Jensen_Eisai_groupB,2,5,ts-global_detected_seizures,183440,183486,46
Jensen_Eisai_groupB,1,4,ts-global_detected_seizures,183477,183507,30
Jensen_Eisai_groupB,2,5,ts-global_detected_seizures,183528,183550,22
Jensen_Eisai_groupB,1,4,ts-global_detected_seizures,183534,183582,48
Jensen_Eisai_groupB,1,4,ts-global_detected_seizures,183586,183622,36
Jensen_Eisai_groupB,1,4,ts-global_detected_seizures,183624,183652,28
Jensen_Eisai_groupB,2,5,ts-global_detected_seizures,183721,183746,25
Jensen_Eisai_groupB,1,4,ts-global_detected_seizures,183722,183756,34
Jensen_Eisai_groupB,1,4,ts-global_detected_seizures,183759,183784,25
Jensen_Eisai_groupB,2,5,ts-global_detected_seizures,183828,183865,37
Jensen_Eisai_groupB,1,4,ts-global_detected_seizures,183840,183881,41
Jensen_Eisai_groupB,2,5,ts-global_detected_seizures,183866,183973,107
Jensen_Eisai_groupB,1,4,ts-global_detected_seizures,183922,184092,170
Jensen_Eisai_groupB,2,5,ts-global_detected_seizures,184006,184030,24
Jensen_Eisai_groupB,2,5,ts-global_detected_seizures,184075,184167,92
Jensen_Eisai_groupB,1,4,ts-global_detected_seizures,184097,184204,107
Jensen_Eisai_groupB,1,4,ts-global_detected_seizures,184209,184312,103
Jensen_Eisai_groupB,2,5,ts-global_detected_seizures,184291,184316,25
Jensen_Eisai_groupB,1,4,ts-global_detected_seizures,184314,184355,41
Jensen_Eisai_groupB,1,4,ts-global_detected_seizures,184365,184391,26
Jensen_Eisai_groupB,2,5,ts-global_detected_seizures,184414,184453,39
Jensen_Eisai_groupB,1,4,ts-global_detected_seizures,184429,184496,67
Jensen_Eisai_groupB,1,4,ts-global_detected_seizures,184504,184532,28
Jensen_Eisai_groupB,1,4,ts-global_detected_seizures,184547,184580,33
Jensen_Eisai_groupB,1,4,ts-global_detected_seizures,184599,184629,30
Jensen_Eisai_groupB,2,5,ts-global_detected_seizures,184636,184659,23
Jensen_Eisai_groupB,1,4,ts-global_detected_seizures,184648,184678,30
Jensen_Eisai_groupB,1,4,ts-global_detected_seizures,184719,184808,89
Jensen_Eisai_groupB,2,5,ts-global_detected_seizures,184813,184847,34
Jensen_Eisai_groupB,1,4,ts-global_detected_seizures,184847,184899,52
Jensen_Eisai_groupB,2,5,ts-global_detected_seizures,184851,184928,77
Jensen_Eisai_groupB,2,5,ts-global_detected_seizures,184929,184962,33
Jensen_Eisai_groupB,1,4,ts-global_detected_seizures,184943,185033,90
Jensen_Eisai_groupB,2,5,ts-global_detected_seizures,184999,185040,41
Jensen_Eisai_groupB,2,5,ts-global_detected_seizures,185041,185070,29
Jensen_Eisai_groupB,1,4,ts-global_detected_seizures,185046,185113,67
Jensen_Eisai_groupB,2,5,ts-global_detected_seizures,185071,185405,334
Jensen_Eisai_groupB,1,4,ts-global_detected_seizures,185114,186768,1654
Jensen_Eisai_groupB,2,5,ts-global_detected_seizures,185411,185433,22
Jensen_Eisai_groupB,2,5,ts-global_detected_seizures,185435,185467,32
Jensen_Eisai_groupB,2,5,ts-global_detected_seizures,185504,185642,138
Jensen_Eisai_groupB,2,5,ts-global_detected_seizures,185660,185737,77
Jensen_Eisai_groupB,2,5,ts-global_detected_seizures,185739,185893,154
Jensen_Eisai_groupB,2,5,ts-global_detected_seizures,185901,185951,50
Jensen_Eisai_groupB,2,5,ts-global_detected_seizures,185972,186098,126
Jensen_Eisai_groupB,2,5,ts-global_detected_seizures,186100,186148,48
Jensen_Eisai_groupB,2,5,ts-global_detected_seizures,186149,186259,110
Jensen_Eisai_groupB,2,5,ts-global_detected_seizures,186260,186346,86
Jensen_Eisai_groupB,2,5,ts-global_detected_seizures,186350,186379,29
Jensen_Eisai_groupB,2,5,ts-global_detected_seizures,186381,186409,28
Jensen_Eisai_groupB,2,5,ts-global_detected_seizures,186410,186473,63
Jensen_Eisai_groupB,2,5,ts-global_detected_seizures,186475,186536,61
Jensen_Eisai_groupB,2,5,ts-global_detected_seizures,186537,186614,77
Jensen_Eisai_groupB,2,5,ts-global_detected_seizures,186666,186719,53
Jensen_Eisai_groupB,2,5,ts-global_detected_seizures,186720,186844,124
Jensen_Eisai_groupB,1,4,ts-global_detected_seizures,186769,188083,1314
Jensen_Eisai_groupB,2,5,ts-global_detected_seizures,186846,186976,130
Jensen_Eisai_groupB,2,5,ts-global_detected_seizures,186992,187037,45
Jensen_Eisai_groupB,2,5,ts-global_detected_seizures,187038,187080,42
Jensen_Eisai_groupB,2,5,ts-global_detected_seizures,187082,187135,53
Jensen_Eisai_groupB,2,5,ts-global_detected_seizures,187136,187240,104
Jensen_Eisai_groupB,2,5,ts-global_detected_seizures,187253,187290,37
Jensen_Eisai_groupB,3,6,ts-global_detected_seizures,187291,188179,888
Jensen_Eisai_groupB,2,5,ts-global_detected_seizures,187375,187403,28
Jensen_Eisai_groupB,2,5,ts-global_detected_seizures,187404,187470,66
Jensen_Eisai_groupB,2,5,ts-global_detected_seizures,187471,187590,119
Jensen_Eisai_groupB,2,5,ts-global_detected_seizures,187591,187886,295
Jensen_Eisai_groupB,2,5,ts-global_detected_seizures,187908,187935,27
Jensen_Eisai_groupB,2,5,ts-global_detected_seizures,187937,187959,22
Jensen_Eisai_groupB,2,5,ts-global_detected_seizures,188063,188273,210
Jensen_Eisai_groupB,1,4,ts-global_detected_seizures,188097,188138,41
Jensen_Eisai_groupB,1,4,ts-global_detected_seizures,188163,188231,68
Jensen_Eisai_groupB,3,6,ts-global_detected_seizures,188214,191306,3092
Jensen_Eisai_groupB,1,4,ts-global_detected_seizures,188232,188273,41
Jensen_Eisai_groupB,1,4,ts-global_detected_seizures,188286,188320,34
Jensen_Eisai_groupB,2,5,ts-global_detected_seizures,188295,188465,170
Jensen_Eisai_groupB,1,4,ts-global_detected_seizures,188386,188453,67
Jensen_Eisai_groupB,2,5,ts-global_detected_seizures,188466,188502,36
Jensen_Eisai_groupB,1,4,ts-global_detected_seizures,188547,188579,32
Jensen_Eisai_groupB,2,5,ts-global_detected_seizures,188664,188712,48
Jensen_Eisai_groupB,1,4,ts-global_detected_seizures,188679,188726,47
Jensen_Eisai_groupB,1,4,ts-global_detected_seizures,188746,188792,46
Jensen_Eisai_groupB,2,5,ts-global_detected_seizures,188793,188816,23
Jensen_Eisai_groupB,1,4,ts-global_detected_seizures,188858,188885,27
Jensen_Eisai_groupB,1,4,ts-global_detected_seizures,188886,188936,50
Jensen_Eisai_groupB,2,5,ts-global_detected_seizures,188906,189376,470
Jensen_Eisai_groupB,1,4,ts-global_detected_seizures,189109,189134,25
Jensen_Eisai_groupB,1,4,ts-global_detected_seizures,189220,189262,42
Jensen_Eisai_groupB,1,4,ts-global_detected_seizures,189301,189349,48
Jensen_Eisai_groupB,2,5,ts-global_detected_seizures,189377,189485,108
Jensen_Eisai_groupB,1,4,ts-global_detected_seizures,189432,189465,33
Jensen_Eisai_groupB,2,5,ts-global_detected_seizures,189487,189509,22
Jensen_Eisai_groupB,1,4,ts-global_detected_seizures,189566,189641,75
Jensen_Eisai_groupB,2,5,ts-global_detected_seizures,189599,189633,34
Jensen_Eisai_groupB,1,4,ts-global_detected_seizures,189649,189685,36
Jensen_Eisai_groupB,2,5,ts-global_detected_seizures,189653,189694,41
Jensen_Eisai_groupB,1,4,ts-global_detected_seizures,189697,189722,25
Jensen_Eisai_groupB,1,4,ts-global_detected_seizures,189723,189754,31
Jensen_Eisai_groupB,2,5,ts-global_detected_seizures,189755,189788,33
Jensen_Eisai_groupB,1,4,ts-global_detected_seizures,189760,189784,24
Jensen_Eisai_groupB,1,4,ts-global_detected_seizures,189785,189824,39
Jensen_Eisai_groupB,1,4,ts-global_detected_seizures,189830,189868,38
Jensen_Eisai_groupB,2,5,ts-global_detected_seizures,189851,189873,22
Jensen_Eisai_groupB,2,5,ts-global_detected_seizures,189918,189942,24
Jensen_Eisai_groupB,2,5,ts-global_detected_seizures,189948,189982,34
Jensen_Eisai_groupB,1,4,ts-global_detected_seizures,189994,190018,24
Jensen_Eisai_groupB,1,4,ts-global_detected_seizures,190036,190077,41
Jensen_Eisai_groupB,2,5,ts-global_detected_seizures,190079,190114,35
Jensen_Eisai_groupB,1,4,ts-global_detected_seizures,190091,190114,23
Jensen_Eisai_groupB,2,5,ts-global_detected_seizures,190194,190219,25
Jensen_Eisai_groupB,1,4,ts-global_detected_seizures,190199,190238,39
Jensen_Eisai_groupB,2,5,ts-global_detected_seizures,190275,190302,27
Jensen_Eisai_groupB,1,4,ts-global_detected_seizures,190277,190302,25
Jensen_Eisai_groupB,1,4,ts-global_detected_seizures,190319,190365,46
Jensen_Eisai_groupB,1,4,ts-global_detected_seizures,190383,190436,53
Jensen_Eisai_groupB,2,5,ts-global_detected_seizures,190386,190423,37
Jensen_Eisai_groupB,2,5,ts-global_detected_seizures,190456,190502,46
Jensen_Eisai_groupB,1,4,ts-global_detected_seizures,190459,190488,29
Jensen_Eisai_groupB,2,5,ts-global_detected_seizures,190509,190579,70
Jensen_Eisai_groupB,1,4,ts-global_detected_seizures,190534,190624,90
Jensen_Eisai_groupB,2,5,ts-global_detected_seizures,190648,190678,30
Jensen_Eisai_groupB,1,4,ts-global_detected_seizures,190670,190828,158
Jensen_Eisai_groupB,2,5,ts-global_detected_seizures,190795,190828,33
Jensen_Eisai_groupB,1,4,ts-global_detected_seizures,190833,190860,27
Jensen_Eisai_groupB,1,4,ts-global_detected_seizures,190872,190909,37
Jensen_Eisai_groupB,2,5,ts-global_detected_seizures,190918,190944,26
Jensen_Eisai_groupB,1,4,ts-global_detected_seizures,190919,191001,82
Jensen_Eisai_groupB,1,4,ts-global_detected_seizures,191003,191036,33
Jensen_Eisai_groupB,2,5,ts-global_detected_seizures,191037,191060,23
Jensen_Eisai_groupB,2,5,ts-global_detected_seizures,191094,191116,22
Jensen_Eisai_groupB,1,4,ts-global_detected_seizures,191149,191174,25
Jensen_Eisai_groupB,1,4,ts-global_detected_seizures,191175,191203,28
Jensen_Eisai_groupB,2,5,ts-global_detected_seizures,191218,191252,34
Jensen_Eisai_groupB,1,4,ts-global_detected_seizures,191269,191303,34
Jensen_Eisai_groupB,2,5,ts-global_detected_seizures,191294,191320,26
Jensen_Eisai_groupB,3,6,ts-global_detected_seizures,191307,203686,12379
Jensen_Eisai_groupB,1,4,ts-global_detected_seizures,191315,191379,64
Jensen_Eisai_groupB,1,4,ts-global_detected_seizures,191399,191439,40
Jensen_Eisai_groupB,1,4,ts-global_detected_seizures,191460,191525,65
Jensen_Eisai_groupB,2,5,ts-global_detected_seizures,191496,191540,44
Jensen_Eisai_groupB,1,4,ts-global_detected_seizures,191526,191555,29
Jensen_Eisai_groupB,1,4,ts-global_detected_seizures,191593,191621,28
Jensen_Eisai_groupB,1,4,ts-global_detected_seizures,191643,191714,71
Jensen_Eisai_groupB,2,5,ts-global_detected_seizures,191654,191688,34
Jensen_Eisai_groupB,2,5,ts-global_detected_seizures,191704,191737,33
Jensen_Eisai_groupB,1,4,ts-global_detected_seizures,191715,191740,25
Jensen_Eisai_groupB,2,5,ts-global_detected_seizures,191747,191784,37
Jensen_Eisai_groupB,1,4,ts-global_detected_seizures,191775,191828,53
Jensen_Eisai_groupB,1,4,ts-global_detected_seizures,191872,192106,234
Jensen_Eisai_groupB,2,5,ts-global_detected_seizures,191898,191922,24
Jensen_Eisai_groupB,2,5,ts-global_detected_seizures,192019,192062,43
Jensen_Eisai_groupB,2,5,ts-global_detected_seizures,192067,192103,36
Jensen_Eisai_groupB,1,4,ts-global_detected_seizures,192107,192137,30
Jensen_Eisai_groupB,1,4,ts-global_detected_seizures,192164,192222,58
Jensen_Eisai_groupB,2,5,ts-global_detected_seizures,192235,192257,22
Jensen_Eisai_groupB,2,5,ts-global_detected_seizures,192275,192302,27
Jensen_Eisai_groupB,1,4,ts-global_detected_seizures,192306,192526,220
Jensen_Eisai_groupB,2,5,ts-global_detected_seizures,192437,192466,29
Jensen_Eisai_groupB,2,5,ts-global_detected_seizures,192467,192491,24
Jensen_Eisai_groupB,1,4,ts-global_detected_seizures,192532,192710,178
Jensen_Eisai_groupB,2,5,ts-global_detected_seizures,192547,192570,23
Jensen_Eisai_groupB,2,5,ts-global_detected_seizures,192584,192608,24
Jensen_Eisai_groupB,2,5,ts-global_detected_seizures,192645,192730,85
Jensen_Eisai_groupB,1,4,ts-global_detected_seizures,192787,192825,38
Jensen_Eisai_groupB,2,5,ts-global_detected_seizures,192853,192876,23
Jensen_Eisai_groupB,1,4,ts-global_detected_seizures,192888,192910,22
Jensen_Eisai_groupB,2,5,ts-global_detected_seizures,192903,192925,22
Jensen_Eisai_groupB,2,5,ts-global_detected_seizures,192967,192990,23
Jensen_Eisai_groupB,1,4,ts-global_detected_seizures,192972,192998,26
Jensen_Eisai_groupB,2,5,ts-global_detected_seizures,193002,193033,31
Jensen_Eisai_groupB,1,4,ts-global_detected_seizures,193062,193117,55
Jensen_Eisai_groupB,2,5,ts-global_detected_seizures,193066,193107,41
Jensen_Eisai_groupB,1,4,ts-global_detected_seizures,193158,193196,38
Jensen_Eisai_groupB,2,5,ts-global_detected_seizures,193189,193213,24
Jensen_Eisai_groupB,1,4,ts-global_detected_seizures,193229,193508,279
Jensen_Eisai_groupB,2,5,ts-global_detected_seizures,193302,193465,163
Jensen_Eisai_groupB,2,5,ts-global_detected_seizures,193474,193510,36
Jensen_Eisai_groupB,1,4,ts-global_detected_seizures,193509,193533,24
Jensen_Eisai_groupB,1,4,ts-global_detected_seizures,193543,193578,35
Jensen_Eisai_groupB,2,5,ts-global_detected_seizures,193549,193572,23
Jensen_Eisai_groupB,1,4,ts-global_detected_seizures,193580,195512,1932
Jensen_Eisai_groupB,2,5,ts-global_detected_seizures,193601,193635,34
Jensen_Eisai_groupB,2,5,ts-global_detected_seizures,193636,193695,59
Jensen_Eisai_groupB,2,5,ts-global_detected_seizures,193854,193885,31
Jensen_Eisai_groupB,2,5,ts-global_detected_seizures,193920,193978,58
Jensen_Eisai_groupB,2,5,ts-global_detected_seizures,194013,194048,35
Jensen_Eisai_groupB,2,5,ts-global_detected_seizures,194083,194137,54
Jensen_Eisai_groupB,2,5,ts-global_detected_seizures,194143,194178,35
Jensen_Eisai_groupB,2,5,ts-global_detected_seizures,194197,194220,23
Jensen_Eisai_groupB,2,5,ts-global_detected_seizures,194238,194269,31
Jensen_Eisai_groupB,2,5,ts-global_detected_seizures,194296,194321,25
Jensen_Eisai_groupB,2,5,ts-global_detected_seizures,194355,194381,26
Jensen_Eisai_groupB,2,5,ts-global_detected_seizures,194425,194448,23
Jensen_Eisai_groupB,2,5,ts-global_detected_seizures,194493,194535,42
Jensen_Eisai_groupB,2,5,ts-global_detected_seizures,194615,194644,29
Jensen_Eisai_groupB,2,5,ts-global_detected_seizures,194684,194713,29
Jensen_Eisai_groupB,2,5,ts-global_detected_seizures,194794,194830,36
Jensen_Eisai_groupB,2,5,ts-global_detected_seizures,194853,194882,29
Jensen_Eisai_groupB,2,5,ts-global_detected_seizures,194945,194968,23
Jensen_Eisai_groupB,2,5,ts-global_detected_seizures,195051,195079,28
Jensen_Eisai_groupB,2,5,ts-global_detected_seizures,195105,195149,44
Jensen_Eisai_groupB,2,5,ts-global_detected_seizures,195165,195221,56
Jensen_Eisai_groupB,2,5,ts-global_detected_seizures,195239,195267,28
Jensen_Eisai_groupB,2,5,ts-global_detected_seizures,195293,195364,71
Jensen_Eisai_groupB,2,5,ts-global_detected_seizures,195399,195427,28
Jensen_Eisai_groupB,2,5,ts-global_detected_seizures,195447,195477,30
Jensen_Eisai_groupB,2,5,ts-global_detected_seizures,195520,195554,34
Jensen_Eisai_groupB,2,5,ts-global_detected_seizures,195560,195628,68
Jensen_Eisai_groupB,1,4,ts-global_detected_seizures,195578,195613,35
Jensen_Eisai_groupB,1,4,ts-global_detected_seizures,195697,195735,38
Jensen_Eisai_groupB,1,4,ts-global_detected_seizures,195769,195805,36
Jensen_Eisai_groupB,1,4,ts-global_detected_seizures,195847,195897,50
Jensen_Eisai_groupB,2,5,ts-global_detected_seizures,195856,195912,56
Jensen_Eisai_groupB,1,4,ts-global_detected_seizures,195908,195930,22
Jensen_Eisai_groupB,2,5,ts-global_detected_seizures,195973,195995,22
Jensen_Eisai_groupB,1,4,ts-global_detected_seizures,195987,196025,38
Jensen_Eisai_groupB,1,4,ts-global_detected_seizures,196026,196061,35
Jensen_Eisai_groupB,1,4,ts-global_detected_seizures,196079,196101,22
Jensen_Eisai_groupB,1,4,ts-global_detected_seizures,196113,196144,31
Jensen_Eisai_groupB,2,5,ts-global_detected_seizures,196200,196236,36
Jensen_Eisai_groupB,1,4,ts-global_detected_seizures,196242,196321,79
Jensen_Eisai_groupB,1,4,ts-global_detected_seizures,196242,196321,79
Jensen_Eisai_groupB,2,5,ts-global_detected_seizures,196285,196314,29
Jensen_Eisai_groupB,2,5,ts-global_detected_seizures,196327,196352,25
Jensen_Eisai_groupB,1,4,ts-global_detected_seizures,196361,196384,23
Jensen_Eisai_groupB,1,4,ts-global_detected_seizures,196391,196415,24
Jensen_Eisai_groupB,1,4,ts-global_detected_seizures,196425,196472,47
Jensen_Eisai_groupB,1,4,ts-global_detected_seizures,196485,196524,39
Jensen_Eisai_groupB,2,5,ts-global_detected_seizures,196544,196596,52
Jensen_Eisai_groupB,1,4,ts-global_detected_seizures,196555,196592,37
Jensen_Eisai_groupB,2,5,ts-global_detected_seizures,196597,196662,65
Jensen_Eisai_groupB,1,4,ts-global_detected_seizures,196608,196660,52
Jensen_Eisai_groupB,2,5,ts-global_detected_seizures,196674,196716,42
Jensen_Eisai_groupB,2,5,ts-global_detected_seizures,196739,196774,35
Jensen_Eisai_groupB,1,4,ts-global_detected_seizures,196751,196880,129
Jensen_Eisai_groupB,2,5,ts-global_detected_seizures,196780,196841,61
Jensen_Eisai_groupB,2,5,ts-global_detected_seizures,196846,196999,153
Jensen_Eisai_groupB,1,4,ts-global_detected_seizures,196889,196943,54
Jensen_Eisai_groupB,1,4,ts-global_detected_seizures,196944,196973,29
Jensen_Eisai_groupB,2,5,ts-global_detected_seizures,197006,197029,23
Jensen_Eisai_groupB,1,4,ts-global_detected_seizures,197011,197114,103
Jensen_Eisai_groupB,2,5,ts-global_detected_seizures,197070,197097,27
Jensen_Eisai_groupB,2,5,ts-global_detected_seizures,197108,197131,23
Jensen_Eisai_groupB,1,4,ts-global_detected_seizures,197115,197285,170
Jensen_Eisai_groupB,2,5,ts-global_detected_seizures,197137,197166,29
Jensen_Eisai_groupB,2,5,ts-global_detected_seizures,197207,197233,26
Jensen_Eisai_groupB,2,5,ts-global_detected_seizures,197245,197275,30
Jensen_Eisai_groupB,1,4,ts-global_detected_seizures,197287,197353,66
Jensen_Eisai_groupB,2,5,ts-global_detected_seizures,197296,197320,24
Jensen_Eisai_groupB,1,4,ts-global_detected_seizures,197354,197428,74
Jensen_Eisai_groupB,2,5,ts-global_detected_seizures,197360,197382,22
Jensen_Eisai_groupB,2,5,ts-global_detected_seizures,197406,197429,23
Jensen_Eisai_groupB,2,5,ts-global_detected_seizures,197498,197524,26
Jensen_Eisai_groupB,1,4,ts-global_detected_seizures,197533,197573,40
Jensen_Eisai_groupB,2,5,ts-global_detected_seizures,197596,197624,28
Jensen_Eisai_groupB,1,4,ts-global_detected_seizures,197626,197739,113
Jensen_Eisai_groupB,2,5,ts-global_detected_seizures,197645,198091,446
Jensen_Eisai_groupB,1,4,ts-global_detected_seizures,197794,197830,36
Jensen_Eisai_groupB,1,4,ts-global_detected_seizures,197869,197894,25
Jensen_Eisai_groupB,1,4,ts-global_detected_seizures,197902,197930,28
Jensen_Eisai_groupB,1,4,ts-global_detected_seizures,197951,197984,33
Jensen_Eisai_groupB,1,4,ts-global_detected_seizures,198018,198255,237
Jensen_Eisai_groupB,2,5,ts-global_detected_seizures,198092,198556,464
Jensen_Eisai_groupB,1,4,ts-global_detected_seizures,198272,198397,125
Jensen_Eisai_groupB,1,4,ts-global_detected_seizures,198407,198506,99
Jensen_Eisai_groupB,1,4,ts-global_detected_seizures,198507,198563,56
Jensen_Eisai_groupB,2,5,ts-global_detected_seizures,198557,199263,706
Jensen_Eisai_groupB,1,4,ts-global_detected_seizures,198613,198646,33
Jensen_Eisai_groupB,1,4,ts-global_detected_seizures,198664,198687,23
Jensen_Eisai_groupB,1,4,ts-global_detected_seizures,198689,198719,30
Jensen_Eisai_groupB,1,4,ts-global_detected_seizures,198765,198798,33
Jensen_Eisai_groupB,1,4,ts-global_detected_seizures,198873,198933,60
Jensen_Eisai_groupB,1,4,ts-global_detected_seizures,198982,199024,42
Jensen_Eisai_groupB,1,4,ts-global_detected_seizures,199048,199130,82
Jensen_Eisai_groupB,1,4,ts-global_detected_seizures,199131,199178,47
Jensen_Eisai_groupB,1,4,ts-global_detected_seizures,199202,199253,51
Jensen_Eisai_groupB,1,4,ts-global_detected_seizures,199288,199338,50
Jensen_Eisai_groupB,2,5,ts-global_detected_seizures,199302,199342,40
Jensen_Eisai_groupB,1,4,ts-global_detected_seizures,199345,199391,46
Jensen_Eisai_groupB,1,4,ts-global_detected_seizures,199427,199491,64
Jensen_Eisai_groupB,2,5,ts-global_detected_seizures,199464,199491,27
Jensen_Eisai_groupB,1,4,ts-global_detected_seizures,199501,199526,25
Jensen_Eisai_groupB,1,4,ts-global_detected_seizures,199532,199606,74
Jensen_Eisai_groupB,2,5,ts-global_detected_seizures,199615,199638,23
Jensen_Eisai_groupB,1,4,ts-global_detected_seizures,199622,199658,36
Jensen_Eisai_groupB,1,4,ts-global_detected_seizures,199680,199715,35
Jensen_Eisai_groupB,2,5,ts-global_detected_seizures,199731,199754,23
Jensen_Eisai_groupB,1,4,ts-global_detected_seizures,199743,199782,39
Jensen_Eisai_groupB,1,4,ts-global_detected_seizures,199804,199838,34
Jensen_Eisai_groupB,2,5,ts-global_detected_seizures,199833,199859,26
Jensen_Eisai_groupB,1,4,ts-global_detected_seizures,199872,199965,93
Jensen_Eisai_groupB,2,5,ts-global_detected_seizures,199969,200007,38
Jensen_Eisai_groupB,1,4,ts-global_detected_seizures,199982,200254,272
Jensen_Eisai_groupB,2,5,ts-global_detected_seizures,200074,200118,44
Jensen_Eisai_groupB,2,5,ts-global_detected_seizures,200198,200231,33
Jensen_Eisai_groupB,2,5,ts-global_detected_seizures,200248,200275,27
Jensen_Eisai_groupB,1,4,ts-global_detected_seizures,200255,200287,32
Jensen_Eisai_groupB,2,5,ts-global_detected_seizures,200277,200910,633
Jensen_Eisai_groupB,1,4,ts-global_detected_seizures,200300,200353,53
Jensen_Eisai_groupB,1,4,ts-global_detected_seizures,200354,200400,46
Jensen_Eisai_groupB,1,4,ts-global_detected_seizures,200401,200431,30
Jensen_Eisai_groupB,1,4,ts-global_detected_seizures,200490,200519,29
Jensen_Eisai_groupB,1,4,ts-global_detected_seizures,200520,200554,34
Jensen_Eisai_groupB,1,4,ts-global_detected_seizures,200565,200606,41
Jensen_Eisai_groupB,1,4,ts-global_detected_seizures,200638,200684,46
Jensen_Eisai_groupB,1,4,ts-global_detected_seizures,200707,200752,45
Jensen_Eisai_groupB,1,4,ts-global_detected_seizures,200759,200794,35
Jensen_Eisai_groupB,1,4,ts-global_detected_seizures,200846,200918,72
Jensen_Eisai_groupB,2,5,ts-global_detected_seizures,200914,200943,29
Jensen_Eisai_groupB,1,4,ts-global_detected_seizures,200947,201021,74
Jensen_Eisai_groupB,2,5,ts-global_detected_seizures,200963,200988,25
Jensen_Eisai_groupB,2,5,ts-global_detected_seizures,201040,201065,25
Jensen_Eisai_groupB,1,4,ts-global_detected_seizures,201046,201105,59
Jensen_Eisai_groupB,2,5,ts-global_detected_seizures,201112,201153,41
Jensen_Eisai_groupB,1,4,ts-global_detected_seizures,201140,201169,29
Jensen_Eisai_groupB,2,5,ts-global_detected_seizures,201200,201226,26
Jensen_Eisai_groupB,1,4,ts-global_detected_seizures,201209,201244,35
Jensen_Eisai_groupB,1,4,ts-global_detected_seizures,201258,201298,40
Jensen_Eisai_groupB,2,5,ts-global_detected_seizures,201263,201298,35
Jensen_Eisai_groupB,2,5,ts-global_detected_seizures,201309,201347,38
Jensen_Eisai_groupB,1,4,ts-global_detected_seizures,201310,201348,38
Jensen_Eisai_groupB,1,4,ts-global_detected_seizures,201384,201619,235
Jensen_Eisai_groupB,2,5,ts-global_detected_seizures,201427,201463,36
Jensen_Eisai_groupB,2,5,ts-global_detected_seizures,201570,201592,22
Jensen_Eisai_groupB,2,5,ts-global_detected_seizures,201610,201636,26
Jensen_Eisai_groupB,1,4,ts-global_detected_seizures,201643,201676,33
Jensen_Eisai_groupB,2,5,ts-global_detected_seizures,201676,201833,157
Jensen_Eisai_groupB,1,4,ts-global_detected_seizures,201694,201787,93
Jensen_Eisai_groupB,1,4,ts-global_detected_seizures,201800,201835,35
Jensen_Eisai_groupB,2,5,ts-global_detected_seizures,201862,201887,25
Jensen_Eisai_groupB,1,4,ts-global_detected_seizures,201892,201925,33
Jensen_Eisai_groupB,1,4,ts-global_detected_seizures,201936,201965,29
Jensen_Eisai_groupB,1,4,ts-global_detected_seizures,201966,202018,52
Jensen_Eisai_groupB,2,5,ts-global_detected_seizures,201968,201998,30
Jensen_Eisai_groupB,1,4,ts-global_detected_seizures,202032,202119,87
Jensen_Eisai_groupB,2,5,ts-global_detected_seizures,202135,202171,36
Jensen_Eisai_groupB,1,4,ts-global_detected_seizures,202148,202221,73
Jensen_Eisai_groupB,1,4,ts-global_detected_seizures,202259,202352,93
Jensen_Eisai_groupB,2,5,ts-global_detected_seizures,202298,202341,43
Jensen_Eisai_groupB,1,4,ts-global_detected_seizures,202356,202508,152
Jensen_Eisai_groupB,2,5,ts-global_detected_seizures,202397,202419,22
Jensen_Eisai_groupB,2,5,ts-global_detected_seizures,202428,202451,23
Jensen_Eisai_groupB,2,5,ts-global_detected_seizures,202478,202501,23
Jensen_Eisai_groupB,1,4,ts-global_detected_seizures,202513,202549,36
Jensen_Eisai_groupB,2,5,ts-global_detected_seizures,202562,202643,81
Jensen_Eisai_groupB,1,4,ts-global_detected_seizures,202564,202642,78
Jensen_Eisai_groupB,2,5,ts-global_detected_seizures,202644,202708,64
Jensen_Eisai_groupB,1,4,ts-global_detected_seizures,202670,202717,47
Jensen_Eisai_groupB,2,5,ts-global_detected_seizures,202729,202760,31
Jensen_Eisai_groupB,1,4,ts-global_detected_seizures,202738,202765,27
Jensen_Eisai_groupB,1,4,ts-global_detected_seizures,202766,202822,56
Jensen_Eisai_groupB,1,4,ts-global_detected_seizures,202823,204126,1303
Jensen_Eisai_groupB,2,5,ts-global_detected_seizures,202998,203034,36
Jensen_Eisai_groupB,2,5,ts-global_detected_seizures,203153,203181,28
Jensen_Eisai_groupB,2,5,ts-global_detected_seizures,203186,203215,29
Jensen_Eisai_groupB,2,5,ts-global_detected_seizures,203224,203271,47
Jensen_Eisai_groupB,2,5,ts-global_detected_seizures,203309,203334,25
Jensen_Eisai_groupB,2,5,ts-global_detected_seizures,203335,203371,36
Jensen_Eisai_groupB,2,5,ts-global_detected_seizures,203335,203371,36
Jensen_Eisai_groupB,2,5,ts-global_detected_seizures,203493,203534,41
Jensen_Eisai_groupB,2,5,ts-global_detected_seizures,203568,203596,28
Jensen_Eisai_groupB,2,5,ts-global_detected_seizures,203612,203644,32
Jensen_Eisai_groupB,2,5,ts-global_detected_seizures,203675,203699,24
Jensen_Eisai_groupB,3,6,ts-global_detected_seizures,203687,203889,202
Jensen_Eisai_groupB,2,5,ts-global_detected_seizures,203722,203756,34
Jensen_Eisai_groupB,2,5,ts-global_detected_seizures,203808,203870,62
Jensen_Eisai_groupB,2,5,ts-global_detected_seizures,203880,203913,33
Jensen_Eisai_groupB,3,6,ts-global_detected_seizures,203895,204079,184
Jensen_Eisai_groupB,2,5,ts-global_detected_seizures,203931,203959,28
Jensen_Eisai_groupB,2,5,ts-global_detected_seizures,203983,204025,42
Jensen_Eisai_groupB,2,5,ts-global_detected_seizures,204055,204087,32
Jensen_Eisai_groupB,3,6,ts-global_detected_seizures,204080,204139,59
Jensen_Eisai_groupB,2,5,ts-global_detected_seizures,204097,204130,33
Jensen_Eisai_groupB,1,4,ts-global_detected_seizures,204127,204218,91
Jensen_Eisai_groupB,3,6,ts-global_detected_seizures,204140,205475,1335
Jensen_Eisai_groupB,2,5,ts-global_detected_seizures,204153,204185,32
Jensen_Eisai_groupB,1,4,ts-global_detected_seizures,204219,204247,28
Jensen_Eisai_groupB,2,5,ts-global_detected_seizures,204234,204273,39
Jensen_Eisai_groupB,1,4,ts-global_detected_seizures,204264,204322,58
Jensen_Eisai_groupB,2,5,ts-global_detected_seizures,204304,204333,29
Jensen_Eisai_groupB,2,5,ts-global_detected_seizures,204342,204372,30
Jensen_Eisai_groupB,1,4,ts-global_detected_seizures,204404,204472,68
Jensen_Eisai_groupB,2,5,ts-global_detected_seizures,204410,204433,23
Jensen_Eisai_groupB,1,4,ts-global_detected_seizures,204475,204499,24
Jensen_Eisai_groupB,2,5,ts-global_detected_seizures,204501,204532,31
Jensen_Eisai_groupB,1,4,ts-global_detected_seizures,204570,204659,89
Jensen_Eisai_groupB,2,5,ts-global_detected_seizures,204590,204655,65
Jensen_Eisai_groupB,1,4,ts-global_detected_seizures,204678,204721,43
Jensen_Eisai_groupB,2,5,ts-global_detected_seizures,204702,204730,28
Jensen_Eisai_groupB,1,4,ts-global_detected_seizures,204741,204800,59
Jensen_Eisai_groupB,2,5,ts-global_detected_seizures,204789,204819,30
Jensen_Eisai_groupB,1,4,ts-global_detected_seizures,204810,204849,39
Jensen_Eisai_groupB,2,5,ts-global_detected_seizures,204890,204923,33
Jensen_Eisai_groupB,1,4,ts-global_detected_seizures,204962,205061,99
Jensen_Eisai_groupB,2,5,ts-global_detected_seizures,204970,205004,34
Jensen_Eisai_groupB,2,5,ts-global_detected_seizures,205051,205080,29
Jensen_Eisai_groupB,1,4,ts-global_detected_seizures,205064,205095,31
Jensen_Eisai_groupB,1,4,ts-global_detected_seizures,205096,205148,52
Jensen_Eisai_groupB,2,5,ts-global_detected_seizures,205123,205184,61
Jensen_Eisai_groupB,1,4,ts-global_detected_seizures,205175,205212,37
Jensen_Eisai_groupB,1,4,ts-global_detected_seizures,205214,205242,28
Jensen_Eisai_groupB,2,5,ts-global_detected_seizures,205225,205289,64
Jensen_Eisai_groupB,1,4,ts-global_detected_seizures,205249,205314,65
Jensen_Eisai_groupB,2,5,ts-global_detected_seizures,205290,205371,81
Jensen_Eisai_groupB,1,4,ts-global_detected_seizures,205322,205368,46
Jensen_Eisai_groupB,2,5,ts-global_detected_seizures,205374,205416,42
Jensen_Eisai_groupB,1,4,ts-global_detected_seizures,205400,205422,22
Jensen_Eisai_groupB,2,5,ts-global_detected_seizures,205435,205476,41
Jensen_Eisai_groupB,1,4,ts-global_detected_seizures,205439,205485,46
Jensen_Eisai_groupB,3,6,ts-global_detected_seizures,205476,205504,28
Jensen_Eisai_groupB,1,4,ts-global_detected_seizures,205492,205514,22
Jensen_Eisai_groupB,3,6,ts-global_detected_seizures,205505,208824,3319
Jensen_Eisai_groupB,1,4,ts-global_detected_seizures,205522,205556,34
Jensen_Eisai_groupB,1,4,ts-global_detected_seizures,205579,205939,360
Jensen_Eisai_groupB,2,5,ts-global_detected_seizures,205593,205633,40
Jensen_Eisai_groupB,2,5,ts-global_detected_seizures,205659,205692,33
Jensen_Eisai_groupB,2,5,ts-global_detected_seizures,205774,205798,24
Jensen_Eisai_groupB,2,5,ts-global_detected_seizures,205850,205881,31
Jensen_Eisai_groupB,2,5,ts-global_detected_seizures,205913,205937,24
Jensen_Eisai_groupB,1,4,ts-global_detected_seizures,205944,206087,143
Jensen_Eisai_groupB,2,5,ts-global_detected_seizures,205971,205999,28
Jensen_Eisai_groupB,2,5,ts-global_detected_seizures,206075,206116,41
Jensen_Eisai_groupB,1,4,ts-global_detected_seizures,206088,206120,32
Jensen_Eisai_groupB,1,4,ts-global_detected_seizures,206137,206192,55
Jensen_Eisai_groupB,2,5,ts-global_detected_seizures,206144,206332,188
Jensen_Eisai_groupB,1,4,ts-global_detected_seizures,206235,206266,31
Jensen_Eisai_groupB,1,4,ts-global_detected_seizures,206282,206337,55
Jensen_Eisai_groupB,2,5,ts-global_detected_seizures,206358,206387,29
Jensen_Eisai_groupB,1,4,ts-global_detected_seizures,206363,206410,47
Jensen_Eisai_groupB,1,4,ts-global_detected_seizures,206413,206452,39
Jensen_Eisai_groupB,1,4,ts-global_detected_seizures,206490,206513,23
Jensen_Eisai_groupB,2,5,ts-global_detected_seizures,206516,206547,31
Jensen_Eisai_groupB,1,4,ts-global_detected_seizures,206537,206583,46
Jensen_Eisai_groupB,2,5,ts-global_detected_seizures,206588,206614,26
Jensen_Eisai_groupB,1,4,ts-global_detected_seizures,206634,206657,23
Jensen_Eisai_groupB,2,5,ts-global_detected_seizures,206658,206680,22
Jensen_Eisai_groupB,1,4,ts-global_detected_seizures,206699,206721,22
Jensen_Eisai_groupB,1,4,ts-global_detected_seizures,206733,206761,28
Jensen_Eisai_groupB,1,4,ts-global_detected_seizures,206777,206802,25
Jensen_Eisai_groupB,1,4,ts-global_detected_seizures,206811,206940,129
Jensen_Eisai_groupB,2,5,ts-global_detected_seizures,206829,206861,32
Jensen_Eisai_groupB,2,5,ts-global_detected_seizures,206906,207185,279
Jensen_Eisai_groupB,1,4,ts-global_detected_seizures,206952,207011,59
Jensen_Eisai_groupB,1,4,ts-global_detected_seizures,207054,207134,80
Jensen_Eisai_groupB,1,4,ts-global_detected_seizures,207135,207170,35
Jensen_Eisai_groupB,1,4,ts-global_detected_seizures,207171,207199,28
Jensen_Eisai_groupB,2,5,ts-global_detected_seizures,207186,207222,36
Jensen_Eisai_groupB,1,4,ts-global_detected_seizures,207206,207238,32
Jensen_Eisai_groupB,2,5,ts-global_detected_seizures,207254,207280,26
Jensen_Eisai_groupB,2,5,ts-global_detected_seizures,207314,207340,26
Jensen_Eisai_groupB,1,4,ts-global_detected_seizures,207320,207362,42
Jensen_Eisai_groupB,2,5,ts-global_detected_seizures,207356,207396,40
Jensen_Eisai_groupB,1,4,ts-global_detected_seizures,207424,207474,50
Jensen_Eisai_groupB,2,5,ts-global_detected_seizures,207467,207501,34
Jensen_Eisai_groupB,1,4,ts-global_detected_seizures,207476,207606,130
Jensen_Eisai_groupB,2,5,ts-global_detected_seizures,207502,207553,51
Jensen_Eisai_groupB,1,4,ts-global_detected_seizures,207607,207635,28
Jensen_Eisai_groupB,1,4,ts-global_detected_seizures,207651,207698,47
Jensen_Eisai_groupB,2,5,ts-global_detected_seizures,207658,207697,39
Jensen_Eisai_groupB,2,5,ts-global_detected_seizures,207708,207762,54
Jensen_Eisai_groupB,1,4,ts-global_detected_seizures,207739,207793,54
Jensen_Eisai_groupB,1,4,ts-global_detected_seizures,207841,207883,42
Jensen_Eisai_groupB,2,5,ts-global_detected_seizures,207845,207879,34
Jensen_Eisai_groupB,1,4,ts-global_detected_seizures,207893,207929,36
Jensen_Eisai_groupB,1,4,ts-global_detected_seizures,207941,208018,77
Jensen_Eisai_groupB,2,5,ts-global_detected_seizures,207977,208007,30
Jensen_Eisai_groupB,1,4,ts-global_detected_seizures,208019,208071,52
Jensen_Eisai_groupB,2,5,ts-global_detected_seizures,208097,208123,26
Jensen_Eisai_groupB,1,4,ts-global_detected_seizures,208110,208221,111
Jensen_Eisai_groupB,2,5,ts-global_detected_seizures,208167,208199,32
Jensen_Eisai_groupB,1,4,ts-global_detected_seizures,208243,208266,23
Jensen_Eisai_groupB,2,5,ts-global_detected_seizures,208246,208268,22
Jensen_Eisai_groupB,2,5,ts-global_detected_seizures,208296,208330,34
Jensen_Eisai_groupB,1,4,ts-global_detected_seizures,208305,208405,100
Jensen_Eisai_groupB,2,5,ts-global_detected_seizures,208341,208415,74
Jensen_Eisai_groupB,1,4,ts-global_detected_seizures,208414,208550,136
Jensen_Eisai_groupB,2,5,ts-global_detected_seizures,208458,208513,55
Jensen_Eisai_groupB,1,4,ts-global_detected_seizures,208551,208588,37
Jensen_Eisai_groupB,2,5,ts-global_detected_seizures,208577,208607,30
Jensen_Eisai_groupB,1,4,ts-global_detected_seizures,208617,208675,58
Jensen_Eisai_groupB,1,4,ts-global_detected_seizures,208704,208748,44
Jensen_Eisai_groupB,2,5,ts-global_detected_seizures,208719,208742,23
Jensen_Eisai_groupB,1,4,ts-global_detected_seizures,208764,208813,49
Jensen_Eisai_groupB,2,5,ts-global_detected_seizures,208818,208855,37
Jensen_Eisai_groupB,3,6,ts-global_detected_seizures,208825,210141,1316
Jensen_Eisai_groupB,1,4,ts-global_detected_seizures,208862,208894,32
Jensen_Eisai_groupB,2,5,ts-global_detected_seizures,208911,208933,22
Jensen_Eisai_groupB,1,4,ts-global_detected_seizures,208917,208988,71
Jensen_Eisai_groupB,2,5,ts-global_detected_seizures,208950,209007,57
Jensen_Eisai_groupB,1,4,ts-global_detected_seizures,209018,209041,23
Jensen_Eisai_groupB,1,4,ts-global_detected_seizures,209044,209086,42
Jensen_Eisai_groupB,2,5,ts-global_detected_seizures,209066,209099,33
Jensen_Eisai_groupB,2,5,ts-global_detected_seizures,209103,209130,27
Jensen_Eisai_groupB,1,4,ts-global_detected_seizures,209119,209155,36
Jensen_Eisai_groupB,2,5,ts-global_detected_seizures,209164,209189,25
Jensen_Eisai_groupB,1,4,ts-global_detected_seizures,209199,209288,89
Jensen_Eisai_groupB,2,5,ts-global_detected_seizures,209216,209264,48
Jensen_Eisai_groupB,2,5,ts-global_detected_seizures,209294,209340,46
Jensen_Eisai_groupB,1,4,ts-global_detected_seizures,209311,209339,28
Jensen_Eisai_groupB,2,5,ts-global_detected_seizures,209342,209469,127
Jensen_Eisai_groupB,1,4,ts-global_detected_seizures,209378,210165,787
Jensen_Eisai_groupB,2,5,ts-global_detected_seizures,209555,209581,26
Jensen_Eisai_groupB,2,5,ts-global_detected_seizures,209594,209621,27
Jensen_Eisai_groupB,2,5,ts-global_detected_seizures,209650,209687,37
Jensen_Eisai_groupB,2,5,ts-global_detected_seizures,209707,210021,314
Jensen_Eisai_groupB,2,5,ts-global_detected_seizures,210022,210597,575
Jensen_Eisai_groupB,3,6,ts-global_detected_seizures,210142,210559,417
Jensen_Eisai_groupB,1,4,ts-global_detected_seizures,210166,210237,71
Jensen_Eisai_groupB,1,4,ts-global_detected_seizures,210246,210281,35
Jensen_Eisai_groupB,1,4,ts-global_detected_seizures,210282,210304,22
Jensen_Eisai_groupB,1,4,ts-global_detected_seizures,210309,210360,51
Jensen_Eisai_groupB,1,4,ts-global_detected_seizures,210492,210579,87
Jensen_Eisai_groupB,3,6,ts-global_detected_seizures,210560,211118,558
Jensen_Eisai_groupB,2,5,ts-global_detected_seizures,210598,210623,25
Jensen_Eisai_groupB,2,5,ts-global_detected_seizures,210624,210900,276
Jensen_Eisai_groupB,1,4,ts-global_detected_seizures,210711,210745,34
Jensen_Eisai_groupB,1,4,ts-global_detected_seizures,210801,211756,955
Jensen_Eisai_groupB,2,5,ts-global_detected_seizures,210901,210940,39
Jensen_Eisai_groupB,2,5,ts-global_detected_seizures,210954,210991,37
Jensen_Eisai_groupB,2,5,ts-global_detected_seizures,210999,211024,25
Jensen_Eisai_groupB,2,5,ts-global_detected_seizures,211052,211076,24
Jensen_Eisai_groupB,2,5,ts-global_detected_seizures,211087,211126,39
Jensen_Eisai_groupB,3,6,ts-global_detected_seizures,211133,211997,864
Jensen_Eisai_groupB,2,5,ts-global_detected_seizures,211193,211226,33
Jensen_Eisai_groupB,2,5,ts-global_detected_seizures,211246,211271,25
Jensen_Eisai_groupB,2,5,ts-global_detected_seizures,211304,211329,25
Jensen_Eisai_groupB,2,5,ts-global_detected_seizures,211409,211446,37
Jensen_Eisai_groupB,2,5,ts-global_detected_seizures,211458,211486,28
Jensen_Eisai_groupB,2,5,ts-global_detected_seizures,211603,211633,30
Jensen_Eisai_groupB,2,5,ts-global_detected_seizures,211644,211673,29
Jensen_Eisai_groupB,1,4,ts-global_detected_seizures,211757,211780,23
Jensen_Eisai_groupB,1,4,ts-global_detected_seizures,211804,211841,37
Jensen_Eisai_groupB,2,5,ts-global_detected_seizures,211809,211845,36
Jensen_Eisai_groupB,1,4,ts-global_detected_seizures,211875,211898,23
Jensen_Eisai_groupB,2,5,ts-global_detected_seizures,211880,211916,36
Jensen_Eisai_groupB,2,5,ts-global_detected_seizures,211918,211964,46
Jensen_Eisai_groupB,2,5,ts-global_detected_seizures,211984,212009,25
Jensen_Eisai_groupB,3,6,ts-global_detected_seizures,211998,212047,49
Jensen_Eisai_groupB,3,6,ts-global_detected_seizures,212048,212350,302
Jensen_Eisai_groupB,2,5,ts-global_detected_seizures,212065,212087,22
Jensen_Eisai_groupB,2,5,ts-global_detected_seizures,212112,212152,40
Jensen_Eisai_groupB,1,4,ts-global_detected_seizures,212118,212144,26
Jensen_Eisai_groupB,2,5,ts-global_detected_seizures,212165,212198,33
Jensen_Eisai_groupB,2,5,ts-global_detected_seizures,212220,212242,22
Jensen_Eisai_groupB,1,4,ts-global_detected_seizures,212263,212345,82
Jensen_Eisai_groupB,2,5,ts-global_detected_seizures,212314,212341,27
Jensen_Eisai_groupB,1,4,ts-global_detected_seizures,212346,212401,55
Jensen_Eisai_groupB,3,6,ts-global_detected_seizures,212351,212623,272
Jensen_Eisai_groupB,2,5,ts-global_detected_seizures,212389,212415,26
Jensen_Eisai_groupB,1,4,ts-global_detected_seizures,212403,212433,30
Jensen_Eisai_groupB,2,5,ts-global_detected_seizures,212436,212458,22
Jensen_Eisai_groupB,1,4,ts-global_detected_seizures,212443,212473,30
Jensen_Eisai_groupB,1,4,ts-global_detected_seizures,212486,212509,23
Jensen_Eisai_groupB,1,4,ts-global_detected_seizures,212534,212569,35
Jensen_Eisai_groupB,1,4,ts-global_detected_seizures,212585,212642,57
Jensen_Eisai_groupB,2,5,ts-global_detected_seizures,212592,212629,37
Jensen_Eisai_groupB,3,6,ts-global_detected_seizures,212624,213438,814
Jensen_Eisai_groupB,2,5,ts-global_detected_seizures,212634,212672,38
Jensen_Eisai_groupB,1,4,ts-global_detected_seizures,212646,212682,36
Jensen_Eisai_groupB,1,4,ts-global_detected_seizures,212691,212744,53
Jensen_Eisai_groupB,2,5,ts-global_detected_seizures,212748,212770,22
Jensen_Eisai_groupB,1,4,ts-global_detected_seizures,212764,212797,33
Jensen_Eisai_groupB,1,4,ts-global_detected_seizures,212814,212841,27
Jensen_Eisai_groupB,2,5,ts-global_detected_seizures,212818,212842,24
Jensen_Eisai_groupB,1,4,ts-global_detected_seizures,212880,213021,141
Jensen_Eisai_groupB,2,5,ts-global_detected_seizures,212896,212931,35
Jensen_Eisai_groupB,2,5,ts-global_detected_seizures,212958,212981,23
Jensen_Eisai_groupB,1,4,ts-global_detected_seizures,213053,213090,37
Jensen_Eisai_groupB,1,4,ts-global_detected_seizures,213098,213137,39
Jensen_Eisai_groupB,2,5,ts-global_detected_seizures,213121,213162,41
Jensen_Eisai_groupB,1,4,ts-global_detected_seizures,213142,213184,42
Jensen_Eisai_groupB,2,5,ts-global_detected_seizures,213193,213219,26
Jensen_Eisai_groupB,1,4,ts-global_detected_seizures,213228,213325,97
Jensen_Eisai_groupB,2,5,ts-global_detected_seizures,213295,213323,28
Jensen_Eisai_groupB,1,4,ts-global_detected_seizures,213327,214033,706
Jensen_Eisai_groupB,2,5,ts-global_detected_seizures,213339,213366,27
Jensen_Eisai_groupB,3,6,ts-global_detected_seizures,213439,214748,1309
Jensen_Eisai_groupB,2,5,ts-global_detected_seizures,213449,213474,25
Jensen_Eisai_groupB,2,5,ts-global_detected_seizures,213485,213535,50
Jensen_Eisai_groupB,2,5,ts-global_detected_seizures,213536,213594,58
Jensen_Eisai_groupB,2,5,ts-global_detected_seizures,213710,213746,36
Jensen_Eisai_groupB,2,5,ts-global_detected_seizures,213862,213892,30
Jensen_Eisai_groupB,2,5,ts-global_detected_seizures,213893,213915,22
Jensen_Eisai_groupB,2,5,ts-global_detected_seizures,213943,213979,36
Jensen_Eisai_groupB,2,5,ts-global_detected_seizures,214016,214056,40
Jensen_Eisai_groupB,1,4,ts-global_detected_seizures,214062,214125,63
Jensen_Eisai_groupB,1,4,ts-global_detected_seizures,214126,214148,22
Jensen_Eisai_groupB,1,4,ts-global_detected_seizures,214180,214686,506
Jensen_Eisai_groupB,2,5,ts-global_detected_seizures,214212,214236,24
Jensen_Eisai_groupB,2,5,ts-global_detected_seizures,214337,214374,37
Jensen_Eisai_groupB,2,5,ts-global_detected_seizures,214421,214526,105
Jensen_Eisai_groupB,2,5,ts-global_detected_seizures,214528,214649,121
Jensen_Eisai_groupB,2,5,ts-global_detected_seizures,214651,214695,44
Jensen_Eisai_groupB,1,4,ts-global_detected_seizures,214689,214793,104
Jensen_Eisai_groupB,2,5,ts-global_detected_seizures,214696,214841,145
Jensen_Eisai_groupB,3,6,ts-global_detected_seizures,214767,215382,615
Jensen_Eisai_groupB,1,4,ts-global_detected_seizures,214807,215223,416
Jensen_Eisai_groupB,2,5,ts-global_detected_seizures,214855,215317,462
Jensen_Eisai_groupB,1,4,ts-global_detected_seizures,215238,215289,51
Jensen_Eisai_groupB,1,4,ts-global_detected_seizures,215290,215467,177
Jensen_Eisai_groupB,2,5,ts-global_detected_seizures,215318,215509,191
Jensen_Eisai_groupB,3,6,ts-global_detected_seizures,215383,217658,2275
Jensen_Eisai_groupB,1,4,ts-global_detected_seizures,215468,215501,33
Jensen_Eisai_groupB,1,4,ts-global_detected_seizures,215502,216234,732
Jensen_Eisai_groupB,2,5,ts-global_detected_seizures,215533,215573,40
Jensen_Eisai_groupB,2,5,ts-global_detected_seizures,215574,215784,210
Jensen_Eisai_groupB,2,5,ts-global_detected_seizures,215817,215879,62
Jensen_Eisai_groupB,2,5,ts-global_detected_seizures,215925,215991,66
Jensen_Eisai_groupB,2,5,ts-global_detected_seizures,216004,216111,107
Jensen_Eisai_groupB,2,5,ts-global_detected_seizures,216116,216142,26
Jensen_Eisai_groupB,2,5,ts-global_detected_seizures,216144,216261,117
Jensen_Eisai_groupB,1,4,ts-global_detected_seizures,216235,216374,139
Jensen_Eisai_groupB,2,5,ts-global_detected_seizures,216262,216288,26
Jensen_Eisai_groupB,2,5,ts-global_detected_seizures,216339,216367,28
Jensen_Eisai_groupB,1,4,ts-global_detected_seizures,216389,216586,197
Jensen_Eisai_groupB,2,5,ts-global_detected_seizures,216426,216450,24
Jensen_Eisai_groupB,2,5,ts-global_detected_seizures,216452,216479,27
Jensen_Eisai_groupB,2,5,ts-global_detected_seizures,216522,216545,23
Jensen_Eisai_groupB,2,5,ts-global_detected_seizures,216577,216615,38
Jensen_Eisai_groupB,1,4,ts-global_detected_seizures,216587,216657,70
Jensen_Eisai_groupB,2,5,ts-global_detected_seizures,216647,216673,26
Jensen_Eisai_groupB,1,4,ts-global_detected_seizures,216658,216699,41
Jensen_Eisai_groupB,2,5,ts-global_detected_seizures,216674,216706,32
Jensen_Eisai_groupB,1,4,ts-global_detected_seizures,216700,216993,293
Jensen_Eisai_groupB,2,5,ts-global_detected_seizures,216753,216793,40
Jensen_Eisai_groupB,2,5,ts-global_detected_seizures,216794,216823,29
Jensen_Eisai_groupB,2,5,ts-global_detected_seizures,216837,216865,28
Jensen_Eisai_groupB,2,5,ts-global_detected_seizures,216866,216895,29
Jensen_Eisai_groupB,2,5,ts-global_detected_seizures,216934,216986,52
Jensen_Eisai_groupB,1,4,ts-global_detected_seizures,216994,217067,73
Jensen_Eisai_groupB,2,5,ts-global_detected_seizures,217003,217083,80
Jensen_Eisai_groupB,1,4,ts-global_detected_seizures,217068,217146,78
Jensen_Eisai_groupB,1,4,ts-global_detected_seizures,217147,217271,124
Jensen_Eisai_groupB,2,5,ts-global_detected_seizures,217171,217203,32
Jensen_Eisai_groupB,2,5,ts-global_detected_seizures,217213,217251,38
Jensen_Eisai_groupB,2,5,ts-global_detected_seizures,217253,217342,89
Jensen_Eisai_groupB,1,4,ts-global_detected_seizures,217272,217321,49
Jensen_Eisai_groupB,1,4,ts-global_detected_seizures,217322,217565,243
Jensen_Eisai_groupB,2,5,ts-global_detected_seizures,217343,217407,64
Jensen_Eisai_groupB,2,5,ts-global_detected_seizures,217408,217479,71
Jensen_Eisai_groupB,2,5,ts-global_detected_seizures,217511,217539,28
Jensen_Eisai_groupB,2,5,ts-global_detected_seizures,217540,217612,72
Jensen_Eisai_groupB,1,4,ts-global_detected_seizures,217567,217612,45
Jensen_Eisai_groupB,1,4,ts-global_detected_seizures,217618,217782,164
Jensen_Eisai_groupB,2,5,ts-global_detected_seizures,217628,217660,32
Jensen_Eisai_groupB,3,6,ts-global_detected_seizures,217659,218261,602
Jensen_Eisai_groupB,2,5,ts-global_detected_seizures,217662,217703,41
Jensen_Eisai_groupB,2,5,ts-global_detected_seizures,217717,217864,147
Jensen_Eisai_groupB,1,4,ts-global_detected_seizures,217857,217925,68
Jensen_Eisai_groupB,2,5,ts-global_detected_seizures,217865,217940,75
Jensen_Eisai_groupB,1,4,ts-global_detected_seizures,217931,217998,67
Jensen_Eisai_groupB,2,5,ts-global_detected_seizures,217941,217996,55
Jensen_Eisai_groupB,2,5,ts-global_detected_seizures,217997,218061,64
Jensen_Eisai_groupB,1,4,ts-global_detected_seizures,218019,218078,59
Jensen_Eisai_groupB,2,5,ts-global_detected_seizures,218100,218173,73
Jensen_Eisai_groupB,1,4,ts-global_detected_seizures,218111,218139,28
Jensen_Eisai_groupB,1,4,ts-global_detected_seizures,218140,218194,54
Jensen_Eisai_groupB,2,5,ts-global_detected_seizures,218174,218223,49
Jensen_Eisai_groupB,1,4,ts-global_detected_seizures,218195,218265,70
Jensen_Eisai_groupB,2,5,ts-global_detected_seizures,218260,218317,57
Jensen_Eisai_groupB,3,6,ts-global_detected_seizures,218262,225047,6785
Jensen_Eisai_groupB,1,4,ts-global_detected_seizures,218277,218401,124
Jensen_Eisai_groupB,2,5,ts-global_detected_seizures,218320,218342,22
Jensen_Eisai_groupB,2,5,ts-global_detected_seizures,218344,218479,135
Jensen_Eisai_groupB,1,4,ts-global_detected_seizures,218421,218443,22
Jensen_Eisai_groupB,2,5,ts-global_detected_seizures,218481,218547,66
Jensen_Eisai_groupB,1,4,ts-global_detected_seizures,218543,218567,24
Jensen_Eisai_groupB,2,5,ts-global_detected_seizures,218558,218610,52
Jensen_Eisai_groupB,1,4,ts-global_detected_seizures,218571,218609,38
Jensen_Eisai_groupB,2,5,ts-global_detected_seizures,218611,218651,40
Jensen_Eisai_groupB,2,5,ts-global_detected_seizures,218652,218687,35
Jensen_Eisai_groupB,1,4,ts-global_detected_seizures,218674,218737,63
Jensen_Eisai_groupB,1,4,ts-global_detected_seizures,218739,218770,31
Jensen_Eisai_groupB,1,4,ts-global_detected_seizures,218771,218979,208
Jensen_Eisai_groupB,1,4,ts-global_detected_seizures,218980,219053,73
Jensen_Eisai_groupB,2,5,ts-global_detected_seizures,219036,219067,31
Jensen_Eisai_groupB,1,4,ts-global_detected_seizures,219054,219161,107
Jensen_Eisai_groupB,2,5,ts-global_detected_seizures,219131,219163,32
Jensen_Eisai_groupB,1,4,ts-global_detected_seizures,219162,219213,51
Jensen_Eisai_groupB,2,5,ts-global_detected_seizures,219165,219248,83
Jensen_Eisai_groupB,1,4,ts-global_detected_seizures,219214,219246,32
Jensen_Eisai_groupB,1,4,ts-global_detected_seizures,219247,219309,62
Jensen_Eisai_groupB,2,5,ts-global_detected_seizures,219249,219272,23
Jensen_Eisai_groupB,2,5,ts-global_detected_seizures,219274,219327,53
Jensen_Eisai_groupB,1,4,ts-global_detected_seizures,219310,219334,24
Jensen_Eisai_groupB,2,5,ts-global_detected_seizures,219328,219399,71
Jensen_Eisai_groupB,1,4,ts-global_detected_seizures,219353,219393,40
Jensen_Eisai_groupB,1,4,ts-global_detected_seizures,219394,219425,31
Jensen_Eisai_groupB,2,5,ts-global_detected_seizures,219400,219443,43
Jensen_Eisai_groupB,1,4,ts-global_detected_seizures,219429,219570,141
Jensen_Eisai_groupB,2,5,ts-global_detected_seizures,219454,219485,31
Jensen_Eisai_groupB,2,5,ts-global_detected_seizures,219534,219559,25
Jensen_Eisai_groupB,2,5,ts-global_detected_seizures,219563,219586,23
Jensen_Eisai_groupB,1,4,ts-global_detected_seizures,219572,219631,59
Jensen_Eisai_groupB,2,5,ts-global_detected_seizures,219625,219838,213
Jensen_Eisai_groupB,1,4,ts-global_detected_seizures,219632,219655,23
Jensen_Eisai_groupB,1,4,ts-global_detected_seizures,219656,219720,64
Jensen_Eisai_groupB,1,4,ts-global_detected_seizures,219722,219774,52
Jensen_Eisai_groupB,1,4,ts-global_detected_seizures,219781,220028,247
Jensen_Eisai_groupB,2,5,ts-global_detected_seizures,219839,220192,353
Jensen_Eisai_groupB,1,4,ts-global_detected_seizures,220029,220554,525
Jensen_Eisai_groupB,2,5,ts-global_detected_seizures,220193,220231,38
Jensen_Eisai_groupB,2,5,ts-global_detected_seizures,220251,220548,297
Jensen_Eisai_groupB,1,4,ts-global_detected_seizures,220570,220641,71
Jensen_Eisai_groupB,1,4,ts-global_detected_seizures,220642,221012,370
Jensen_Eisai_groupB,2,5,ts-global_detected_seizures,220660,220685,25
Jensen_Eisai_groupB,2,5,ts-global_detected_seizures,220734,220760,26
Jensen_Eisai_groupB,2,5,ts-global_detected_seizures,220869,220895,26
Jensen_Eisai_groupB,1,4,ts-global_detected_seizures,221033,221410,377
Jensen_Eisai_groupB,2,5,ts-global_detected_seizures,221082,221104,22
Jensen_Eisai_groupB,2,5,ts-global_detected_seizures,221206,221229,23
Jensen_Eisai_groupB,2,5,ts-global_detected_seizures,221380,221604,224
Jensen_Eisai_groupB,1,4,ts-global_detected_seizures,221424,221584,160
Jensen_Eisai_groupB,1,4,ts-global_detected_seizures,221585,221849,264
Jensen_Eisai_groupB,2,5,ts-global_detected_seizures,221635,221659,24
Jensen_Eisai_groupB,2,5,ts-global_detected_seizures,221725,221757,32
Jensen_Eisai_groupB,2,5,ts-global_detected_seizures,221795,221825,30
Jensen_Eisai_groupB,1,4,ts-global_detected_seizures,221855,221953,98
Jensen_Eisai_groupB,2,5,ts-global_detected_seizures,221907,221983,76
Jensen_Eisai_groupB,1,4,ts-global_detected_seizures,221954,222165,211
Jensen_Eisai_groupB,2,5,ts-global_detected_seizures,222112,222134,22
Jensen_Eisai_groupB,1,4,ts-global_detected_seizures,222166,222219,53
Jensen_Eisai_groupB,1,4,ts-global_detected_seizures,222220,222272,52
Jensen_Eisai_groupB,1,4,ts-global_detected_seizures,222273,222368,95
Jensen_Eisai_groupB,2,5,ts-global_detected_seizures,222311,222349,38
Jensen_Eisai_groupB,2,5,ts-global_detected_seizures,222360,222636,276
Jensen_Eisai_groupB,1,4,ts-global_detected_seizures,222381,222441,60
Jensen_Eisai_groupB,1,4,ts-global_detected_seizures,222442,222464,22
Jensen_Eisai_groupB,1,4,ts-global_detected_seizures,222465,222543,78
Jensen_Eisai_groupB,1,4,ts-global_detected_seizures,222544,223200,656
Jensen_Eisai_groupB,2,5,ts-global_detected_seizures,222637,223045,408
Jensen_Eisai_groupB,2,5,ts-global_detected_seizures,223058,223091,33
Jensen_Eisai_groupB,2,5,ts-global_detected_seizures,223092,223330,238
Jensen_Eisai_groupB,1,4,ts-global_detected_seizures,223201,223408,207
Jensen_Eisai_groupB,2,5,ts-global_detected_seizures,223331,223361,30
Jensen_Eisai_groupB,2,5,ts-global_detected_seizures,223362,223456,94
Jensen_Eisai_groupB,1,4,ts-global_detected_seizures,223409,223677,268
Jensen_Eisai_groupB,2,5,ts-global_detected_seizures,223569,223603,34
Jensen_Eisai_groupB,2,5,ts-global_detected_seizures,223627,223713,86
Jensen_Eisai_groupB,1,4,ts-global_detected_seizures,223679,223735,56
Jensen_Eisai_groupB,1,4,ts-global_detected_seizures,223741,224187,446
Jensen_Eisai_groupB,2,5,ts-global_detected_seizures,223837,223861,24
Jensen_Eisai_groupB,2,5,ts-global_detected_seizures,224065,224107,42
Jensen_Eisai_groupB,1,4,ts-global_detected_seizures,224188,224799,611
Jensen_Eisai_groupB,2,5,ts-global_detected_seizures,224207,224230,23
Jensen_Eisai_groupB,2,5,ts-global_detected_seizures,224277,224308,31
Jensen_Eisai_groupB,2,5,ts-global_detected_seizures,224383,224409,26
Jensen_Eisai_groupB,2,5,ts-global_detected_seizures,224412,224445,33
Jensen_Eisai_groupB,2,5,ts-global_detected_seizures,224488,224511,23
Jensen_Eisai_groupB,2,5,ts-global_detected_seizures,224519,224543,24
Jensen_Eisai_groupB,2,5,ts-global_detected_seizures,224660,225210,550
Jensen_Eisai_groupB,1,4,ts-global_detected_seizures,224800,224852,52
Jensen_Eisai_groupB,1,4,ts-global_detected_seizures,224853,225327,474
Jensen_Eisai_groupB,3,6,ts-global_detected_seizures,225048,229342,4294
Jensen_Eisai_groupB,2,5,ts-global_detected_seizures,225214,225302,88
Jensen_Eisai_groupB,2,5,ts-global_detected_seizures,225303,225417,114
Jensen_Eisai_groupB,1,4,ts-global_detected_seizures,225328,225595,267
Jensen_Eisai_groupB,2,5,ts-global_detected_seizures,225436,225723,287
Jensen_Eisai_groupB,1,4,ts-global_detected_seizures,225596,225978,382
Jensen_Eisai_groupB,2,5,ts-global_detected_seizures,225747,225779,32
Jensen_Eisai_groupB,2,5,ts-global_detected_seizures,225813,225921,108
Jensen_Eisai_groupB,1,4,ts-global_detected_seizures,225997,226030,33
Jensen_Eisai_groupB,2,5,ts-global_detected_seizures,226027,226050,23
Jensen_Eisai_groupB,1,4,ts-global_detected_seizures,226032,226079,47
Jensen_Eisai_groupB,2,5,ts-global_detected_seizures,226054,226076,22
Jensen_Eisai_groupB,1,4,ts-global_detected_seizures,226081,226164,83
Jensen_Eisai_groupB,1,4,ts-global_detected_seizures,226240,226413,173
Jensen_Eisai_groupB,1,4,ts-global_detected_seizures,226415,226505,90
Jensen_Eisai_groupB,1,4,ts-global_detected_seizures,226507,226693,186
Jensen_Eisai_groupB,2,5,ts-global_detected_seizures,226545,226571,26
Jensen_Eisai_groupB,2,5,ts-global_detected_seizures,226572,226643,71
Jensen_Eisai_groupB,2,5,ts-global_detected_seizures,226654,226677,23
Jensen_Eisai_groupB,1,4,ts-global_detected_seizures,226694,226775,81
Jensen_Eisai_groupB,1,4,ts-global_detected_seizures,226776,226954,178
Jensen_Eisai_groupB,2,5,ts-global_detected_seizures,226856,226883,27
Jensen_Eisai_groupB,1,4,ts-global_detected_seizures,226955,227933,978
Jensen_Eisai_groupB,2,5,ts-global_detected_seizures,227066,227090,24
Jensen_Eisai_groupB,2,5,ts-global_detected_seizures,227130,227546,416
Jensen_Eisai_groupB,2,5,ts-global_detected_seizures,227547,227570,23
Jensen_Eisai_groupB,2,5,ts-global_detected_seizures,227571,227595,24
Jensen_Eisai_groupB,2,5,ts-global_detected_seizures,227655,227679,24
Jensen_Eisai_groupB,2,5,ts-global_detected_seizures,227684,227721,37
Jensen_Eisai_groupB,2,5,ts-global_detected_seizures,227722,227751,29
Jensen_Eisai_groupB,2,5,ts-global_detected_seizures,227813,227838,25
Jensen_Eisai_groupB,2,5,ts-global_detected_seizures,227853,228005,152
Jensen_Eisai_groupB,1,4,ts-global_detected_seizures,227934,227964,30
Jensen_Eisai_groupB,1,4,ts-global_detected_seizures,227965,228600,635
Jensen_Eisai_groupB,2,5,ts-global_detected_seizures,228256,228278,22
Jensen_Eisai_groupB,2,5,ts-global_detected_seizures,228322,228352,30
Jensen_Eisai_groupB,2,5,ts-global_detected_seizures,228556,228605,49
Jensen_Eisai_groupB,1,4,ts-global_detected_seizures,228601,228797,196
Jensen_Eisai_groupB,2,5,ts-global_detected_seizures,228707,228732,25
Jensen_Eisai_groupB,2,5,ts-global_detected_seizures,228766,228792,26
Jensen_Eisai_groupB,1,4,ts-global_detected_seizures,228808,228951,143
Jensen_Eisai_groupB,2,5,ts-global_detected_seizures,228829,228851,22
Jensen_Eisai_groupB,2,5,ts-global_detected_seizures,228937,228999,62
Jensen_Eisai_groupB,1,4,ts-global_detected_seizures,228952,229070,118
Jensen_Eisai_groupB,2,5,ts-global_detected_seizures,229000,229023,23
Jensen_Eisai_groupB,2,5,ts-global_detected_seizures,229024,229098,74
Jensen_Eisai_groupB,1,4,ts-global_detected_seizures,229101,229153,52
Jensen_Eisai_groupB,2,5,ts-global_detected_seizures,229110,229135,25
Jensen_Eisai_groupB,2,5,ts-global_detected_seizures,229158,229188,30
Jensen_Eisai_groupB,1,4,ts-global_detected_seizures,229210,229240,30
Jensen_Eisai_groupB,2,5,ts-global_detected_seizures,229301,229330,29
Jensen_Eisai_groupB,1,4,ts-global_detected_seizures,229319,229534,215
Jensen_Eisai_groupB,3,6,ts-global_detected_seizures,229343,235312,5969
Jensen_Eisai_groupB,2,5,ts-global_detected_seizures,229375,229398,23
Jensen_Eisai_groupB,2,5,ts-global_detected_seizures,229507,229531,24
Jensen_Eisai_groupB,2,5,ts-global_detected_seizures,229665,229690,25
Jensen_Eisai_groupB,2,5,ts-global_detected_seizures,229692,229714,22
Jensen_Eisai_groupB,1,4,ts-global_detected_seizures,229713,229735,22
Jensen_Eisai_groupB,2,5,ts-global_detected_seizures,229718,229951,233
Jensen_Eisai_groupB,1,4,ts-global_detected_seizures,229755,229780,25
Jensen_Eisai_groupB,2,5,ts-global_detected_seizures,229952,229994,42
Jensen_Eisai_groupB,2,5,ts-global_detected_seizures,230003,230045,42
Jensen_Eisai_groupB,1,4,ts-global_detected_seizures,230047,230166,119
Jensen_Eisai_groupB,2,5,ts-global_detected_seizures,230071,230094,23
Jensen_Eisai_groupB,2,5,ts-global_detected_seizures,230107,230131,24
Jensen_Eisai_groupB,2,5,ts-global_detected_seizures,230147,230171,24
Jensen_Eisai_groupB,2,5,ts-global_detected_seizures,230237,230264,27
Jensen_Eisai_groupB,2,5,ts-global_detected_seizures,230265,230296,31
Jensen_Eisai_groupB,2,5,ts-global_detected_seizures,230317,230351,34
Jensen_Eisai_groupB,2,5,ts-global_detected_seizures,230369,230613,244
Jensen_Eisai_groupB,2,5,ts-global_detected_seizures,230615,230680,65
Jensen_Eisai_groupB,2,5,ts-global_detected_seizures,230681,230710,29
Jensen_Eisai_groupB,2,5,ts-global_detected_seizures,230729,230777,48
Jensen_Eisai_groupB,2,5,ts-global_detected_seizures,230778,231003,225
Jensen_Eisai_groupB,1,4,ts-global_detected_seizures,230856,230927,71
Jensen_Eisai_groupB,2,5,ts-global_detected_seizures,231004,231041,37
Jensen_Eisai_groupB,1,4,ts-global_detected_seizures,231023,231051,28
Jensen_Eisai_groupB,2,5,ts-global_detected_seizures,231042,231404,362
Jensen_Eisai_groupB,1,4,ts-global_detected_seizures,231342,231410,68
Jensen_Eisai_groupB,2,5,ts-global_detected_seizures,231405,231706,301
Jensen_Eisai_groupB,1,4,ts-global_detected_seizures,231618,231645,27
Jensen_Eisai_groupB,1,4,ts-global_detected_seizures,231687,231710,23
Jensen_Eisai_groupB,2,5,ts-global_detected_seizures,231707,232229,522
Jensen_Eisai_groupB,1,4,ts-global_detected_seizures,231730,231755,25
Jensen_Eisai_groupB,1,4,ts-global_detected_seizures,231797,231820,23
Jensen_Eisai_groupB,1,4,ts-global_detected_seizures,231966,232000,34
Jensen_Eisai_groupB,1,4,ts-global_detected_seizures,232017,232054,37
Jensen_Eisai_groupB,1,4,ts-global_detected_seizures,232137,232181,44
Jensen_Eisai_groupB,2,5,ts-global_detected_seizures,232255,232284,29
Jensen_Eisai_groupB,1,4,ts-global_detected_seizures,232311,232335,24
Jensen_Eisai_groupB,2,5,ts-global_detected_seizures,232380,232410,30
Jensen_Eisai_groupB,1,4,ts-global_detected_seizures,232389,232420,31
Jensen_Eisai_groupB,2,5,ts-global_detected_seizures,232470,232498,28
Jensen_Eisai_groupB,1,4,ts-global_detected_seizures,232476,232540,64
Jensen_Eisai_groupB,2,5,ts-global_detected_seizures,232513,232535,22
Jensen_Eisai_groupB,2,5,ts-global_detected_seizures,232548,232850,302
Jensen_Eisai_groupB,1,4,ts-global_detected_seizures,232549,233052,503
Jensen_Eisai_groupB,2,5,ts-global_detected_seizures,232910,233886,976
Jensen_Eisai_groupB,1,4,ts-global_detected_seizures,233053,233424,371
Jensen_Eisai_groupB,1,4,ts-global_detected_seizures,233425,233737,312
Jensen_Eisai_groupB,1,4,ts-global_detected_seizures,233738,233931,193
Jensen_Eisai_groupB,2,5,ts-global_detected_seizures,233893,234046,153
Jensen_Eisai_groupB,1,4,ts-global_detected_seizures,233932,234212,280
Jensen_Eisai_groupB,2,5,ts-global_detected_seizures,234047,234318,271
Jensen_Eisai_groupB,1,4,ts-global_detected_seizures,234213,234991,778
Jensen_Eisai_groupB,2,5,ts-global_detected_seizures,234319,234378,59
Jensen_Eisai_groupB,2,5,ts-global_detected_seizures,234476,234500,24
Jensen_Eisai_groupB,2,5,ts-global_detected_seizures,234633,234664,31
Jensen_Eisai_groupB,2,5,ts-global_detected_seizures,234728,234750,22
Jensen_Eisai_groupB,2,5,ts-global_detected_seizures,234837,234867,30
Jensen_Eisai_groupB,2,5,ts-global_detected_seizures,234979,235005,26
Jensen_Eisai_groupB,1,4,ts-global_detected_seizures,234992,235249,257
Jensen_Eisai_groupB,2,5,ts-global_detected_seizures,235123,235152,29
Jensen_Eisai_groupB,1,4,ts-global_detected_seizures,235250,235733,483
Jensen_Eisai_groupB,2,5,ts-global_detected_seizures,235307,235337,30
Jensen_Eisai_groupB,3,6,ts-global_detected_seizures,235313,237154,1841
Jensen_Eisai_groupB,2,5,ts-global_detected_seizures,235344,235380,36
Jensen_Eisai_groupB,2,5,ts-global_detected_seizures,235382,235406,24
Jensen_Eisai_groupB,2,5,ts-global_detected_seizures,235449,235476,27
Jensen_Eisai_groupB,2,5,ts-global_detected_seizures,235538,235563,25
Jensen_Eisai_groupB,2,5,ts-global_detected_seizures,235587,235614,27
Jensen_Eisai_groupB,2,5,ts-global_detected_seizures,235634,235656,22
Jensen_Eisai_groupB,2,5,ts-global_detected_seizures,235695,235726,31
Jensen_Eisai_groupB,1,4,ts-global_detected_seizures,235734,236744,1010
Jensen_Eisai_groupB,2,5,ts-global_detected_seizures,235780,235818,38
Jensen_Eisai_groupB,2,5,ts-global_detected_seizures,235860,235885,25
Jensen_Eisai_groupB,2,5,ts-global_detected_seizures,235894,235951,57
Jensen_Eisai_groupB,2,5,ts-global_detected_seizures,235991,236043,52
Jensen_Eisai_groupB,2,5,ts-global_detected_seizures,236110,236143,33
Jensen_Eisai_groupB,2,5,ts-global_detected_seizures,236188,236221,33
Jensen_Eisai_groupB,2,5,ts-global_detected_seizures,236269,236305,36
Jensen_Eisai_groupB,2,5,ts-global_detected_seizures,236321,236353,32
Jensen_Eisai_groupB,2,5,ts-global_detected_seizures,236379,236414,35
Jensen_Eisai_groupB,2,5,ts-global_detected_seizures,236472,236537,65
Jensen_Eisai_groupB,2,5,ts-global_detected_seizures,236601,236628,27
Jensen_Eisai_groupB,2,5,ts-global_detected_seizures,236638,236664,26
Jensen_Eisai_groupB,1,4,ts-global_detected_seizures,236745,236946,201
Jensen_Eisai_groupB,2,5,ts-global_detected_seizures,236819,236859,40
Jensen_Eisai_groupB,2,5,ts-global_detected_seizures,236919,236956,37
Jensen_Eisai_groupB,1,4,ts-global_detected_seizures,236947,238278,1331
Jensen_Eisai_groupB,2,5,ts-global_detected_seizures,237022,237496,474
Jensen_Eisai_groupB,3,6,ts-global_detected_seizures,237155,237371,216
Jensen_Eisai_groupB,3,6,ts-global_detected_seizures,237389,238571,1182
Jensen_Eisai_groupB,2,5,ts-global_detected_seizures,237497,237916,419
Jensen_Eisai_groupB,2,5,ts-global_detected_seizures,237917,237971,54
Jensen_Eisai_groupB,2,5,ts-global_detected_seizures,237972,238650,678
Jensen_Eisai_groupB,1,4,ts-global_detected_seizures,238279,238894,615
Jensen_Eisai_groupB,3,6,ts-global_detected_seizures,238572,243005,4433
Jensen_Eisai_groupB,2,5,ts-global_detected_seizures,238660,238786,126
Jensen_Eisai_groupB,2,5,ts-global_detected_seizures,238788,239140,352
Jensen_Eisai_groupB,1,4,ts-global_detected_seizures,238895,239042,147
Jensen_Eisai_groupB,1,4,ts-global_detected_seizures,239043,239255,212
Jensen_Eisai_groupB,2,5,ts-global_detected_seizures,239142,240035,893
Jensen_Eisai_groupB,1,4,ts-global_detected_seizures,239256,240116,860
Jensen_Eisai_groupB,2,5,ts-global_detected_seizures,240037,240347,310
Jensen_Eisai_groupB,1,4,ts-global_detected_seizures,240117,242395,2278
Jensen_Eisai_groupB,2,5,ts-global_detected_seizures,240371,240401,30
Jensen_Eisai_groupB,2,5,ts-global_detected_seizures,240436,240461,25
Jensen_Eisai_groupB,2,5,ts-global_detected_seizures,240548,240620,72
Jensen_Eisai_groupB,2,5,ts-global_detected_seizures,240630,240662,32
Jensen_Eisai_groupB,2,5,ts-global_detected_seizures,240755,240838,83
Jensen_Eisai_groupB,2,5,ts-global_detected_seizures,240849,240881,32
Jensen_Eisai_groupB,2,5,ts-global_detected_seizures,240947,240970,23
Jensen_Eisai_groupB,2,5,ts-global_detected_seizures,241018,241060,42
Jensen_Eisai_groupB,2,5,ts-global_detected_seizures,241091,241141,50
Jensen_Eisai_groupB,2,5,ts-global_detected_seizures,241203,241226,23
Jensen_Eisai_groupB,2,5,ts-global_detected_seizures,241256,241324,68
Jensen_Eisai_groupB,2,5,ts-global_detected_seizures,241325,241369,44
Jensen_Eisai_groupB,2,5,ts-global_detected_seizures,241406,241441,35
Jensen_Eisai_groupB,2,5,ts-global_detected_seizures,241442,241472,30
Jensen_Eisai_groupB,2,5,ts-global_detected_seizures,241479,241503,24
Jensen_Eisai_groupB,2,5,ts-global_detected_seizures,241606,241661,55
Jensen_Eisai_groupB,2,5,ts-global_detected_seizures,241699,241727,28
Jensen_Eisai_groupB,2,5,ts-global_detected_seizures,241748,241801,53
Jensen_Eisai_groupB,2,5,ts-global_detected_seizures,241845,241867,22
Jensen_Eisai_groupB,2,5,ts-global_detected_seizures,241890,241921,31
Jensen_Eisai_groupB,2,5,ts-global_detected_seizures,241947,242003,56
Jensen_Eisai_groupB,2,5,ts-global_detected_seizures,242062,242114,52
Jensen_Eisai_groupB,2,5,ts-global_detected_seizures,242133,242162,29
Jensen_Eisai_groupB,2,5,ts-global_detected_seizures,242183,242205,22
Jensen_Eisai_groupB,2,5,ts-global_detected_seizures,242245,242279,34
Jensen_Eisai_groupB,2,5,ts-global_detected_seizures,242358,242386,28
Jensen_Eisai_groupB,1,4,ts-global_detected_seizures,242413,242438,25
Jensen_Eisai_groupB,1,4,ts-global_detected_seizures,242449,242480,31
Jensen_Eisai_groupB,2,5,ts-global_detected_seizures,242493,242530,37
Jensen_Eisai_groupB,2,5,ts-global_detected_seizures,242533,242569,36
Jensen_Eisai_groupB,1,4,ts-global_detected_seizures,242559,242938,379
Jensen_Eisai_groupB,2,5,ts-global_detected_seizures,242619,242699,80
Jensen_Eisai_groupB,2,5,ts-global_detected_seizures,242760,242807,47
Jensen_Eisai_groupB,2,5,ts-global_detected_seizures,242881,242920,39
Jensen_Eisai_groupB,1,4,ts-global_detected_seizures,242941,242963,22
Jensen_Eisai_groupB,2,5,ts-global_detected_seizures,242944,242980,36
Jensen_Eisai_groupB,3,6,ts-global_detected_seizures,243006,246143,3137
Jensen_Eisai_groupB,2,5,ts-global_detected_seizures,243008,243092,84
Jensen_Eisai_groupB,2,5,ts-global_detected_seizures,243094,243118,24
Jensen_Eisai_groupB,1,4,ts-global_detected_seizures,243103,243140,37
Jensen_Eisai_groupB,2,5,ts-global_detected_seizures,243130,243280,150
Jensen_Eisai_groupB,1,4,ts-global_detected_seizures,243142,243190,48
Jensen_Eisai_groupB,2,5,ts-global_detected_seizures,243281,243351,70
Jensen_Eisai_groupB,1,4,ts-global_detected_seizures,243362,243385,23
Jensen_Eisai_groupB,2,5,ts-global_detected_seizures,243374,243397,23
Jensen_Eisai_groupB,2,5,ts-global_detected_seizures,243437,243473,36
Jensen_Eisai_groupB,1,4,ts-global_detected_seizures,243453,243485,32
Jensen_Eisai_groupB,2,5,ts-global_detected_seizures,243575,243610,35
Jensen_Eisai_groupB,1,4,ts-global_detected_seizures,243623,243657,34
Jensen_Eisai_groupB,2,5,ts-global_detected_seizures,243759,243781,22
Jensen_Eisai_groupB,1,4,ts-global_detected_seizures,243858,243885,27
Jensen_Eisai_groupB,2,5,ts-global_detected_seizures,243874,243925,51
Jensen_Eisai_groupB,2,5,ts-global_detected_seizures,244033,244068,35
Jensen_Eisai_groupB,1,4,ts-global_detected_seizures,244041,244069,28
Jensen_Eisai_groupB,1,4,ts-global_detected_seizures,244120,244142,22
Jensen_Eisai_groupB,2,5,ts-global_detected_seizures,244148,244214,66
Jensen_Eisai_groupB,1,4,ts-global_detected_seizures,244213,244263,50
Jensen_Eisai_groupB,2,5,ts-global_detected_seizures,244239,244316,77
Jensen_Eisai_groupB,1,4,ts-global_detected_seizures,244265,244348,83
Jensen_Eisai_groupB,2,5,ts-global_detected_seizures,244317,244341,24
Jensen_Eisai_groupB,2,5,ts-global_detected_seizures,244365,244420,55
Jensen_Eisai_groupB,1,4,ts-global_detected_seizures,244440,244463,23
Jensen_Eisai_groupB,2,5,ts-global_detected_seizures,244445,244536,91
Jensen_Eisai_groupB,2,5,ts-global_detected_seizures,244537,245644,1107
Jensen_Eisai_groupB,1,4,ts-global_detected_seizures,244578,244602,24
Jensen_Eisai_groupB,1,4,ts-global_detected_seizures,244719,244748,29
Jensen_Eisai_groupB,1,4,ts-global_detected_seizures,244784,244822,38
Jensen_Eisai_groupB,1,4,ts-global_detected_seizures,244906,244990,84
Jensen_Eisai_groupB,1,4,ts-global_detected_seizures,245050,245076,26
Jensen_Eisai_groupB,1,4,ts-global_detected_seizures,245173,245205,32
Jensen_Eisai_groupB,1,4,ts-global_detected_seizures,245251,245276,25
Jensen_Eisai_groupB,1,4,ts-global_detected_seizures,245371,245426,55
Jensen_Eisai_groupB,1,4,ts-global_detected_seizures,245572,245594,22
Jensen_Eisai_groupB,1,4,ts-global_detected_seizures,245605,245684,79
Jensen_Eisai_groupB,2,5,ts-global_detected_seizures,245645,246579,934
Jensen_Eisai_groupB,1,4,ts-global_detected_seizures,245685,245720,35
Jensen_Eisai_groupB,1,4,ts-global_detected_seizures,245731,245772,41
Jensen_Eisai_groupB,1,4,ts-global_detected_seizures,245919,245953,34
Jensen_Eisai_groupB,1,4,ts-global_detected_seizures,246017,246048,31
Jensen_Eisai_groupB,1,4,ts-global_detected_seizures,246049,246080,31
Jensen_Eisai_groupB,3,6,ts-global_detected_seizures,246144,253143,6999
Jensen_Eisai_groupB,3,6,ts-global_detected_seizures,246144,253143,6999
Jensen_Eisai_groupB,1,4,ts-global_detected_seizures,246154,246250,96
Jensen_Eisai_groupB,1,4,ts-global_detected_seizures,246299,246341,42
Jensen_Eisai_groupB,1,4,ts-global_detected_seizures,246362,246415,53
Jensen_Eisai_groupB,1,4,ts-global_detected_seizures,246418,246458,40
Jensen_Eisai_groupB,1,4,ts-global_detected_seizures,246459,247699,1240
Jensen_Eisai_groupB,2,5,ts-global_detected_seizures,246580,246981,401
Jensen_Eisai_groupB,2,5,ts-global_detected_seizures,246996,247018,22
Jensen_Eisai_groupB,2,5,ts-global_detected_seizures,247065,247089,24
Jensen_Eisai_groupB,2,5,ts-global_detected_seizures,247130,247162,32
Jensen_Eisai_groupB,2,5,ts-global_detected_seizures,247228,247292,64
Jensen_Eisai_groupB,2,5,ts-global_detected_seizures,247309,247344,35
Jensen_Eisai_groupB,2,5,ts-global_detected_seizures,247395,247420,25
Jensen_Eisai_groupB,2,5,ts-global_detected_seizures,247436,247471,35
Jensen_Eisai_groupB,2,5,ts-global_detected_seizures,247571,247615,44
Jensen_Eisai_groupB,2,5,ts-global_detected_seizures,247616,247640,24
Jensen_Eisai_groupB,2,5,ts-global_detected_seizures,247653,247706,53
Jensen_Eisai_groupB,1,4,ts-global_detected_seizures,247700,250269,2569
Jensen_Eisai_groupB,2,5,ts-global_detected_seizures,247718,247769,51
Jensen_Eisai_groupB,2,5,ts-global_detected_seizures,247808,247844,36
Jensen_Eisai_groupB,2,5,ts-global_detected_seizures,247900,247933,33
Jensen_Eisai_groupB,2,5,ts-global_detected_seizures,248015,248051,36
Jensen_Eisai_groupB,2,5,ts-global_detected_seizures,248109,249051,942
Jensen_Eisai_groupB,2,5,ts-global_detected_seizures,249061,249303,242
Jensen_Eisai_groupB,2,5,ts-global_detected_seizures,249342,249367,25
Jensen_Eisai_groupB,2,5,ts-global_detected_seizures,249470,249508,38
Jensen_Eisai_groupB,2,5,ts-global_detected_seizures,249537,249564,27
Jensen_Eisai_groupB,2,5,ts-global_detected_seizures,249598,249647,49
Jensen_Eisai_groupB,2,5,ts-global_detected_seizures,249723,249762,39
Jensen_Eisai_groupB,2,5,ts-global_detected_seizures,249809,249833,24
Jensen_Eisai_groupB,2,5,ts-global_detected_seizures,249999,250031,32
Jensen_Eisai_groupB,2,5,ts-global_detected_seizures,250155,250188,33
Jensen_Eisai_groupB,2,5,ts-global_detected_seizures,250196,250226,30
Jensen_Eisai_groupB,2,5,ts-global_detected_seizures,250245,250280,35
Jensen_Eisai_groupB,2,5,ts-global_detected_seizures,250282,250307,25
Jensen_Eisai_groupB,1,4,ts-global_detected_seizures,250290,250315,25
Jensen_Eisai_groupB,2,5,ts-global_detected_seizures,250411,250441,30
Jensen_Eisai_groupB,1,4,ts-global_detected_seizures,250440,250478,38
Jensen_Eisai_groupB,2,5,ts-global_detected_seizures,250455,250493,38
Jensen_Eisai_groupB,2,5,ts-global_detected_seizures,250510,250549,39
Jensen_Eisai_groupB,2,5,ts-global_detected_seizures,250572,250597,25
Jensen_Eisai_groupB,1,4,ts-global_detected_seizures,250608,250657,49
Jensen_Eisai_groupB,2,5,ts-global_detected_seizures,250628,250668,40
Jensen_Eisai_groupB,1,4,ts-global_detected_seizures,250659,250695,36
Jensen_Eisai_groupB,2,5,ts-global_detected_seizures,250730,250774,44
Jensen_Eisai_groupB,2,5,ts-global_detected_seizures,250823,250856,33
Jensen_Eisai_groupB,2,5,ts-global_detected_seizures,250870,250905,35
Jensen_Eisai_groupB,2,5,ts-global_detected_seizures,250929,250973,44
Jensen_Eisai_groupB,2,5,ts-global_detected_seizures,250975,250997,22
Jensen_Eisai_groupB,1,4,ts-global_detected_seizures,250993,251096,103
Jensen_Eisai_groupB,2,5,ts-global_detected_seizures,250998,251031,33
Jensen_Eisai_groupB,2,5,ts-global_detected_seizures,251064,251260,196
Jensen_Eisai_groupB,1,4,ts-global_detected_seizures,251135,251172,37
Jensen_Eisai_groupB,1,4,ts-global_detected_seizures,251254,251285,31
Jensen_Eisai_groupB,2,5,ts-global_detected_seizures,251261,251411,150
Jensen_Eisai_groupB,1,4,ts-global_detected_seizures,251297,251323,26
Jensen_Eisai_groupB,1,4,ts-global_detected_seizures,251360,251404,44
Jensen_Eisai_groupB,2,5,ts-global_detected_seizures,251426,251460,34
Jensen_Eisai_groupB,2,5,ts-global_detected_seizures,251493,251515,22
Jensen_Eisai_groupB,2,5,ts-global_detected_seizures,251546,251568,22
Jensen_Eisai_groupB,1,4,ts-global_detected_seizures,251547,251573,26
Jensen_Eisai_groupB,1,4,ts-global_detected_seizures,251588,251611,23
Jensen_Eisai_groupB,2,5,ts-global_detected_seizures,251619,251649,30
Jensen_Eisai_groupB,1,4,ts-global_detected_seizures,251680,251761,81
Jensen_Eisai_groupB,2,5,ts-global_detected_seizures,251715,251745,30
Jensen_Eisai_groupB,1,4,ts-global_detected_seizures,251790,251825,35
Jensen_Eisai_groupB,2,5,ts-global_detected_seizures,251861,251887,26
Jensen_Eisai_groupB,1,4,ts-global_detected_seizures,251899,251924,25
Jensen_Eisai_groupB,1,4,ts-global_detected_seizures,251925,251954,29
Jensen_Eisai_groupB,1,4,ts-global_detected_seizures,251974,252019,45
Jensen_Eisai_groupB,2,5,ts-global_detected_seizures,251977,252000,23
Jensen_Eisai_groupB,2,5,ts-global_detected_seizures,252020,252056,36
Jensen_Eisai_groupB,1,4,ts-global_detected_seizures,252080,252106,26
Jensen_Eisai_groupB,1,4,ts-global_detected_seizures,252140,252184,44
Jensen_Eisai_groupB,2,5,ts-global_detected_seizures,252156,252180,24
Jensen_Eisai_groupB,1,4,ts-global_detected_seizures,252187,252212,25
Jensen_Eisai_groupB,1,4,ts-global_detected_seizures,252246,252274,28
Jensen_Eisai_groupB,2,5,ts-global_detected_seizures,252248,252277,29
Jensen_Eisai_groupB,1,4,ts-global_detected_seizures,252303,252358,55
Jensen_Eisai_groupB,2,5,ts-global_detected_seizures,252315,252347,32
Jensen_Eisai_groupB,1,4,ts-global_detected_seizures,252382,252409,27
Jensen_Eisai_groupB,2,5,ts-global_detected_seizures,252383,252407,24
Jensen_Eisai_groupB,2,5,ts-global_detected_seizures,252408,252468,60
Jensen_Eisai_groupB,2,5,ts-global_detected_seizures,252469,252502,33
Jensen_Eisai_groupB,1,4,ts-global_detected_seizures,252491,252589,98
Jensen_Eisai_groupB,2,5,ts-global_detected_seizures,252503,252694,191
Jensen_Eisai_groupB,1,4,ts-global_detected_seizures,252590,252642,52
Jensen_Eisai_groupB,1,4,ts-global_detected_seizures,252685,252767,82
Jensen_Eisai_groupB,2,5,ts-global_detected_seizures,252723,252758,35
Jensen_Eisai_groupB,2,5,ts-global_detected_seizures,252765,252792,27
Jensen_Eisai_groupB,1,4,ts-global_detected_seizures,252786,252841,55
Jensen_Eisai_groupB,2,5,ts-global_detected_seizures,252797,252826,29
Jensen_Eisai_groupB,1,4,ts-global_detected_seizures,252843,252930,87
Jensen_Eisai_groupB,1,4,ts-global_detected_seizures,252931,253104,173
Jensen_Eisai_groupB,2,5,ts-global_detected_seizures,252959,252991,32
Jensen_Eisai_groupB,2,5,ts-global_detected_seizures,253027,253070,43
Jensen_Eisai_groupB,2,5,ts-global_detected_seizures,253089,253120,31
Jensen_Eisai_groupB,1,4,ts-global_detected_seizures,253105,253131,26
Jensen_Eisai_groupB,2,5,ts-global_detected_seizures,253137,253167,30
Jensen_Eisai_groupB,3,6,ts-global_detected_seizures,253144,253301,157
Jensen_Eisai_groupB,1,4,ts-global_detected_seizures,253147,253200,53
Jensen_Eisai_groupB,2,5,ts-global_detected_seizures,253223,253251,28
Jensen_Eisai_groupB,1,4,ts-global_detected_seizures,253288,253313,25
Jensen_Eisai_groupB,2,5,ts-global_detected_seizures,253299,253376,77
Jensen_Eisai_groupB,3,6,ts-global_detected_seizures,253302,253336,34
Jensen_Eisai_groupB,1,4,ts-global_detected_seizures,253314,253367,53
Jensen_Eisai_groupB,3,6,ts-global_detected_seizures,253337,253666,329
Jensen_Eisai_groupB,1,4,ts-global_detected_seizures,253375,253417,42
Jensen_Eisai_groupB,1,4,ts-global_detected_seizures,253419,253471,52
Jensen_Eisai_groupB,2,5,ts-global_detected_seizures,253460,253488,28
Jensen_Eisai_groupB,1,4,ts-global_detected_seizures,253495,253689,194
Jensen_Eisai_groupB,2,5,ts-global_detected_seizures,253608,253644,36
Jensen_Eisai_groupB,2,5,ts-global_detected_seizures,253653,253676,23
Jensen_Eisai_groupB,3,6,ts-global_detected_seizures,253667,253828,161
Jensen_Eisai_groupB,2,5,ts-global_detected_seizures,253717,253743,26
Jensen_Eisai_groupB,3,6,ts-global_detected_seizures,253829,259039,5210
Jensen_Eisai_groupB,2,5,ts-global_detected_seizures,253850,253888,38
Jensen_Eisai_groupB,1,4,ts-global_detected_seizures,253854,253877,23
Jensen_Eisai_groupB,2,5,ts-global_detected_seizures,253903,254001,98
Jensen_Eisai_groupB,1,4,ts-global_detected_seizures,253908,258073,4165
Jensen_Eisai_groupB,2,5,ts-global_detected_seizures,254067,254096,29
Jensen_Eisai_groupB,2,5,ts-global_detected_seizures,254132,254195,63
Jensen_Eisai_groupB,2,5,ts-global_detected_seizures,254221,254255,34
Jensen_Eisai_groupB,2,5,ts-global_detected_seizures,254303,254353,50
Jensen_Eisai_groupB,2,5,ts-global_detected_seizures,254358,254400,42
Jensen_Eisai_groupB,2,5,ts-global_detected_seizures,254401,254433,32
Jensen_Eisai_groupB,2,5,ts-global_detected_seizures,254468,254494,26
Jensen_Eisai_groupB,2,5,ts-global_detected_seizures,254561,254604,43
Jensen_Eisai_groupB,2,5,ts-global_detected_seizures,254614,254642,28
Jensen_Eisai_groupB,2,5,ts-global_detected_seizures,254717,254753,36
Jensen_Eisai_groupB,2,5,ts-global_detected_seizures,254772,254807,35
Jensen_Eisai_groupB,2,5,ts-global_detected_seizures,254840,254879,39
Jensen_Eisai_groupB,2,5,ts-global_detected_seizures,254884,254919,35
Jensen_Eisai_groupB,2,5,ts-global_detected_seizures,254949,254991,42
Jensen_Eisai_groupB,2,5,ts-global_detected_seizures,255028,255052,24
Jensen_Eisai_groupB,2,5,ts-global_detected_seizures,255062,256785,1723
Jensen_Eisai_groupB,2,5,ts-global_detected_seizures,256814,256879,65
Jensen_Eisai_groupB,2,5,ts-global_detected_seizures,256969,257088,119
Jensen_Eisai_groupB,2,5,ts-global_detected_seizures,257089,259039,1950
Jensen_Eisai_groupB,1,4,ts-global_detected_seizures,258090,258121,31
Jensen_Eisai_groupB,1,4,ts-global_detected_seizures,258135,258175,40
Jensen_Eisai_groupB,1,4,ts-global_detected_seizures,258176,259039,863
Jensen_Eisai_groupB,3,6,ts-global_detected_seizures,259508,259669,161
Jensen_Eisai_groupB,3,6,ts-global_detected_seizures,259670,260097,427
Jensen_Eisai_groupB,2,5,ts-global_detected_seizures,259675,259869,194
Jensen_Eisai_groupB,1,4,ts-global_detected_seizures,259850,259954,104
Jensen_Eisai_groupB,2,5,ts-global_detected_seizures,259870,259902,32
Jensen_Eisai_groupB,2,5,ts-global_detected_seizures,259913,259950,37
Jensen_Eisai_groupB,2,5,ts-global_detected_seizures,259951,260024,73
Jensen_Eisai_groupB,1,4,ts-global_detected_seizures,259955,260046,91
Jensen_Eisai_groupB,2,5,ts-global_detected_seizures,260026,260105,79
Jensen_Eisai_groupB,1,4,ts-global_detected_seizures,260049,260075,26
Jensen_Eisai_groupB,1,4,ts-global_detected_seizures,260093,260157,64
Jensen_Eisai_groupB,3,6,ts-global_detected_seizures,260098,260855,757
Jensen_Eisai_groupB,2,5,ts-global_detected_seizures,260109,260133,24
Jensen_Eisai_groupB,2,5,ts-global_detected_seizures,260134,260161,27
Jensen_Eisai_groupB,1,4,ts-global_detected_seizures,260159,260218,59
Jensen_Eisai_groupB,2,5,ts-global_detected_seizures,260162,260209,47
Jensen_Eisai_groupB,2,5,ts-global_detected_seizures,260217,260313,96
Jensen_Eisai_groupB,1,4,ts-global_detected_seizures,260220,260290,70
Jensen_Eisai_groupB,2,5,ts-global_detected_seizures,260314,260344,30
Jensen_Eisai_groupB,1,4,ts-global_detected_seizures,260341,260414,73
Jensen_Eisai_groupB,2,5,ts-global_detected_seizures,260345,260368,23
Jensen_Eisai_groupB,2,5,ts-global_detected_seizures,260391,260432,41
Jensen_Eisai_groupB,1,4,ts-global_detected_seizures,260430,260464,34
Jensen_Eisai_groupB,2,5,ts-global_detected_seizures,260433,260473,40
Jensen_Eisai_groupB,1,4,ts-global_detected_seizures,260467,260653,186
Jensen_Eisai_groupB,2,5,ts-global_detected_seizures,260474,260543,69
Jensen_Eisai_groupB,2,5,ts-global_detected_seizures,260544,260566,22
Jensen_Eisai_groupB,2,5,ts-global_detected_seizures,260567,260600,33
Jensen_Eisai_groupB,2,5,ts-global_detected_seizures,260601,260626,25
Jensen_Eisai_groupB,2,5,ts-global_detected_seizures,260627,260672,45
Jensen_Eisai_groupB,1,4,ts-global_detected_seizures,260655,260911,256
Jensen_Eisai_groupB,2,5,ts-global_detected_seizures,260685,260712,27
Jensen_Eisai_groupB,2,5,ts-global_detected_seizures,260713,260769,56
Jensen_Eisai_groupB,2,5,ts-global_detected_seizures,260770,260799,29
Jensen_Eisai_groupB,2,5,ts-global_detected_seizures,260800,260831,31
Jensen_Eisai_groupB,2,5,ts-global_detected_seizures,260853,260920,67
Jensen_Eisai_groupB,3,6,ts-global_detected_seizures,260856,277089,16233
Jensen_Eisai_groupB,2,5,ts-global_detected_seizures,260932,260957,25
Jensen_Eisai_groupB,1,4,ts-global_detected_seizures,260953,260981,28
Jensen_Eisai_groupB,1,4,ts-global_detected_seizures,261020,261073,53
Jensen_Eisai_groupB,2,5,ts-global_detected_seizures,261024,261068,44
Jensen_Eisai_groupB,1,4,ts-global_detected_seizures,261074,261196,122
Jensen_Eisai_groupB,2,5,ts-global_detected_seizures,261079,261150,71
Jensen_Eisai_groupB,2,5,ts-global_detected_seizures,261157,261210,53
Jensen_Eisai_groupB,1,4,ts-global_detected_seizures,261197,261248,51
Jensen_Eisai_groupB,2,5,ts-global_detected_seizures,261232,261280,48
Jensen_Eisai_groupB,1,4,ts-global_detected_seizures,261269,261817,548
Jensen_Eisai_groupB,2,5,ts-global_detected_seizures,261281,261334,53
Jensen_Eisai_groupB,2,5,ts-global_detected_seizures,261337,261369,32
Jensen_Eisai_groupB,2,5,ts-global_detected_seizures,261405,261455,50
Jensen_Eisai_groupB,2,5,ts-global_detected_seizures,261516,261570,54
Jensen_Eisai_groupB,2,5,ts-global_detected_seizures,261647,261687,40
Jensen_Eisai_groupB,2,5,ts-global_detected_seizures,261688,261734,46
Jensen_Eisai_groupB,2,5,ts-global_detected_seizures,261735,261779,44
Jensen_Eisai_groupB,1,4,ts-global_detected_seizures,261818,261874,56
Jensen_Eisai_groupB,2,5,ts-global_detected_seizures,261827,261857,30
Jensen_Eisai_groupB,2,5,ts-global_detected_seizures,261871,261895,24
Jensen_Eisai_groupB,1,4,ts-global_detected_seizures,261879,261901,22
Jensen_Eisai_groupB,1,4,ts-global_detected_seizures,261906,262102,196
Jensen_Eisai_groupB,2,5,ts-global_detected_seizures,261968,262034,66
Jensen_Eisai_groupB,2,5,ts-global_detected_seizures,262038,262073,35
Jensen_Eisai_groupB,2,5,ts-global_detected_seizures,262082,262131,49
Jensen_Eisai_groupB,1,4,ts-global_detected_seizures,262113,262225,112
Jensen_Eisai_groupB,2,5,ts-global_detected_seizures,262132,262170,38
Jensen_Eisai_groupB,2,5,ts-global_detected_seizures,262181,262203,22
Jensen_Eisai_groupB,2,5,ts-global_detected_seizures,262212,262246,34
Jensen_Eisai_groupB,1,4,ts-global_detected_seizures,262242,262360,118
Jensen_Eisai_groupB,2,5,ts-global_detected_seizures,262323,262378,55
Jensen_Eisai_groupB,1,4,ts-global_detected_seizures,262368,262395,27
Jensen_Eisai_groupB,1,4,ts-global_detected_seizures,262397,262515,118
Jensen_Eisai_groupB,2,5,ts-global_detected_seizures,262402,262429,27
Jensen_Eisai_groupB,2,5,ts-global_detected_seizures,262438,262468,30
Jensen_Eisai_groupB,2,5,ts-global_detected_seizures,262491,262513,22
Jensen_Eisai_groupB,1,4,ts-global_detected_seizures,262516,262548,32
Jensen_Eisai_groupB,1,4,ts-global_detected_seizures,262565,262808,243
Jensen_Eisai_groupB,2,5,ts-global_detected_seizures,262706,262743,37
Jensen_Eisai_groupB,2,5,ts-global_detected_seizures,262744,262810,66
Jensen_Eisai_groupB,2,5,ts-global_detected_seizures,262811,262868,57
Jensen_Eisai_groupB,1,4,ts-global_detected_seizures,262853,262879,26
Jensen_Eisai_groupB,1,4,ts-global_detected_seizures,262930,262970,40
Jensen_Eisai_groupB,2,5,ts-global_detected_seizures,262934,262972,38
Jensen_Eisai_groupB,2,5,ts-global_detected_seizures,262934,262972,38
Jensen_Eisai_groupB,2,5,ts-global_detected_seizures,262995,263027,32
Jensen_Eisai_groupB,2,5,ts-global_detected_seizures,263049,263110,61
Jensen_Eisai_groupB,2,5,ts-global_detected_seizures,263112,263148,36
Jensen_Eisai_groupB,1,4,ts-global_detected_seizures,263151,263184,33
Jensen_Eisai_groupB,1,4,ts-global_detected_seizures,263313,263448,135
Jensen_Eisai_groupB,2,5,ts-global_detected_seizures,263365,263387,22
Jensen_Eisai_groupB,2,5,ts-global_detected_seizures,263417,263523,106
Jensen_Eisai_groupB,1,4,ts-global_detected_seizures,263535,263601,66
Jensen_Eisai_groupB,1,4,ts-global_detected_seizures,263665,263697,32
Jensen_Eisai_groupB,2,5,ts-global_detected_seizures,263702,263724,22
Jensen_Eisai_groupB,2,5,ts-global_detected_seizures,263737,263837,100
Jensen_Eisai_groupB,1,4,ts-global_detected_seizures,263853,263892,39
Jensen_Eisai_groupB,1,4,ts-global_detected_seizures,263919,263944,25
Jensen_Eisai_groupB,2,5,ts-global_detected_seizures,263947,263971,24
Jensen_Eisai_groupB,1,4,ts-global_detected_seizures,263973,264043,70
Jensen_Eisai_groupB,2,5,ts-global_detected_seizures,264047,264079,32
Jensen_Eisai_groupB,1,4,ts-global_detected_seizures,264065,264089,24
Jensen_Eisai_groupB,1,4,ts-global_detected_seizures,264146,264174,28
Jensen_Eisai_groupB,1,4,ts-global_detected_seizures,264236,264301,65
Jensen_Eisai_groupB,2,5,ts-global_detected_seizures,264257,264314,57
Jensen_Eisai_groupB,1,4,ts-global_detected_seizures,264310,264360,50
Jensen_Eisai_groupB,1,4,ts-global_detected_seizures,264361,264400,39
Jensen_Eisai_groupB,2,5,ts-global_detected_seizures,264491,264616,125
Jensen_Eisai_groupB,1,4,ts-global_detected_seizures,264495,264524,29
Jensen_Eisai_groupB,1,4,ts-global_detected_seizures,264602,264644,42
Jensen_Eisai_groupB,2,5,ts-global_detected_seizures,264617,264672,55
Jensen_Eisai_groupB,1,4,ts-global_detected_seizures,264645,264701,56
Jensen_Eisai_groupB,2,5,ts-global_detected_seizures,264687,264990,303
Jensen_Eisai_groupB,1,4,ts-global_detected_seizures,264731,264768,37
Jensen_Eisai_groupB,1,4,ts-global_detected_seizures,264805,264846,41
Jensen_Eisai_groupB,1,4,ts-global_detected_seizures,264908,264933,25
Jensen_Eisai_groupB,1,4,ts-global_detected_seizures,264953,264990,37
Jensen_Eisai_groupB,2,5,ts-global_detected_seizures,264991,265122,131
Jensen_Eisai_groupB,1,4,ts-global_detected_seizures,265024,265056,32
Jensen_Eisai_groupB,1,4,ts-global_detected_seizures,265105,265136,31
Jensen_Eisai_groupB,2,5,ts-global_detected_seizures,265124,265151,27
Jensen_Eisai_groupB,1,4,ts-global_detected_seizures,265137,265164,27
Jensen_Eisai_groupB,2,5,ts-global_detected_seizures,265152,265225,73
Jensen_Eisai_groupB,1,4,ts-global_detected_seizures,265175,265222,47
Jensen_Eisai_groupB,2,5,ts-global_detected_seizures,265226,265289,63
Jensen_Eisai_groupB,1,4,ts-global_detected_seizures,265258,265300,42
Jensen_Eisai_groupB,2,5,ts-global_detected_seizures,265297,265324,27
Jensen_Eisai_groupB,1,4,ts-global_detected_seizures,265301,265431,130
Jensen_Eisai_groupB,2,5,ts-global_detected_seizures,265326,265488,162
Jensen_Eisai_groupB,1,4,ts-global_detected_seizures,265450,265511,61
Jensen_Eisai_groupB,2,5,ts-global_detected_seizures,265489,265814,325
Jensen_Eisai_groupB,1,4,ts-global_detected_seizures,265517,265543,26
Jensen_Eisai_groupB,1,4,ts-global_detected_seizures,265544,265581,37
Jensen_Eisai_groupB,1,4,ts-global_detected_seizures,265646,265680,34
Jensen_Eisai_groupB,1,4,ts-global_detected_seizures,265729,265763,34
Jensen_Eisai_groupB,2,5,ts-global_detected_seizures,265815,265850,35
Jensen_Eisai_groupB,1,4,ts-global_detected_seizures,265831,265856,25
Jensen_Eisai_groupB,2,5,ts-global_detected_seizures,265860,265882,22
Jensen_Eisai_groupB,1,4,ts-global_detected_seizures,265865,265894,29
Jensen_Eisai_groupB,1,4,ts-global_detected_seizures,265925,266014,89
Jensen_Eisai_groupB,1,4,ts-global_detected_seizures,266032,266054,22
Jensen_Eisai_groupB,1,4,ts-global_detected_seizures,266063,266092,29
Jensen_Eisai_groupB,1,4,ts-global_detected_seizures,266110,266155,45
Jensen_Eisai_groupB,1,4,ts-global_detected_seizures,266177,266199,22
Jensen_Eisai_groupB,1,4,ts-global_detected_seizures,266260,266297,37
Jensen_Eisai_groupB,2,5,ts-global_detected_seizures,266301,266333,32
Jensen_Eisai_groupB,1,4,ts-global_detected_seizures,266348,268239,1891
Jensen_Eisai_groupB,2,5,ts-global_detected_seizures,266349,266380,31
Jensen_Eisai_groupB,2,5,ts-global_detected_seizures,266485,266514,29
Jensen_Eisai_groupB,2,5,ts-global_detected_seizures,266637,266662,25
Jensen_Eisai_groupB,2,5,ts-global_detected_seizures,266735,266779,44
Jensen_Eisai_groupB,2,5,ts-global_detected_seizures,266864,266887,23
Jensen_Eisai_groupB,2,5,ts-global_detected_seizures,266998,267030,32
Jensen_Eisai_groupB,2,5,ts-global_detected_seizures,267233,267258,25
Jensen_Eisai_groupB,2,5,ts-global_detected_seizures,267310,267342,32
Jensen_Eisai_groupB,2,5,ts-global_detected_seizures,267382,267407,25
Jensen_Eisai_groupB,2,5,ts-global_detected_seizures,267430,267452,22
Jensen_Eisai_groupB,2,5,ts-global_detected_seizures,267478,267532,54
Jensen_Eisai_groupB,2,5,ts-global_detected_seizures,267774,267796,22
Jensen_Eisai_groupB,2,5,ts-global_detected_seizures,267814,267855,41
Jensen_Eisai_groupB,2,5,ts-global_detected_seizures,267894,267918,24
Jensen_Eisai_groupB,2,5,ts-global_detected_seizures,267957,267979,22
Jensen_Eisai_groupB,2,5,ts-global_detected_seizures,267992,268024,32
Jensen_Eisai_groupB,2,5,ts-global_detected_seizures,268071,268093,22
Jensen_Eisai_groupB,2,5,ts-global_detected_seizures,268156,268208,52
Jensen_Eisai_groupB,2,5,ts-global_detected_seizures,268225,268258,33
Jensen_Eisai_groupB,1,4,ts-global_detected_seizures,268240,268538,298
Jensen_Eisai_groupB,2,5,ts-global_detected_seizures,268278,268307,29
Jensen_Eisai_groupB,2,5,ts-global_detected_seizures,268336,268359,23
Jensen_Eisai_groupB,2,5,ts-global_detected_seizures,268409,268439,30
Jensen_Eisai_groupB,2,5,ts-global_detected_seizures,268490,268542,52
Jensen_Eisai_groupB,1,4,ts-global_detected_seizures,268539,268921,382
Jensen_Eisai_groupB,2,5,ts-global_detected_seizures,268608,268633,25
Jensen_Eisai_groupB,2,5,ts-global_detected_seizures,268649,268674,25
Jensen_Eisai_groupB,2,5,ts-global_detected_seizures,268677,268702,25
Jensen_Eisai_groupB,2,5,ts-global_detected_seizures,268761,268820,59
Jensen_Eisai_groupB,2,5,ts-global_detected_seizures,268870,268904,34
Jensen_Eisai_groupB,1,4,ts-global_detected_seizures,268927,268961,34
Jensen_Eisai_groupB,2,5,ts-global_detected_seizures,268941,268963,22
Jensen_Eisai_groupB,2,5,ts-global_detected_seizures,268993,269040,47
Jensen_Eisai_groupB,1,4,ts-global_detected_seizures,269083,269168,85
Jensen_Eisai_groupB,2,5,ts-global_detected_seizures,269101,269127,26
Jensen_Eisai_groupB,2,5,ts-global_detected_seizures,269152,269182,30
Jensen_Eisai_groupB,1,4,ts-global_detected_seizures,269177,269202,25
Jensen_Eisai_groupB,2,5,ts-global_detected_seizures,269188,269257,69
Jensen_Eisai_groupB,2,5,ts-global_detected_seizures,269297,269321,24
Jensen_Eisai_groupB,2,5,ts-global_detected_seizures,269371,269416,45
Jensen_Eisai_groupB,1,4,ts-global_detected_seizures,269482,269516,34
Jensen_Eisai_groupB,2,5,ts-global_detected_seizures,269495,269523,28
Jensen_Eisai_groupB,1,4,ts-global_detected_seizures,269556,269638,82
Jensen_Eisai_groupB,2,5,ts-global_detected_seizures,269605,269631,26
Jensen_Eisai_groupB,2,5,ts-global_detected_seizures,269641,269677,36
Jensen_Eisai_groupB,1,4,ts-global_detected_seizures,269662,269685,23
Jensen_Eisai_groupB,1,4,ts-global_detected_seizures,269686,269717,31
Jensen_Eisai_groupB,2,5,ts-global_detected_seizures,269693,269716,23
Jensen_Eisai_groupB,2,5,ts-global_detected_seizures,269729,269758,29
Jensen_Eisai_groupB,1,4,ts-global_detected_seizures,269766,269799,33
Jensen_Eisai_groupB,2,5,ts-global_detected_seizures,269770,269799,29
Jensen_Eisai_groupB,2,5,ts-global_detected_seizures,269807,269904,97
Jensen_Eisai_groupB,1,4,ts-global_detected_seizures,269881,269919,38
Jensen_Eisai_groupB,2,5,ts-global_detected_seizures,269905,269935,30
Jensen_Eisai_groupB,1,4,ts-global_detected_seizures,269974,270012,38
Jensen_Eisai_groupB,2,5,ts-global_detected_seizures,270004,270026,22
Jensen_Eisai_groupB,2,5,ts-global_detected_seizures,270033,270056,23
Jensen_Eisai_groupB,1,4,ts-global_detected_seizures,270048,270076,28
Jensen_Eisai_groupB,2,5,ts-global_detected_seizures,270086,270126,40
Jensen_Eisai_groupB,1,4,ts-global_detected_seizures,270130,270163,33
Jensen_Eisai_groupB,2,5,ts-global_detected_seizures,270183,270356,173
Jensen_Eisai_groupB,1,4,ts-global_detected_seizures,270201,270226,25
Jensen_Eisai_groupB,1,4,ts-global_detected_seizures,270248,270275,27
Jensen_Eisai_groupB,1,4,ts-global_detected_seizures,270297,270327,30
Jensen_Eisai_groupB,2,5,ts-global_detected_seizures,270357,270419,62
Jensen_Eisai_groupB,1,4,ts-global_detected_seizures,270363,270391,28
Jensen_Eisai_groupB,1,4,ts-global_detected_seizures,270392,270452,60
Jensen_Eisai_groupB,2,5,ts-global_detected_seizures,270421,270448,27
Jensen_Eisai_groupB,2,5,ts-global_detected_seizures,270449,270534,85
Jensen_Eisai_groupB,1,4,ts-global_detected_seizures,270458,270480,22
Jensen_Eisai_groupB,1,4,ts-global_detected_seizures,270485,270537,52
Jensen_Eisai_groupB,2,5,ts-global_detected_seizures,270535,270557,22
Jensen_Eisai_groupB,2,5,ts-global_detected_seizures,270558,271008,450
Jensen_Eisai_groupB,1,4,ts-global_detected_seizures,270616,270659,43
Jensen_Eisai_groupB,1,4,ts-global_detected_seizures,270706,270781,75
Jensen_Eisai_groupB,1,4,ts-global_detected_seizures,270783,270879,96
Jensen_Eisai_groupB,1,4,ts-global_detected_seizures,270886,270927,41
Jensen_Eisai_groupB,1,4,ts-global_detected_seizures,270931,270969,38
Jensen_Eisai_groupB,1,4,ts-global_detected_seizures,270979,271002,23
Jensen_Eisai_groupB,2,5,ts-global_detected_seizures,271009,271042,33
Jensen_Eisai_groupB,1,4,ts-global_detected_seizures,271037,271096,59
Jensen_Eisai_groupB,2,5,ts-global_detected_seizures,271043,271084,41
Jensen_Eisai_groupB,2,5,ts-global_detected_seizures,271103,271138,35
Jensen_Eisai_groupB,1,4,ts-global_detected_seizures,271121,271162,41
Jensen_Eisai_groupB,2,5,ts-global_detected_seizures,271152,271272,120
Jensen_Eisai_groupB,1,4,ts-global_detected_seizures,271193,271227,34
Jensen_Eisai_groupB,2,5,ts-global_detected_seizures,271273,271550,277
Jensen_Eisai_groupB,1,4,ts-global_detected_seizures,271296,271334,38
Jensen_Eisai_groupB,1,4,ts-global_detected_seizures,271343,271366,23
Jensen_Eisai_groupB,1,4,ts-global_detected_seizures,271367,271407,40
Jensen_Eisai_groupB,1,4,ts-global_detected_seizures,271441,271464,23
Jensen_Eisai_groupB,1,4,ts-global_detected_seizures,271499,271901,402
Jensen_Eisai_groupB,2,5,ts-global_detected_seizures,271551,271576,25
Jensen_Eisai_groupB,2,5,ts-global_detected_seizures,271597,271632,35
Jensen_Eisai_groupB,2,5,ts-global_detected_seizures,271676,271707,31
Jensen_Eisai_groupB,2,5,ts-global_detected_seizures,271708,271764,56
Jensen_Eisai_groupB,2,5,ts-global_detected_seizures,271789,271830,41
Jensen_Eisai_groupB,2,5,ts-global_detected_seizures,271844,271886,42
Jensen_Eisai_groupB,1,4,ts-global_detected_seizures,271902,271934,32
Jensen_Eisai_groupB,1,4,ts-global_detected_seizures,271947,271979,32
Jensen_Eisai_groupB,2,5,ts-global_detected_seizures,271971,272000,29
Jensen_Eisai_groupB,1,4,ts-global_detected_seizures,271980,272016,36
Jensen_Eisai_groupB,1,4,ts-global_detected_seizures,272020,272042,22
Jensen_Eisai_groupB,1,4,ts-global_detected_seizures,272043,272082,39
Jensen_Eisai_groupB,2,5,ts-global_detected_seizures,272057,272079,22
Jensen_Eisai_groupB,1,4,ts-global_detected_seizures,272118,272143,25
Jensen_Eisai_groupB,2,5,ts-global_detected_seizures,272144,272166,22
Jensen_Eisai_groupB,1,4,ts-global_detected_seizures,272163,272203,40
Jensen_Eisai_groupB,1,4,ts-global_detected_seizures,272205,272227,22
Jensen_Eisai_groupB,2,5,ts-global_detected_seizures,272219,272249,30
Jensen_Eisai_groupB,1,4,ts-global_detected_seizures,272295,272353,58
Jensen_Eisai_groupB,2,5,ts-global_detected_seizures,272304,272354,50
Jensen_Eisai_groupB,1,4,ts-global_detected_seizures,272354,272405,51
Jensen_Eisai_groupB,2,5,ts-global_detected_seizures,272355,272387,32
Jensen_Eisai_groupB,2,5,ts-global_detected_seizures,272398,272424,26
Jensen_Eisai_groupB,1,4,ts-global_detected_seizures,272411,272542,131
Jensen_Eisai_groupB,2,5,ts-global_detected_seizures,272429,272462,33
Jensen_Eisai_groupB,2,5,ts-global_detected_seizures,272508,272543,35
Jensen_Eisai_groupB,1,4,ts-global_detected_seizures,272581,272639,58
Jensen_Eisai_groupB,2,5,ts-global_detected_seizures,272583,272615,32
Jensen_Eisai_groupB,2,5,ts-global_detected_seizures,272641,272681,40
Jensen_Eisai_groupB,1,4,ts-global_detected_seizures,272667,272729,62
Jensen_Eisai_groupB,2,5,ts-global_detected_seizures,272714,272744,30
Jensen_Eisai_groupB,1,4,ts-global_detected_seizures,272731,272784,53
Jensen_Eisai_groupB,2,5,ts-global_detected_seizures,272761,272791,30
Jensen_Eisai_groupB,2,5,ts-global_detected_seizures,272800,272825,25
Jensen_Eisai_groupB,1,4,ts-global_detected_seizures,272821,272886,65
Jensen_Eisai_groupB,2,5,ts-global_detected_seizures,272873,272911,38
Jensen_Eisai_groupB,2,5,ts-global_detected_seizures,272964,272988,24
Jensen_Eisai_groupB,1,4,ts-global_detected_seizures,272981,273017,36
Jensen_Eisai_groupB,2,5,ts-global_detected_seizures,273000,273127,127
Jensen_Eisai_groupB,1,4,ts-global_detected_seizures,273040,273079,39
Jensen_Eisai_groupB,1,4,ts-global_detected_seizures,273103,273144,41
Jensen_Eisai_groupB,1,4,ts-global_detected_seizures,273145,273182,37
Jensen_Eisai_groupB,2,5,ts-global_detected_seizures,273171,273194,23
Jensen_Eisai_groupB,2,5,ts-global_detected_seizures,273204,273234,30
Jensen_Eisai_groupB,1,4,ts-global_detected_seizures,273207,273266,59
Jensen_Eisai_groupB,1,4,ts-global_detected_seizures,273282,273461,179
Jensen_Eisai_groupB,2,5,ts-global_detected_seizures,273409,273436,27
Jensen_Eisai_groupB,2,5,ts-global_detected_seizures,273451,273488,37
Jensen_Eisai_groupB,1,4,ts-global_detected_seizures,273462,273579,117
Jensen_Eisai_groupB,2,5,ts-global_detected_seizures,273503,273526,23
Jensen_Eisai_groupB,2,5,ts-global_detected_seizures,273604,273658,54
Jensen_Eisai_groupB,1,4,ts-global_detected_seizures,273652,273753,101
Jensen_Eisai_groupB,2,5,ts-global_detected_seizures,273674,273722,48
Jensen_Eisai_groupB,1,4,ts-global_detected_seizures,273764,273869,105
Jensen_Eisai_groupB,2,5,ts-global_detected_seizures,273783,273824,41
Jensen_Eisai_groupB,2,5,ts-global_detected_seizures,273825,273881,56
Jensen_Eisai_groupB,2,5,ts-global_detected_seizures,273883,273910,27
Jensen_Eisai_groupB,1,4,ts-global_detected_seizures,273914,273948,34
Jensen_Eisai_groupB,2,5,ts-global_detected_seizures,273939,273970,31
Jensen_Eisai_groupB,1,4,ts-global_detected_seizures,273966,274010,44
Jensen_Eisai_groupB,2,5,ts-global_detected_seizures,274011,274045,34
Jensen_Eisai_groupB,1,4,ts-global_detected_seizures,274029,274086,57
Jensen_Eisai_groupB,2,5,ts-global_detected_seizures,274048,274070,22
Jensen_Eisai_groupB,2,5,ts-global_detected_seizures,274082,274107,25
Jensen_Eisai_groupB,1,4,ts-global_detected_seizures,274110,274145,35
Jensen_Eisai_groupB,2,5,ts-global_detected_seizures,274145,274168,23
Jensen_Eisai_groupB,1,4,ts-global_detected_seizures,274147,274234,87
Jensen_Eisai_groupB,2,5,ts-global_detected_seizures,274175,274225,50
Jensen_Eisai_groupB,1,4,ts-global_detected_seizures,274236,274289,53
Jensen_Eisai_groupB,2,5,ts-global_detected_seizures,274335,274366,31
Jensen_Eisai_groupB,1,4,ts-global_detected_seizures,274337,274480,143
Jensen_Eisai_groupB,2,5,ts-global_detected_seizures,274406,274475,69
Jensen_Eisai_groupB,2,5,ts-global_detected_seizures,274476,274540,64
Jensen_Eisai_groupB,1,4,ts-global_detected_seizures,274503,274548,45
Jensen_Eisai_groupB,1,4,ts-global_detected_seizures,274503,274548,45
Jensen_Eisai_groupB,2,5,ts-global_detected_seizures,274541,274574,33
Jensen_Eisai_groupB,1,4,ts-global_detected_seizures,274551,274574,23
Jensen_Eisai_groupB,2,5,ts-global_detected_seizures,274576,274609,33
Jensen_Eisai_groupB,1,4,ts-global_detected_seizures,274594,274617,23
Jensen_Eisai_groupB,1,4,ts-global_detected_seizures,274618,274664,46
Jensen_Eisai_groupB,2,5,ts-global_detected_seizures,274642,274687,45
Jensen_Eisai_groupB,1,4,ts-global_detected_seizures,274674,274717,43
Jensen_Eisai_groupB,2,5,ts-global_detected_seizures,274709,274755,46
Jensen_Eisai_groupB,1,4,ts-global_detected_seizures,274744,274927,183
Jensen_Eisai_groupB,2,5,ts-global_detected_seizures,274757,274784,27
Jensen_Eisai_groupB,2,5,ts-global_detected_seizures,274842,274889,47
Jensen_Eisai_groupB,2,5,ts-global_detected_seizures,274933,275103,170
Jensen_Eisai_groupB,1,4,ts-global_detected_seizures,274950,274993,43
Jensen_Eisai_groupB,1,4,ts-global_detected_seizures,275009,275059,50
Jensen_Eisai_groupB,1,4,ts-global_detected_seizures,275069,275109,40
Jensen_Eisai_groupB,1,4,ts-global_detected_seizures,275135,275495,360
Jensen_Eisai_groupB,2,5,ts-global_detected_seizures,275234,275285,51
Jensen_Eisai_groupB,2,5,ts-global_detected_seizures,275412,275439,27
Jensen_Eisai_groupB,1,4,ts-global_detected_seizures,275496,275546,50
Jensen_Eisai_groupB,2,5,ts-global_detected_seizures,275502,275548,46
Jensen_Eisai_groupB,1,4,ts-global_detected_seizures,275569,276803,1234
Jensen_Eisai_groupB,2,5,ts-global_detected_seizures,275628,275650,22
Jensen_Eisai_groupB,2,5,ts-global_detected_seizures,275677,275708,31
Jensen_Eisai_groupB,2,5,ts-global_detected_seizures,275757,275821,64
Jensen_Eisai_groupB,2,5,ts-global_detected_seizures,275895,275925,30
Jensen_Eisai_groupB,2,5,ts-global_detected_seizures,275942,275972,30
Jensen_Eisai_groupB,2,5,ts-global_detected_seizures,275980,276051,71
Jensen_Eisai_groupB,2,5,ts-global_detected_seizures,276098,276141,43
Jensen_Eisai_groupB,2,5,ts-global_detected_seizures,276157,276197,40
Jensen_Eisai_groupB,2,5,ts-global_detected_seizures,276198,276506,308
Jensen_Eisai_groupB,2,5,ts-global_detected_seizures,276507,276917,410
Jensen_Eisai_groupB,1,4,ts-global_detected_seizures,276815,278605,1790
Jensen_Eisai_groupB,2,5,ts-global_detected_seizures,276918,276941,23
Jensen_Eisai_groupB,2,5,ts-global_detected_seizures,276942,277005,63
Jensen_Eisai_groupB,2,5,ts-global_detected_seizures,277009,278240,1231
Jensen_Eisai_groupB,3,6,ts-global_detected_seizures,277090,288922,11832
Jensen_Eisai_groupB,2,5,ts-global_detected_seizures,278253,278303,50
Jensen_Eisai_groupB,2,5,ts-global_detected_seizures,278385,278412,27
Jensen_Eisai_groupB,2,5,ts-global_detected_seizures,278466,278489,23
Jensen_Eisai_groupB,2,5,ts-global_detected_seizures,278502,278532,30
Jensen_Eisai_groupB,2,5,ts-global_detected_seizures,278542,278605,63
Jensen_Eisai_groupB,1,4,ts-global_detected_seizures,278645,278756,111
Jensen_Eisai_groupB,2,5,ts-global_detected_seizures,278669,278698,29
Jensen_Eisai_groupB,2,5,ts-global_detected_seizures,278707,278739,32
Jensen_Eisai_groupB,2,5,ts-global_detected_seizures,278762,278796,34
Jensen_Eisai_groupB,1,4,ts-global_detected_seizures,278862,278901,39
Jensen_Eisai_groupB,2,5,ts-global_detected_seizures,278889,278925,36
Jensen_Eisai_groupB,2,5,ts-global_detected_seizures,278983,279007,24
Jensen_Eisai_groupB,1,4,ts-global_detected_seizures,279017,279143,126
Jensen_Eisai_groupB,2,5,ts-global_detected_seizures,279029,279066,37
Jensen_Eisai_groupB,2,5,ts-global_detected_seizures,279100,279132,32
Jensen_Eisai_groupB,1,4,ts-global_detected_seizures,279151,279175,24
Jensen_Eisai_groupB,2,5,ts-global_detected_seizures,279162,279187,25
Jensen_Eisai_groupB,2,5,ts-global_detected_seizures,279196,279223,27
Jensen_Eisai_groupB,1,4,ts-global_detected_seizures,279207,279229,22
Jensen_Eisai_groupB,1,4,ts-global_detected_seizures,279258,279324,66
Jensen_Eisai_groupB,2,5,ts-global_detected_seizures,279261,279292,31
Jensen_Eisai_groupB,2,5,ts-global_detected_seizures,279354,279430,76
Jensen_Eisai_groupB,1,4,ts-global_detected_seizures,279415,279440,25
Jensen_Eisai_groupB,2,5,ts-global_detected_seizures,279431,279455,24
Jensen_Eisai_groupB,2,5,ts-global_detected_seizures,279470,279501,31
Jensen_Eisai_groupB,2,5,ts-global_detected_seizures,279549,279601,52
Jensen_Eisai_groupB,1,4,ts-global_detected_seizures,279552,279574,22
Jensen_Eisai_groupB,1,4,ts-global_detected_seizures,279583,279611,28
Jensen_Eisai_groupB,1,4,ts-global_detected_seizures,279612,279643,31
Jensen_Eisai_groupB,2,5,ts-global_detected_seizures,279636,279661,25
Jensen_Eisai_groupB,1,4,ts-global_detected_seizures,279665,279691,26
Jensen_Eisai_groupB,2,5,ts-global_detected_seizures,279734,279774,40
Jensen_Eisai_groupB,2,5,ts-global_detected_seizures,279791,279850,59
Jensen_Eisai_groupB,1,4,ts-global_detected_seizures,279805,279828,23
Jensen_Eisai_groupB,2,5,ts-global_detected_seizures,279861,279890,29
Jensen_Eisai_groupB,2,5,ts-global_detected_seizures,279944,279978,34
Jensen_Eisai_groupB,1,4,ts-global_detected_seizures,279949,280031,82
Jensen_Eisai_groupB,2,5,ts-global_detected_seizures,280009,280058,49
Jensen_Eisai_groupB,1,4,ts-global_detected_seizures,280048,280084,36
Jensen_Eisai_groupB,2,5,ts-global_detected_seizures,280062,280116,54
Jensen_Eisai_groupB,1,4,ts-global_detected_seizures,280157,280188,31
Jensen_Eisai_groupB,2,5,ts-global_detected_seizures,280205,280253,48
Jensen_Eisai_groupB,1,4,ts-global_detected_seizures,280214,280237,23
Jensen_Eisai_groupB,2,5,ts-global_detected_seizures,280275,280308,33
Jensen_Eisai_groupB,2,5,ts-global_detected_seizures,280327,280362,35
Jensen_Eisai_groupB,2,5,ts-global_detected_seizures,280411,280435,24
Jensen_Eisai_groupB,2,5,ts-global_detected_seizures,280437,280502,65
Jensen_Eisai_groupB,1,4,ts-global_detected_seizures,280441,280468,27
Jensen_Eisai_groupB,1,4,ts-global_detected_seizures,280504,280538,34
Jensen_Eisai_groupB,2,5,ts-global_detected_seizures,280505,280567,62
Jensen_Eisai_groupB,1,4,ts-global_detected_seizures,280566,280623,57
Jensen_Eisai_groupB,1,4,ts-global_detected_seizures,280624,280681,57
Jensen_Eisai_groupB,2,5,ts-global_detected_seizures,280669,280693,24
Jensen_Eisai_groupB,1,4,ts-global_detected_seizures,280693,280715,22
Jensen_Eisai_groupB,2,5,ts-global_detected_seizures,280713,280738,25
Jensen_Eisai_groupB,1,4,ts-global_detected_seizures,280747,280883,136
Jensen_Eisai_groupB,2,5,ts-global_detected_seizures,280787,280832,45
Jensen_Eisai_groupB,2,5,ts-global_detected_seizures,280850,281042,192
Jensen_Eisai_groupB,1,4,ts-global_detected_seizures,280884,281004,120
Jensen_Eisai_groupB,1,4,ts-global_detected_seizures,281014,281043,29
Jensen_Eisai_groupB,2,5,ts-global_detected_seizures,281056,281087,31
Jensen_Eisai_groupB,1,4,ts-global_detected_seizures,281068,281146,78
Jensen_Eisai_groupB,2,5,ts-global_detected_seizures,281095,281130,35
Jensen_Eisai_groupB,2,5,ts-global_detected_seizures,281197,281224,27
Jensen_Eisai_groupB,1,4,ts-global_detected_seizures,281224,281259,35
Jensen_Eisai_groupB,1,4,ts-global_detected_seizures,281266,281331,65
Jensen_Eisai_groupB,2,5,ts-global_detected_seizures,281297,281322,25
Jensen_Eisai_groupB,1,4,ts-global_detected_seizures,281353,281385,32
Jensen_Eisai_groupB,1,4,ts-global_detected_seizures,281386,281442,56
Jensen_Eisai_groupB,2,5,ts-global_detected_seizures,281403,281453,50
Jensen_Eisai_groupB,1,4,ts-global_detected_seizures,281446,281526,80
Jensen_Eisai_groupB,2,5,ts-global_detected_seizures,281513,281558,45
Jensen_Eisai_groupB,1,4,ts-global_detected_seizures,281548,281586,38
Jensen_Eisai_groupB,2,5,ts-global_detected_seizures,281572,281653,81
Jensen_Eisai_groupB,1,4,ts-global_detected_seizures,281602,281934,332
Jensen_Eisai_groupB,2,5,ts-global_detected_seizures,281669,281716,47
Jensen_Eisai_groupB,2,5,ts-global_detected_seizures,281753,281777,24
Jensen_Eisai_groupB,2,5,ts-global_detected_seizures,281783,281807,24
Jensen_Eisai_groupB,2,5,ts-global_detected_seizures,281835,281921,86
Jensen_Eisai_groupB,2,5,ts-global_detected_seizures,281924,281955,31
Jensen_Eisai_groupB,1,4,ts-global_detected_seizures,281935,281968,33
Jensen_Eisai_groupB,1,4,ts-global_detected_seizures,281970,282007,37
Jensen_Eisai_groupB,2,5,ts-global_detected_seizures,281982,282006,24
Jensen_Eisai_groupB,2,5,ts-global_detected_seizures,282015,282075,60
Jensen_Eisai_groupB,1,4,ts-global_detected_seizures,282021,282050,29
Jensen_Eisai_groupB,1,4,ts-global_detected_seizures,282077,282117,40
Jensen_Eisai_groupB,2,5,ts-global_detected_seizures,282079,282103,24
Jensen_Eisai_groupB,2,5,ts-global_detected_seizures,282145,282261,116
Jensen_Eisai_groupB,1,4,ts-global_detected_seizures,282173,282218,45
Jensen_Eisai_groupB,2,5,ts-global_detected_seizures,282262,282298,36
Jensen_Eisai_groupB,1,4,ts-global_detected_seizures,282284,282316,32
Jensen_Eisai_groupB,2,5,ts-global_detected_seizures,282299,282332,33
Jensen_Eisai_groupB,1,4,ts-global_detected_seizures,282317,282340,23
Jensen_Eisai_groupB,2,5,ts-global_detected_seizures,282337,282363,26
Jensen_Eisai_groupB,1,4,ts-global_detected_seizures,282341,282388,47
Jensen_Eisai_groupB,2,5,ts-global_detected_seizures,282368,282412,44
Jensen_Eisai_groupB,1,4,ts-global_detected_seizures,282392,282420,28
Jensen_Eisai_groupB,1,4,ts-global_detected_seizures,282445,282468,23
Jensen_Eisai_groupB,2,5,ts-global_detected_seizures,282538,282589,51
Jensen_Eisai_groupB,1,4,ts-global_detected_seizures,282540,282617,77
Jensen_Eisai_groupB,2,5,ts-global_detected_seizures,282624,282646,22
Jensen_Eisai_groupB,2,5,ts-global_detected_seizures,282649,282696,47
Jensen_Eisai_groupB,1,4,ts-global_detected_seizures,282654,282694,40
Jensen_Eisai_groupB,1,4,ts-global_detected_seizures,282707,282745,38
Jensen_Eisai_groupB,2,5,ts-global_detected_seizures,282740,283030,290
Jensen_Eisai_groupB,1,4,ts-global_detected_seizures,282853,282953,100
Jensen_Eisai_groupB,1,4,ts-global_detected_seizures,282965,283167,202
Jensen_Eisai_groupB,2,5,ts-global_detected_seizures,283037,283093,56
Jensen_Eisai_groupB,2,5,ts-global_detected_seizures,283094,283119,25
Jensen_Eisai_groupB,2,5,ts-global_detected_seizures,283146,283179,33
Jensen_Eisai_groupB,1,4,ts-global_detected_seizures,283177,283248,71
Jensen_Eisai_groupB,2,5,ts-global_detected_seizures,283183,283213,30
Jensen_Eisai_groupB,2,5,ts-global_detected_seizures,283215,283241,26
Jensen_Eisai_groupB,1,4,ts-global_detected_seizures,283267,283317,50
Jensen_Eisai_groupB,2,5,ts-global_detected_seizures,283311,283363,52
Jensen_Eisai_groupB,1,4,ts-global_detected_seizures,283356,283380,24
Jensen_Eisai_groupB,2,5,ts-global_detected_seizures,283387,283422,35
Jensen_Eisai_groupB,1,4,ts-global_detected_seizures,283417,283443,26
Jensen_Eisai_groupB,1,4,ts-global_detected_seizures,283461,283487,26
Jensen_Eisai_groupB,2,5,ts-global_detected_seizures,283470,283499,29
Jensen_Eisai_groupB,1,4,ts-global_detected_seizures,283504,283635,131
Jensen_Eisai_groupB,2,5,ts-global_detected_seizures,283517,283549,32
Jensen_Eisai_groupB,2,5,ts-global_detected_seizures,283575,283655,80
Jensen_Eisai_groupB,1,4,ts-global_detected_seizures,283652,283703,51
Jensen_Eisai_groupB,2,5,ts-global_detected_seizures,283693,283742,49
Jensen_Eisai_groupB,1,4,ts-global_detected_seizures,283704,283789,85
Jensen_Eisai_groupB,2,5,ts-global_detected_seizures,283793,283820,27
Jensen_Eisai_groupB,1,4,ts-global_detected_seizures,283822,283878,56
Jensen_Eisai_groupB,2,5,ts-global_detected_seizures,283856,283898,42
Jensen_Eisai_groupB,1,4,ts-global_detected_seizures,283908,284129,221
Jensen_Eisai_groupB,2,5,ts-global_detected_seizures,283941,284009,68
Jensen_Eisai_groupB,2,5,ts-global_detected_seizures,284023,284098,75
Jensen_Eisai_groupB,2,5,ts-global_detected_seizures,284113,284135,22
Jensen_Eisai_groupB,1,4,ts-global_detected_seizures,284150,284267,117
Jensen_Eisai_groupB,2,5,ts-global_detected_seizures,284197,284225,28
Jensen_Eisai_groupB,2,5,ts-global_detected_seizures,284246,284280,34
Jensen_Eisai_groupB,1,4,ts-global_detected_seizures,284268,284318,50
Jensen_Eisai_groupB,2,5,ts-global_detected_seizures,284294,284323,29
Jensen_Eisai_groupB,2,5,ts-global_detected_seizures,284353,284408,55
Jensen_Eisai_groupB,2,5,ts-global_detected_seizures,284409,284565,156
Jensen_Eisai_groupB,1,4,ts-global_detected_seizures,284427,284452,25
Jensen_Eisai_groupB,1,4,ts-global_detected_seizures,284465,284492,27
Jensen_Eisai_groupB,1,4,ts-global_detected_seizures,284523,284550,27
Jensen_Eisai_groupB,1,4,ts-global_detected_seizures,284552,284585,33
Jensen_Eisai_groupB,1,4,ts-global_detected_seizures,284586,284625,39
Jensen_Eisai_groupB,2,5,ts-global_detected_seizures,284660,284685,25
Jensen_Eisai_groupB,1,4,ts-global_detected_seizures,284713,284737,24
Jensen_Eisai_groupB,2,5,ts-global_detected_seizures,284725,284756,31
Jensen_Eisai_groupB,1,4,ts-global_detected_seizures,284739,284806,67
Jensen_Eisai_groupB,2,5,ts-global_detected_seizures,284818,284862,44
Jensen_Eisai_groupB,1,4,ts-global_detected_seizures,284832,284856,24
Jensen_Eisai_groupB,1,4,ts-global_detected_seizures,284867,284939,72
Jensen_Eisai_groupB,2,5,ts-global_detected_seizures,284874,284923,49
Jensen_Eisai_groupB,2,5,ts-global_detected_seizures,284947,284985,38
Jensen_Eisai_groupB,2,5,ts-global_detected_seizures,284989,285013,24
Jensen_Eisai_groupB,2,5,ts-global_detected_seizures,285032,285058,26
Jensen_Eisai_groupB,1,4,ts-global_detected_seizures,285071,285126,55
Jensen_Eisai_groupB,2,5,ts-global_detected_seizures,285104,285141,37
Jensen_Eisai_groupB,1,4,ts-global_detected_seizures,285128,285168,40
Jensen_Eisai_groupB,2,5,ts-global_detected_seizures,285166,285280,114
Jensen_Eisai_groupB,1,4,ts-global_detected_seizures,285215,285418,203
Jensen_Eisai_groupB,2,5,ts-global_detected_seizures,285287,285319,32
Jensen_Eisai_groupB,2,5,ts-global_detected_seizures,285340,285386,46
Jensen_Eisai_groupB,2,5,ts-global_detected_seizures,285398,285438,40
Jensen_Eisai_groupB,1,4,ts-global_detected_seizures,285422,285493,71
Jensen_Eisai_groupB,2,5,ts-global_detected_seizures,285460,285485,25
Jensen_Eisai_groupB,2,5,ts-global_detected_seizures,285486,285532,46
Jensen_Eisai_groupB,1,4,ts-global_detected_seizures,285516,285624,108
Jensen_Eisai_groupB,2,5,ts-global_detected_seizures,285540,285572,32
Jensen_Eisai_groupB,2,5,ts-global_detected_seizures,285587,285632,45
Jensen_Eisai_groupB,1,4,ts-global_detected_seizures,285625,285665,40
Jensen_Eisai_groupB,2,5,ts-global_detected_seizures,285667,285700,33
Jensen_Eisai_groupB,1,4,ts-global_detected_seizures,285680,285737,57
Jensen_Eisai_groupB,2,5,ts-global_detected_seizures,285721,285759,38
Jensen_Eisai_groupB,1,4,ts-global_detected_seizures,285744,285775,31
Jensen_Eisai_groupB,2,5,ts-global_detected_seizures,285793,285831,38
Jensen_Eisai_groupB,1,4,ts-global_detected_seizures,285808,285966,158
Jensen_Eisai_groupB,2,5,ts-global_detected_seizures,285850,285876,26
Jensen_Eisai_groupB,2,5,ts-global_detected_seizures,285891,286140,249
Jensen_Eisai_groupB,1,4,ts-global_detected_seizures,285999,286099,100
Jensen_Eisai_groupB,1,4,ts-global_detected_seizures,286108,286179,71
Jensen_Eisai_groupB,2,5,ts-global_detected_seizures,286158,286217,59
Jensen_Eisai_groupB,1,4,ts-global_detected_seizures,286180,286223,43
Jensen_Eisai_groupB,1,4,ts-global_detected_seizures,286224,286257,33
Jensen_Eisai_groupB,2,5,ts-global_detected_seizures,286233,286281,48
Jensen_Eisai_groupB,1,4,ts-global_detected_seizures,286319,286389,70
Jensen_Eisai_groupB,2,5,ts-global_detected_seizures,286358,286391,33
Jensen_Eisai_groupB,2,5,ts-global_detected_seizures,286394,286434,40
Jensen_Eisai_groupB,1,4,ts-global_detected_seizures,286424,286449,25
Jensen_Eisai_groupB,2,5,ts-global_detected_seizures,286453,286486,33
Jensen_Eisai_groupB,1,4,ts-global_detected_seizures,286472,286531,59
Jensen_Eisai_groupB,2,5,ts-global_detected_seizures,286549,286583,34
Jensen_Eisai_groupB,1,4,ts-global_detected_seizures,286561,286674,113
Jensen_Eisai_groupB,2,5,ts-global_detected_seizures,286625,286667,42
Jensen_Eisai_groupB,1,4,ts-global_detected_seizures,286676,286746,70
Jensen_Eisai_groupB,2,5,ts-global_detected_seizures,286688,286743,55
Jensen_Eisai_groupB,1,4,ts-global_detected_seizures,286779,286810,31
Jensen_Eisai_groupB,2,5,ts-global_detected_seizures,286789,286871,82
Jensen_Eisai_groupB,1,4,ts-global_detected_seizures,286832,286867,35
Jensen_Eisai_groupB,2,5,ts-global_detected_seizures,286874,286896,22
Jensen_Eisai_groupB,1,4,ts-global_detected_seizures,286894,286971,77
Jensen_Eisai_groupB,2,5,ts-global_detected_seizures,286903,286946,43
Jensen_Eisai_groupB,2,5,ts-global_detected_seizures,286953,287003,50
Jensen_Eisai_groupB,1,4,ts-global_detected_seizures,286999,287023,24
Jensen_Eisai_groupB,2,5,ts-global_detected_seizures,287004,287030,26
Jensen_Eisai_groupB,1,4,ts-global_detected_seizures,287026,287064,38
Jensen_Eisai_groupB,2,5,ts-global_detected_seizures,287041,287070,29
Jensen_Eisai_groupB,2,5,ts-global_detected_seizures,287095,287129,34
Jensen_Eisai_groupB,1,4,ts-global_detected_seizures,287106,287191,85
Jensen_Eisai_groupB,2,5,ts-global_detected_seizures,287169,287255,86
Jensen_Eisai_groupB,1,4,ts-global_detected_seizures,287192,287274,82
Jensen_Eisai_groupB,2,5,ts-global_detected_seizures,287270,287302,32
Jensen_Eisai_groupB,1,4,ts-global_detected_seizures,287277,287305,28
Jensen_Eisai_groupB,2,5,ts-global_detected_seizures,287314,287392,78
Jensen_Eisai_groupB,1,4,ts-global_detected_seizures,287344,287391,47
Jensen_Eisai_groupB,1,4,ts-global_detected_seizures,287417,287455,38
Jensen_Eisai_groupB,2,5,ts-global_detected_seizures,287441,287486,45
Jensen_Eisai_groupB,1,4,ts-global_detected_seizures,287473,287507,34
Jensen_Eisai_groupB,2,5,ts-global_detected_seizures,287511,287566,55
Jensen_Eisai_groupB,1,4,ts-global_detected_seizures,287526,287548,22
Jensen_Eisai_groupB,1,4,ts-global_detected_seizures,287609,287637,28
Jensen_Eisai_groupB,2,5,ts-global_detected_seizures,287640,287774,134
Jensen_Eisai_groupB,1,4,ts-global_detected_seizures,287691,287803,112
Jensen_Eisai_groupB,2,5,ts-global_detected_seizures,287805,287844,39
Jensen_Eisai_groupB,2,5,ts-global_detected_seizures,287856,287891,35
Jensen_Eisai_groupB,1,4,ts-global_detected_seizures,287877,287905,28
Jensen_Eisai_groupB,1,4,ts-global_detected_seizures,287925,288158,233
Jensen_Eisai_groupB,2,5,ts-global_detected_seizures,287935,287977,42
Jensen_Eisai_groupB,2,5,ts-global_detected_seizures,288002,288047,45
Jensen_Eisai_groupB,2,5,ts-global_detected_seizures,288059,288112,53
Jensen_Eisai_groupB,2,5,ts-global_detected_seizures,288115,288140,25
Jensen_Eisai_groupB,1,4,ts-global_detected_seizures,288159,288194,35
Jensen_Eisai_groupB,1,4,ts-global_detected_seizures,288195,288266,71
Jensen_Eisai_groupB,2,5,ts-global_detected_seizures,288242,288421,179
Jensen_Eisai_groupB,1,4,ts-global_detected_seizures,288277,288317,40
Jensen_Eisai_groupB,1,4,ts-global_detected_seizures,288341,288381,40
Jensen_Eisai_groupB,1,4,ts-global_detected_seizures,288403,288435,32
Jensen_Eisai_groupB,1,4,ts-global_detected_seizures,288442,288502,60
Jensen_Eisai_groupB,2,5,ts-global_detected_seizures,288465,288540,75
Jensen_Eisai_groupB,1,4,ts-global_detected_seizures,288552,288575,23
Jensen_Eisai_groupB,1,4,ts-global_detected_seizures,288578,288648,70
Jensen_Eisai_groupB,2,5,ts-global_detected_seizures,288609,288635,26
Jensen_Eisai_groupB,2,5,ts-global_detected_seizures,288648,288679,31
Jensen_Eisai_groupB,2,5,ts-global_detected_seizures,288687,288710,23
Jensen_Eisai_groupB,1,4,ts-global_detected_seizures,288707,288748,41
Jensen_Eisai_groupB,2,5,ts-global_detected_seizures,288730,288755,25
Jensen_Eisai_groupB,2,5,ts-global_detected_seizures,288756,288781,25
Jensen_Eisai_groupB,2,5,ts-global_detected_seizures,288808,288852,44
Jensen_Eisai_groupB,1,4,ts-global_detected_seizures,288826,288899,73
Jensen_Eisai_groupB,2,5,ts-global_detected_seizures,288877,288902,25
Jensen_Eisai_groupB,1,4,ts-global_detected_seizures,288902,288952,50
Jensen_Eisai_groupB,3,6,ts-global_detected_seizures,288923,292040,3117
Jensen_Eisai_groupB,2,5,ts-global_detected_seizures,288956,288981,25
Jensen_Eisai_groupB,1,4,ts-global_detected_seizures,288966,289039,73
Jensen_Eisai_groupB,2,5,ts-global_detected_seizures,289003,289039,36
Jensen_Eisai_groupB,2,5,ts-global_detected_seizures,289053,289092,39
Jensen_Eisai_groupB,2,5,ts-global_detected_seizures,289123,289150,27
Jensen_Eisai_groupB,1,4,ts-global_detected_seizures,289167,289466,299
Jensen_Eisai_groupB,2,5,ts-global_detected_seizures,289256,289288,32
Jensen_Eisai_groupB,2,5,ts-global_detected_seizures,289302,289350,48
Jensen_Eisai_groupB,2,5,ts-global_detected_seizures,289375,289405,30
Jensen_Eisai_groupB,2,5,ts-global_detected_seizures,289420,289446,26
Jensen_Eisai_groupB,1,4,ts-global_detected_seizures,289467,289567,100
Jensen_Eisai_groupB,2,5,ts-global_detected_seizures,289468,289508,40
Jensen_Eisai_groupB,2,5,ts-global_detected_seizures,289509,289582,73
Jensen_Eisai_groupB,2,5,ts-global_detected_seizures,289595,289621,26
Jensen_Eisai_groupB,1,4,ts-global_detected_seizures,289641,289675,34
Jensen_Eisai_groupB,2,5,ts-global_detected_seizures,289686,290766,1080
Jensen_Eisai_groupB,1,4,ts-global_detected_seizures,289692,289723,31
Jensen_Eisai_groupB,1,4,ts-global_detected_seizures,289758,289788,30
Jensen_Eisai_groupB,1,4,ts-global_detected_seizures,289833,289944,111
Jensen_Eisai_groupB,1,4,ts-global_detected_seizures,289988,290175,187
Jensen_Eisai_groupB,1,4,ts-global_detected_seizures,290176,290239,63
Jensen_Eisai_groupB,1,4,ts-global_detected_seizures,290253,290281,28
Jensen_Eisai_groupB,1,4,ts-global_detected_seizures,290297,290338,41
Jensen_Eisai_groupB,1,4,ts-global_detected_seizures,290375,291110,735
Jensen_Eisai_groupB,2,5,ts-global_detected_seizures,290767,290852,85
Jensen_Eisai_groupB,2,5,ts-global_detected_seizures,290861,290893,32
Jensen_Eisai_groupB,2,5,ts-global_detected_seizures,290900,290939,39
Jensen_Eisai_groupB,2,5,ts-global_detected_seizures,290949,290974,25
Jensen_Eisai_groupB,2,5,ts-global_detected_seizures,290979,291022,43
Jensen_Eisai_groupB,2,5,ts-global_detected_seizures,291037,291059,22
Jensen_Eisai_groupB,2,5,ts-global_detected_seizures,291065,291104,39
Jensen_Eisai_groupB,1,4,ts-global_detected_seizures,291111,292236,1125
Jensen_Eisai_groupB,2,5,ts-global_detected_seizures,291120,291163,43
Jensen_Eisai_groupB,2,5,ts-global_detected_seizures,291191,291233,42
Jensen_Eisai_groupB,2,5,ts-global_detected_seizures,291245,291269,24
Jensen_Eisai_groupB,2,5,ts-global_detected_seizures,291299,291345,46
Jensen_Eisai_groupB,2,5,ts-global_detected_seizures,291373,291424,51
Jensen_Eisai_groupB,2,5,ts-global_detected_seizures,291460,291527,67
Jensen_Eisai_groupB,2,5,ts-global_detected_seizures,291535,291558,23
Jensen_Eisai_groupB,2,5,ts-global_detected_seizures,291559,291605,46
Jensen_Eisai_groupB,2,5,ts-global_detected_seizures,291641,291674,33
Jensen_Eisai_groupB,2,5,ts-global_detected_seizures,291738,291766,28
Jensen_Eisai_groupB,2,5,ts-global_detected_seizures,291789,291814,25
Jensen_Eisai_groupB,2,5,ts-global_detected_seizures,291834,291864,30
Jensen_Eisai_groupB,2,5,ts-global_detected_seizures,291888,291918,30
Jensen_Eisai_groupB,2,5,ts-global_detected_seizures,291951,291985,34
Jensen_Eisai_groupB,2,5,ts-global_detected_seizures,292009,292074,65
Jensen_Eisai_groupB,3,6,ts-global_detected_seizures,292041,293147,1106
Jensen_Eisai_groupB,2,5,ts-global_detected_seizures,292114,292140,26
Jensen_Eisai_groupB,2,5,ts-global_detected_seizures,292141,292224,83
Jensen_Eisai_groupB,1,4,ts-global_detected_seizures,292237,292294,57
Jensen_Eisai_groupB,2,5,ts-global_detected_seizures,292249,292272,23
Jensen_Eisai_groupB,1,4,ts-global_detected_seizures,292373,292403,30
Jensen_Eisai_groupB,2,5,ts-global_detected_seizures,292409,292440,31
Jensen_Eisai_groupB,1,4,ts-global_detected_seizures,292432,292466,34
Jensen_Eisai_groupB,2,5,ts-global_detected_seizures,292446,292479,33
Jensen_Eisai_groupB,2,5,ts-global_detected_seizures,292494,292516,22
Jensen_Eisai_groupB,2,5,ts-global_detected_seizures,292536,292579,43
Jensen_Eisai_groupB,1,4,ts-global_detected_seizures,292547,292571,24
Jensen_Eisai_groupB,2,5,ts-global_detected_seizures,292594,292634,40
Jensen_Eisai_groupB,1,4,ts-global_detected_seizures,292648,292684,36
Jensen_Eisai_groupB,2,5,ts-global_detected_seizures,292678,292717,39
Jensen_Eisai_groupB,1,4,ts-global_detected_seizures,292739,292773,34
Jensen_Eisai_groupB,2,5,ts-global_detected_seizures,292778,292812,34
Jensen_Eisai_groupB,2,5,ts-global_detected_seizures,292814,292857,43
Jensen_Eisai_groupB,1,4,ts-global_detected_seizures,292850,292876,26
Jensen_Eisai_groupB,2,5,ts-global_detected_seizures,292871,292903,32
Jensen_Eisai_groupB,2,5,ts-global_detected_seizures,292904,292949,45
Jensen_Eisai_groupB,1,4,ts-global_detected_seizures,292914,292972,58
Jensen_Eisai_groupB,2,5,ts-global_detected_seizures,292963,292995,32
Jensen_Eisai_groupB,1,4,ts-global_detected_seizures,292993,293054,61
Jensen_Eisai_groupB,2,5,ts-global_detected_seizures,293033,293074,41
Jensen_Eisai_groupB,1,4,ts-global_detected_seizures,293089,293111,22
Jensen_Eisai_groupB,1,4,ts-global_detected_seizures,293120,293147,27
Jensen_Eisai_groupB,2,5,ts-global_detected_seizures,293131,293172,41
Jensen_Eisai_groupB,3,6,ts-global_detected_seizures,293148,294716,1568
Jensen_Eisai_groupB,1,4,ts-global_detected_seizures,293187,293230,43
Jensen_Eisai_groupB,2,5,ts-global_detected_seizures,293188,293231,43
Jensen_Eisai_groupB,1,4,ts-global_detected_seizures,293233,293291,58
Jensen_Eisai_groupB,2,5,ts-global_detected_seizures,293250,293279,29
Jensen_Eisai_groupB,1,4,ts-global_detected_seizures,293323,293350,27
Jensen_Eisai_groupB,2,5,ts-global_detected_seizures,293324,293362,38
Jensen_Eisai_groupB,1,4,ts-global_detected_seizures,293363,293406,43
Jensen_Eisai_groupB,2,5,ts-global_detected_seizures,293375,293429,54
Jensen_Eisai_groupB,1,4,ts-global_detected_seizures,293409,293446,37
Jensen_Eisai_groupB,2,5,ts-global_detected_seizures,293487,293522,35
Jensen_Eisai_groupB,1,4,ts-global_detected_seizures,293501,293533,32
Jensen_Eisai_groupB,2,5,ts-global_detected_seizures,293564,293618,54
Jensen_Eisai_groupB,1,4,ts-global_detected_seizures,293620,293787,167
Jensen_Eisai_groupB,2,5,ts-global_detected_seizures,293638,293709,71
Jensen_Eisai_groupB,2,5,ts-global_detected_seizures,293715,293741,26
Jensen_Eisai_groupB,2,5,ts-global_detected_seizures,293769,293800,31
Jensen_Eisai_groupB,1,4,ts-global_detected_seizures,293803,293876,73
Jensen_Eisai_groupB,2,5,ts-global_detected_seizures,293819,293850,31
Jensen_Eisai_groupB,2,5,ts-global_detected_seizures,293851,293941,90
Jensen_Eisai_groupB,1,4,ts-global_detected_seizures,293895,293919,24
Jensen_Eisai_groupB,1,4,ts-global_detected_seizures,293920,293971,51
Jensen_Eisai_groupB,2,5,ts-global_detected_seizures,293942,294004,62
Jensen_Eisai_groupB,1,4,ts-global_detected_seizures,293992,294038,46
Jensen_Eisai_groupB,2,5,ts-global_detected_seizures,294005,294027,22
Jensen_Eisai_groupB,1,4,ts-global_detected_seizures,294039,294104,65
Jensen_Eisai_groupB,2,5,ts-global_detected_seizures,294053,294085,32
Jensen_Eisai_groupB,2,5,ts-global_detected_seizures,294099,294122,23
Jensen_Eisai_groupB,1,4,ts-global_detected_seizures,294110,294143,33
Jensen_Eisai_groupB,2,5,ts-global_detected_seizures,294123,294149,26
Jensen_Eisai_groupB,2,5,ts-global_detected_seizures,294186,294233,47
Jensen_Eisai_groupB,1,4,ts-global_detected_seizures,294206,294353,147
Jensen_Eisai_groupB,2,5,ts-global_detected_seizures,294272,294305,33
Jensen_Eisai_groupB,2,5,ts-global_detected_seizures,294333,294356,23
Jensen_Eisai_groupB,1,4,ts-global_detected_seizures,294357,294399,42
Jensen_Eisai_groupB,2,5,ts-global_detected_seizures,294378,294410,32
Jensen_Eisai_groupB,1,4,ts-global_detected_seizures,294419,294465,46
Jensen_Eisai_groupB,2,5,ts-global_detected_seizures,294462,294494,32
Jensen_Eisai_groupB,1,4,ts-global_detected_seizures,294480,294530,50
Jensen_Eisai_groupB,2,5,ts-global_detected_seizures,294507,294530,23
Jensen_Eisai_groupB,2,5,ts-global_detected_seizures,294545,294611,66
Jensen_Eisai_groupB,1,4,ts-global_detected_seizures,294555,294616,61
Jensen_Eisai_groupB,2,5,ts-global_detected_seizures,294612,294649,37
Jensen_Eisai_groupB,1,4,ts-global_detected_seizures,294630,294653,23
Jensen_Eisai_groupB,1,4,ts-global_detected_seizures,294674,294698,24
Jensen_Eisai_groupB,1,4,ts-global_detected_seizures,294704,294731,27
Jensen_Eisai_groupB,3,6,ts-global_detected_seizures,294717,296016,1299
Jensen_Eisai_groupB,2,5,ts-global_detected_seizures,294723,294752,29
Jensen_Eisai_groupB,2,5,ts-global_detected_seizures,294761,294802,41
Jensen_Eisai_groupB,1,4,ts-global_detected_seizures,294762,294792,30
Jensen_Eisai_groupB,1,4,ts-global_detected_seizures,294830,294939,109
Jensen_Eisai_groupB,2,5,ts-global_detected_seizures,294852,294881,29
Jensen_Eisai_groupB,2,5,ts-global_detected_seizures,294924,294969,45
Jensen_Eisai_groupB,1,4,ts-global_detected_seizures,294940,294986,46
Jensen_Eisai_groupB,2,5,ts-global_detected_seizures,294973,295002,29
Jensen_Eisai_groupB,1,4,ts-global_detected_seizures,294987,295019,32
Jensen_Eisai_groupB,1,4,ts-global_detected_seizures,295025,295066,41
Jensen_Eisai_groupB,2,5,ts-global_detected_seizures,295030,295078,48
Jensen_Eisai_groupB,1,4,ts-global_detected_seizures,295079,295110,31
Jensen_Eisai_groupB,2,5,ts-global_detected_seizures,295089,295134,45
Jensen_Eisai_groupB,1,4,ts-global_detected_seizures,295169,295252,83
Jensen_Eisai_groupB,2,5,ts-global_detected_seizures,295174,295201,27
Jensen_Eisai_groupB,2,5,ts-global_detected_seizures,295220,295279,59
Jensen_Eisai_groupB,1,4,ts-global_detected_seizures,295266,295303,37
Jensen_Eisai_groupB,2,5,ts-global_detected_seizures,295294,295325,31
Jensen_Eisai_groupB,1,4,ts-global_detected_seizures,295321,295353,32
Jensen_Eisai_groupB,2,5,ts-global_detected_seizures,295366,295388,22
Jensen_Eisai_groupB,1,4,ts-global_detected_seizures,295396,295451,55
Jensen_Eisai_groupB,2,5,ts-global_detected_seizures,295413,295477,64
Jensen_Eisai_groupB,1,4,ts-global_detected_seizures,295465,295563,98
Jensen_Eisai_groupB,2,5,ts-global_detected_seizures,295488,295514,26
Jensen_Eisai_groupB,2,5,ts-global_detected_seizures,295519,295547,28
Jensen_Eisai_groupB,2,5,ts-global_detected_seizures,295566,295591,25
Jensen_Eisai_groupB,2,5,ts-global_detected_seizures,295660,295686,26
Jensen_Eisai_groupB,1,4,ts-global_detected_seizures,295685,295733,48
Jensen_Eisai_groupB,1,4,ts-global_detected_seizures,295758,295783,25
Jensen_Eisai_groupB,2,5,ts-global_detected_seizures,295792,295851,59
Jensen_Eisai_groupB,1,4,ts-global_detected_seizures,295868,296006,138
Jensen_Eisai_groupB,2,5,ts-global_detected_seizures,295877,295906,29
Jensen_Eisai_groupB,2,5,ts-global_detected_seizures,295916,295951,35
Jensen_Eisai_groupB,2,5,ts-global_detected_seizures,295958,295981,23
Jensen_Eisai_groupB,1,4,ts-global_detected_seizures,296008,296173,165
Jensen_Eisai_groupB,3,6,ts-global_detected_seizures,296017,299009,2992
Jensen_Eisai_groupB,2,5,ts-global_detected_seizures,296054,296093,39
Jensen_Eisai_groupB,2,5,ts-global_detected_seizures,296094,296124,30
Jensen_Eisai_groupB,2,5,ts-global_detected_seizures,296134,296165,31
Jensen_Eisai_groupB,1,4,ts-global_detected_seizures,296190,296249,59
Jensen_Eisai_groupB,2,5,ts-global_detected_seizures,296200,296224,24
Jensen_Eisai_groupB,2,5,ts-global_detected_seizures,296288,296329,41
Jensen_Eisai_groupB,1,4,ts-global_detected_seizures,296294,296358,64
Jensen_Eisai_groupB,2,5,ts-global_detected_seizures,296379,296432,53
Jensen_Eisai_groupB,1,4,ts-global_detected_seizures,296380,296408,28
Jensen_Eisai_groupB,2,5,ts-global_detected_seizures,296433,296500,67
Jensen_Eisai_groupB,1,4,ts-global_detected_seizures,296453,296505,52
Jensen_Eisai_groupB,2,5,ts-global_detected_seizures,296510,296559,49
Jensen_Eisai_groupB,1,4,ts-global_detected_seizures,296541,296572,31
Jensen_Eisai_groupB,2,5,ts-global_detected_seizures,296561,296594,33
Jensen_Eisai_groupB,1,4,ts-global_detected_seizures,296593,296706,113
Jensen_Eisai_groupB,2,5,ts-global_detected_seizures,296597,297376,779
Jensen_Eisai_groupB,1,4,ts-global_detected_seizures,296707,296732,25
Jensen_Eisai_groupB,1,4,ts-global_detected_seizures,296744,296774,30
Jensen_Eisai_groupB,1,4,ts-global_detected_seizures,296782,296831,49
Jensen_Eisai_groupB,1,4,ts-global_detected_seizures,296833,296868,35
Jensen_Eisai_groupB,1,4,ts-global_detected_seizures,296898,296992,94
Jensen_Eisai_groupB,1,4,ts-global_detected_seizures,297026,297049,23
Jensen_Eisai_groupB,1,4,ts-global_detected_seizures,297086,297159,73
Jensen_Eisai_groupB,1,4,ts-global_detected_seizures,297232,297835,603
Jensen_Eisai_groupB,2,5,ts-global_detected_seizures,297377,297637,260
Jensen_Eisai_groupB,2,5,ts-global_detected_seizures,297638,297705,67
Jensen_Eisai_groupB,2,5,ts-global_detected_seizures,297726,297762,36
Jensen_Eisai_groupB,2,5,ts-global_detected_seizures,297765,297817,52
Jensen_Eisai_groupB,1,4,ts-global_detected_seizures,297836,297948,112
Jensen_Eisai_groupB,2,5,ts-global_detected_seizures,297869,297901,32
Jensen_Eisai_groupB,2,5,ts-global_detected_seizures,297909,297936,27
Jensen_Eisai_groupB,2,5,ts-global_detected_seizures,297949,298005,56
Jensen_Eisai_groupB,1,4,ts-global_detected_seizures,297983,298104,121
Jensen_Eisai_groupB,2,5,ts-global_detected_seizures,298032,298124,92
Jensen_Eisai_groupB,1,4,ts-global_detected_seizures,298113,298151,38
Jensen_Eisai_groupB,2,5,ts-global_detected_seizures,298145,298169,24
Jensen_Eisai_groupB,1,4,ts-global_detected_seizures,298179,298207,28
Jensen_Eisai_groupB,1,4,ts-global_detected_seizures,298234,298290,56
Jensen_Eisai_groupB,2,5,ts-global_detected_seizures,298343,298385,42
Jensen_Eisai_groupB,1,4,ts-global_detected_seizures,298375,298416,41
Jensen_Eisai_groupB,1,4,ts-global_detected_seizures,298417,298461,44
Jensen_Eisai_groupB,1,4,ts-global_detected_seizures,298462,299285,823
Jensen_Eisai_groupB,2,5,ts-global_detected_seizures,298472,298501,29
Jensen_Eisai_groupB,2,5,ts-global_detected_seizures,298609,298659,50
Jensen_Eisai_groupB,2,5,ts-global_detected_seizures,298762,298791,29
Jensen_Eisai_groupB,2,5,ts-global_detected_seizures,298827,298860,33
Jensen_Eisai_groupB,2,5,ts-global_detected_seizures,299002,299065,63
Jensen_Eisai_groupB,3,6,ts-global_detected_seizures,299010,300793,1783
Jensen_Eisai_groupB,2,5,ts-global_detected_seizures,299140,299209,69
Jensen_Eisai_groupB,2,5,ts-global_detected_seizures,299236,299266,30
Jensen_Eisai_groupB,1,4,ts-global_detected_seizures,299286,299326,40
Jensen_Eisai_groupB,2,5,ts-global_detected_seizures,299307,299346,39
Jensen_Eisai_groupB,1,4,ts-global_detected_seizures,299327,299356,29
Jensen_Eisai_groupB,1,4,ts-global_detected_seizures,299357,299405,48
Jensen_Eisai_groupB,2,5,ts-global_detected_seizures,299373,299396,23
Jensen_Eisai_groupB,1,4,ts-global_detected_seizures,299408,299439,31
Jensen_Eisai_groupB,2,5,ts-global_detected_seizures,299436,299461,25
Jensen_Eisai_groupB,1,4,ts-global_detected_seizures,299447,299470,23
Jensen_Eisai_groupB,1,4,ts-global_detected_seizures,299472,299501,29
Jensen_Eisai_groupB,2,5,ts-global_detected_seizures,299515,299546,31
Jensen_Eisai_groupB,1,4,ts-global_detected_seizures,299575,299600,25
Jensen_Eisai_groupB,2,5,ts-global_detected_seizures,299587,299626,39
Jensen_Eisai_groupB,1,4,ts-global_detected_seizures,299601,299628,27
Jensen_Eisai_groupB,1,4,ts-global_detected_seizures,299629,299659,30
Jensen_Eisai_groupB,1,4,ts-global_detected_seizures,299672,299697,25
Jensen_Eisai_groupB,1,4,ts-global_detected_seizures,299715,300483,768
Jensen_Eisai_groupB,2,5,ts-global_detected_seizures,299723,299772,49
Jensen_Eisai_groupB,2,5,ts-global_detected_seizures,299819,299855,36
Jensen_Eisai_groupB,2,5,ts-global_detected_seizures,299856,299881,25
Jensen_Eisai_groupB,2,5,ts-global_detected_seizures,299883,299949,66
Jensen_Eisai_groupB,2,5,ts-global_detected_seizures,299999,300046,47
Jensen_Eisai_groupB,2,5,ts-global_detected_seizures,300050,300081,31
Jensen_Eisai_groupB,2,5,ts-global_detected_seizures,300177,300208,31
Jensen_Eisai_groupB,2,5,ts-global_detected_seizures,300221,300251,30
Jensen_Eisai_groupB,2,5,ts-global_detected_seizures,300277,300303,26
Jensen_Eisai_groupB,2,5,ts-global_detected_seizures,300327,301128,801
Jensen_Eisai_groupB,1,4,ts-global_detected_seizures,300485,300510,25
Jensen_Eisai_groupB,1,4,ts-global_detected_seizures,300511,300574,63
Jensen_Eisai_groupB,1,4,ts-global_detected_seizures,300589,300621,32
Jensen_Eisai_groupB,1,4,ts-global_detected_seizures,300632,300664,32
Jensen_Eisai_groupB,1,4,ts-global_detected_seizures,300665,300692,27
Jensen_Eisai_groupB,1,4,ts-global_detected_seizures,300714,300755,41
Jensen_Eisai_groupB,3,6,ts-global_detected_seizures,300794,301211,417
Jensen_Eisai_groupB,2,5,ts-global_detected_seizures,301131,301159,28
Jensen_Eisai_groupB,2,5,ts-global_detected_seizures,301194,301219,25
Jensen_Eisai_groupB,1,4,ts-global_detected_seizures,301197,301261,64
Jensen_Eisai_groupB,3,6,ts-global_detected_seizures,301212,301723,511
Jensen_Eisai_groupB,2,5,ts-global_detected_seizures,301237,301263,26
Jensen_Eisai_groupB,2,5,ts-global_detected_seizures,301267,301292,25
Jensen_Eisai_groupB,1,4,ts-global_detected_seizures,301283,301310,27
Jensen_Eisai_groupB,2,5,ts-global_detected_seizures,301312,301366,54
Jensen_Eisai_groupB,1,4,ts-global_detected_seizures,301313,301764,451
Jensen_Eisai_groupB,2,5,ts-global_detected_seizures,301404,301427,23
Jensen_Eisai_groupB,2,5,ts-global_detected_seizures,301447,301808,361
Jensen_Eisai_groupB,3,6,ts-global_detected_seizures,301738,318461,16723
Jensen_Eisai_groupB,1,4,ts-global_detected_seizures,301782,302177,395
Jensen_Eisai_groupB,2,5,ts-global_detected_seizures,301830,302354,524
Jensen_Eisai_groupB,1,4,ts-global_detected_seizures,302178,302410,232
Jensen_Eisai_groupB,2,5,ts-global_detected_seizures,302355,302445,90
Jensen_Eisai_groupB,1,4,ts-global_detected_seizures,302411,302528,117
Jensen_Eisai_groupB,2,5,ts-global_detected_seizures,302446,302487,41
Jensen_Eisai_groupB,2,5,ts-global_detected_seizures,302488,302628,140
Jensen_Eisai_groupB,1,4,ts-global_detected_seizures,302529,302683,154
Jensen_Eisai_groupB,2,5,ts-global_detected_seizures,302629,302672,43
Jensen_Eisai_groupB,2,5,ts-global_detected_seizures,302674,302778,104
Jensen_Eisai_groupB,1,4,ts-global_detected_seizures,302684,302746,62
Jensen_Eisai_groupB,1,4,ts-global_detected_seizures,302747,302849,102
Jensen_Eisai_groupB,2,5,ts-global_detected_seizures,302796,302858,62
Jensen_Eisai_groupB,1,4,ts-global_detected_seizures,302850,302880,30
Jensen_Eisai_groupB,2,5,ts-global_detected_seizures,302878,302900,22
Jensen_Eisai_groupB,1,4,ts-global_detected_seizures,302881,302925,44
Jensen_Eisai_groupB,1,4,ts-global_detected_seizures,302926,303009,83
Jensen_Eisai_groupB,2,5,ts-global_detected_seizures,302927,302952,25
Jensen_Eisai_groupB,2,5,ts-global_detected_seizures,302954,302996,42
Jensen_Eisai_groupB,2,5,ts-global_detected_seizures,303015,303055,40
Jensen_Eisai_groupB,1,4,ts-global_detected_seizures,303032,303081,49
Jensen_Eisai_groupB,2,5,ts-global_detected_seizures,303071,303094,23
Jensen_Eisai_groupB,1,4,ts-global_detected_seizures,303087,303156,69
Jensen_Eisai_groupB,2,5,ts-global_detected_seizures,303118,303197,79
Jensen_Eisai_groupB,1,4,ts-global_detected_seizures,303159,303209,50
Jensen_Eisai_groupB,2,5,ts-global_detected_seizures,303205,303244,39
Jensen_Eisai_groupB,1,4,ts-global_detected_seizures,303210,303297,87
Jensen_Eisai_groupB,2,5,ts-global_detected_seizures,303261,303303,42
Jensen_Eisai_groupB,1,4,ts-global_detected_seizures,303298,303393,95
Jensen_Eisai_groupB,2,5,ts-global_detected_seizures,303310,303355,45
Jensen_Eisai_groupB,2,5,ts-global_detected_seizures,303368,303394,26
Jensen_Eisai_groupB,2,5,ts-global_detected_seizures,303395,303433,38
Jensen_Eisai_groupB,1,4,ts-global_detected_seizures,303430,303552,122
Jensen_Eisai_groupB,2,5,ts-global_detected_seizures,303434,303482,48
Jensen_Eisai_groupB,2,5,ts-global_detected_seizures,303485,303520,35
Jensen_Eisai_groupB,1,4,ts-global_detected_seizures,303553,303781,228
Jensen_Eisai_groupB,2,5,ts-global_detected_seizures,303568,303654,86
Jensen_Eisai_groupB,2,5,ts-global_detected_seizures,303656,303691,35
Jensen_Eisai_groupB,2,5,ts-global_detected_seizures,303711,303736,25
Jensen_Eisai_groupB,1,4,ts-global_detected_seizures,303782,303902,120
Jensen_Eisai_groupB,2,5,ts-global_detected_seizures,303824,303851,27
Jensen_Eisai_groupB,1,4,ts-global_detected_seizures,303903,303937,34
Jensen_Eisai_groupB,2,5,ts-global_detected_seizures,303927,303962,35
Jensen_Eisai_groupB,1,4,ts-global_detected_seizures,303938,304011,73
Jensen_Eisai_groupB,2,5,ts-global_detected_seizures,303963,303998,35
Jensen_Eisai_groupB,1,4,ts-global_detected_seizures,304012,304144,132
Jensen_Eisai_groupB,2,5,ts-global_detected_seizures,304041,304091,50
Jensen_Eisai_groupB,2,5,ts-global_detected_seizures,304092,304114,22
Jensen_Eisai_groupB,2,5,ts-global_detected_seizures,304118,304187,69
Jensen_Eisai_groupB,1,4,ts-global_detected_seizures,304145,304200,55
Jensen_Eisai_groupB,2,5,ts-global_detected_seizures,304188,304235,47
Jensen_Eisai_groupB,1,4,ts-global_detected_seizures,304201,304245,44
Jensen_Eisai_groupB,2,5,ts-global_detected_seizures,304236,304277,41
Jensen_Eisai_groupB,2,5,ts-global_detected_seizures,304278,304324,46
Jensen_Eisai_groupB,1,4,ts-global_detected_seizures,304321,304402,81
Jensen_Eisai_groupB,2,5,ts-global_detected_seizures,304325,304392,67
Jensen_Eisai_groupB,1,4,ts-global_detected_seizures,304403,304616,213
Jensen_Eisai_groupB,2,5,ts-global_detected_seizures,304423,304477,54
Jensen_Eisai_groupB,2,5,ts-global_detected_seizures,304585,304624,39
Jensen_Eisai_groupB,1,4,ts-global_detected_seizures,304618,304849,231
Jensen_Eisai_groupB,2,5,ts-global_detected_seizures,304657,304679,22
Jensen_Eisai_groupB,2,5,ts-global_detected_seizures,304689,304711,22
Jensen_Eisai_groupB,2,5,ts-global_detected_seizures,304713,304757,44
Jensen_Eisai_groupB,2,5,ts-global_detected_seizures,304781,304827,46
Jensen_Eisai_groupB,2,5,ts-global_detected_seizures,304828,304860,32
Jensen_Eisai_groupB,1,4,ts-global_detected_seizures,304850,304893,43
Jensen_Eisai_groupB,2,5,ts-global_detected_seizures,304885,304917,32
Jensen_Eisai_groupB,1,4,ts-global_detected_seizures,304894,304951,57
Jensen_Eisai_groupB,2,5,ts-global_detected_seizures,304938,304976,38
Jensen_Eisai_groupB,1,4,ts-global_detected_seizures,304970,305097,127
Jensen_Eisai_groupB,2,5,ts-global_detected_seizures,304978,305005,27
Jensen_Eisai_groupB,2,5,ts-global_detected_seizures,305038,305066,28
Jensen_Eisai_groupB,1,4,ts-global_detected_seizures,305143,305186,43
Jensen_Eisai_groupB,2,5,ts-global_detected_seizures,305171,305205,34
Jensen_Eisai_groupB,1,4,ts-global_detected_seizures,305187,305323,136
Jensen_Eisai_groupB,2,5,ts-global_detected_seizures,305254,305350,96
Jensen_Eisai_groupB,1,4,ts-global_detected_seizures,305340,305376,36
Jensen_Eisai_groupB,2,5,ts-global_detected_seizures,305361,305421,60
Jensen_Eisai_groupB,1,4,ts-global_detected_seizures,305377,305471,94
Jensen_Eisai_groupB,2,5,ts-global_detected_seizures,305422,305453,31
Jensen_Eisai_groupB,2,5,ts-global_detected_seizures,305454,305479,25
Jensen_Eisai_groupB,1,4,ts-global_detected_seizures,305472,305535,63
Jensen_Eisai_groupB,2,5,ts-global_detected_seizures,305502,305601,99
Jensen_Eisai_groupB,1,4,ts-global_detected_seizures,305536,305999,463
Jensen_Eisai_groupB,2,5,ts-global_detected_seizures,305624,305681,57
Jensen_Eisai_groupB,2,5,ts-global_detected_seizures,305691,305736,45
Jensen_Eisai_groupB,2,5,ts-global_detected_seizures,305746,305784,38
Jensen_Eisai_groupB,2,5,ts-global_detected_seizures,305785,305836,51
Jensen_Eisai_groupB,2,5,ts-global_detected_seizures,305837,305905,68
Jensen_Eisai_groupB,2,5,ts-global_detected_seizures,305913,306001,88
Jensen_Eisai_groupB,2,5,ts-global_detected_seizures,306004,306050,46
Jensen_Eisai_groupB,1,4,ts-global_detected_seizures,306007,306100,93
Jensen_Eisai_groupB,2,5,ts-global_detected_seizures,306051,306114,63
Jensen_Eisai_groupB,1,4,ts-global_detected_seizures,306101,306152,51
Jensen_Eisai_groupB,2,5,ts-global_detected_seizures,306115,306176,61
Jensen_Eisai_groupB,1,4,ts-global_detected_seizures,306153,306282,129
Jensen_Eisai_groupB,2,5,ts-global_detected_seizures,306177,306223,46
Jensen_Eisai_groupB,1,4,ts-global_detected_seizures,306283,306309,26
Jensen_Eisai_groupB,1,4,ts-global_detected_seizures,306311,306338,27
Jensen_Eisai_groupB,1,4,ts-global_detected_seizures,306340,306394,54
Jensen_Eisai_groupB,2,5,ts-global_detected_seizures,306378,306408,30
Jensen_Eisai_groupB,1,4,ts-global_detected_seizures,306395,306500,105
Jensen_Eisai_groupB,1,4,ts-global_detected_seizures,306501,306595,94
Jensen_Eisai_groupB,1,4,ts-global_detected_seizures,306596,306898,302
Jensen_Eisai_groupB,2,5,ts-global_detected_seizures,306797,306928,131
Jensen_Eisai_groupB,1,4,ts-global_detected_seizures,306927,306970,43
Jensen_Eisai_groupB,2,5,ts-global_detected_seizures,306929,307605,676
Jensen_Eisai_groupB,1,4,ts-global_detected_seizures,306978,307183,205
Jensen_Eisai_groupB,1,4,ts-global_detected_seizures,307184,307330,146
Jensen_Eisai_groupB,1,4,ts-global_detected_seizures,307343,307427,84
Jensen_Eisai_groupB,1,4,ts-global_detected_seizures,307430,307479,49
Jensen_Eisai_groupB,1,4,ts-global_detected_seizures,307480,307561,81
Jensen_Eisai_groupB,1,4,ts-global_detected_seizures,307562,307601,39
Jensen_Eisai_groupB,1,4,ts-global_detected_seizures,307602,307754,152
Jensen_Eisai_groupB,2,5,ts-global_detected_seizures,307606,307708,102
Jensen_Eisai_groupB,2,5,ts-global_detected_seizures,307709,307759,50
Jensen_Eisai_groupB,1,4,ts-global_detected_seizures,307755,307800,45
Jensen_Eisai_groupB,2,5,ts-global_detected_seizures,307760,307787,27
Jensen_Eisai_groupB,1,4,ts-global_detected_seizures,307801,307849,48
Jensen_Eisai_groupB,1,4,ts-global_detected_seizures,307850,307912,62
Jensen_Eisai_groupB,2,5,ts-global_detected_seizures,307898,307923,25
Jensen_Eisai_groupB,1,4,ts-global_detected_seizures,307914,307956,42
Jensen_Eisai_groupB,1,4,ts-global_detected_seizures,307969,307997,28
Jensen_Eisai_groupB,1,4,ts-global_detected_seizures,307998,308025,27
Jensen_Eisai_groupB,2,5,ts-global_detected_seizures,308030,308054,24
Jensen_Eisai_groupB,1,4,ts-global_detected_seizures,308034,308093,59
Jensen_Eisai_groupB,1,4,ts-global_detected_seizures,308094,308192,98
Jensen_Eisai_groupB,1,4,ts-global_detected_seizures,308209,308270,61
Jensen_Eisai_groupB,2,5,ts-global_detected_seizures,308212,308235,23
Jensen_Eisai_groupB,1,4,ts-global_detected_seizures,308289,308336,47
Jensen_Eisai_groupB,2,5,ts-global_detected_seizures,308312,308336,24
Jensen_Eisai_groupB,1,4,ts-global_detected_seizures,308339,308488,149
Jensen_Eisai_groupB,2,5,ts-global_detected_seizures,308418,308445,27
Jensen_Eisai_groupB,1,4,ts-global_detected_seizures,308505,308609,104
Jensen_Eisai_groupB,2,5,ts-global_detected_seizures,308575,308600,25
Jensen_Eisai_groupB,2,5,ts-global_detected_seizures,308629,308665,36
Jensen_Eisai_groupB,1,4,ts-global_detected_seizures,308643,308667,24
Jensen_Eisai_groupB,2,5,ts-global_detected_seizures,308682,308768,86
Jensen_Eisai_groupB,2,5,ts-global_detected_seizures,308682,308768,86
Jensen_Eisai_groupB,1,4,ts-global_detected_seizures,308688,308722,34
Jensen_Eisai_groupB,1,4,ts-global_detected_seizures,308723,308766,43
Jensen_Eisai_groupB,1,4,ts-global_detected_seizures,308775,309086,311
Jensen_Eisai_groupB,2,5,ts-global_detected_seizures,308784,309041,257
Jensen_Eisai_groupB,2,5,ts-global_detected_seizures,309043,309199,156
Jensen_Eisai_groupB,1,4,ts-global_detected_seizures,309088,309129,41
Jensen_Eisai_groupB,1,4,ts-global_detected_seizures,309130,309154,24
Jensen_Eisai_groupB,1,4,ts-global_detected_seizures,309162,309188,26
Jensen_Eisai_groupB,1,4,ts-global_detected_seizures,309189,309256,67
Jensen_Eisai_groupB,2,5,ts-global_detected_seizures,309201,309230,29
Jensen_Eisai_groupB,1,4,ts-global_detected_seizures,309265,309405,140
Jensen_Eisai_groupB,2,5,ts-global_detected_seizures,309319,309341,22
Jensen_Eisai_groupB,1,4,ts-global_detected_seizures,309406,309643,237
Jensen_Eisai_groupB,2,5,ts-global_detected_seizures,309617,309644,27
Jensen_Eisai_groupB,1,4,ts-global_detected_seizures,309644,309840,196
Jensen_Eisai_groupB,2,5,ts-global_detected_seizures,309722,309748,26
Jensen_Eisai_groupB,2,5,ts-global_detected_seizures,309776,309798,22
Jensen_Eisai_groupB,1,4,ts-global_detected_seizures,309841,309970,129
Jensen_Eisai_groupB,2,5,ts-global_detected_seizures,309874,309939,65
Jensen_Eisai_groupB,2,5,ts-global_detected_seizures,309940,310301,361
Jensen_Eisai_groupB,1,4,ts-global_detected_seizures,309971,310095,124
Jensen_Eisai_groupB,1,4,ts-global_detected_seizures,310138,310273,135
Jensen_Eisai_groupB,1,4,ts-global_detected_seizures,310292,310620,328
Jensen_Eisai_groupB,2,5,ts-global_detected_seizures,310585,310614,29
Jensen_Eisai_groupB,1,4,ts-global_detected_seizures,310622,310662,40
Jensen_Eisai_groupB,1,4,ts-global_detected_seizures,310663,310790,127
Jensen_Eisai_groupB,2,5,ts-global_detected_seizures,310782,310810,28
Jensen_Eisai_groupB,1,4,ts-global_detected_seizures,310793,310823,30
Jensen_Eisai_groupB,1,4,ts-global_detected_seizures,310824,310883,59
Jensen_Eisai_groupB,2,5,ts-global_detected_seizures,310872,310896,24
Jensen_Eisai_groupB,1,4,ts-global_detected_seizures,310884,310913,29
Jensen_Eisai_groupB,1,4,ts-global_detected_seizures,310914,310990,76
Jensen_Eisai_groupB,2,5,ts-global_detected_seizures,310987,311017,30
Jensen_Eisai_groupB,1,4,ts-global_detected_seizures,310991,311208,217
Jensen_Eisai_groupB,2,5,ts-global_detected_seizures,311039,311061,22
Jensen_Eisai_groupB,2,5,ts-global_detected_seizures,311097,311604,507
Jensen_Eisai_groupB,1,4,ts-global_detected_seizures,311209,311419,210
Jensen_Eisai_groupB,1,4,ts-global_detected_seizures,311420,311480,60
Jensen_Eisai_groupB,1,4,ts-global_detected_seizures,311481,311721,240
Jensen_Eisai_groupB,2,5,ts-global_detected_seizures,311606,311788,182
Jensen_Eisai_groupB,1,4,ts-global_detected_seizures,311722,311756,34
Jensen_Eisai_groupB,1,4,ts-global_detected_seizures,311757,312100,343
Jensen_Eisai_groupB,2,5,ts-global_detected_seizures,311822,311844,22
Jensen_Eisai_groupB,2,5,ts-global_detected_seizures,311887,311936,49
Jensen_Eisai_groupB,2,5,ts-global_detected_seizures,311955,311982,27
Jensen_Eisai_groupB,1,4,ts-global_detected_seizures,312101,312139,38
Jensen_Eisai_groupB,1,4,ts-global_detected_seizures,312140,312185,45
Jensen_Eisai_groupB,1,4,ts-global_detected_seizures,312186,312234,48
Jensen_Eisai_groupB,1,4,ts-global_detected_seizures,312244,312295,51
Jensen_Eisai_groupB,1,4,ts-global_detected_seizures,312336,312505,169
Jensen_Eisai_groupB,2,5,ts-global_detected_seizures,312354,312388,34
Jensen_Eisai_groupB,2,5,ts-global_detected_seizures,312465,312488,23
Jensen_Eisai_groupB,2,5,ts-global_detected_seizures,312492,312517,25
Jensen_Eisai_groupB,1,4,ts-global_detected_seizures,312506,312604,98
Jensen_Eisai_groupB,2,5,ts-global_detected_seizures,312518,312553,35
Jensen_Eisai_groupB,2,5,ts-global_detected_seizures,312554,312606,52
Jensen_Eisai_groupB,2,5,ts-global_detected_seizures,312611,312751,140
Jensen_Eisai_groupB,1,4,ts-global_detected_seizures,312619,312649,30
Jensen_Eisai_groupB,1,4,ts-global_detected_seizures,312650,312690,40
Jensen_Eisai_groupB,1,4,ts-global_detected_seizures,312691,312761,70
Jensen_Eisai_groupB,1,4,ts-global_detected_seizures,312762,312788,26
Jensen_Eisai_groupB,1,4,ts-global_detected_seizures,312789,312818,29
Jensen_Eisai_groupB,1,4,ts-global_detected_seizures,312819,312847,28
Jensen_Eisai_groupB,2,5,ts-global_detected_seizures,312835,312858,23
Jensen_Eisai_groupB,1,4,ts-global_detected_seizures,312848,312995,147
Jensen_Eisai_groupB,1,4,ts-global_detected_seizures,312996,313090,94
Jensen_Eisai_groupB,2,5,ts-global_detected_seizures,313037,313059,22
Jensen_Eisai_groupB,2,5,ts-global_detected_seizures,313084,313114,30
Jensen_Eisai_groupB,1,4,ts-global_detected_seizures,313092,313755,663
Jensen_Eisai_groupB,2,5,ts-global_detected_seizures,313204,313229,25
Jensen_Eisai_groupB,2,5,ts-global_detected_seizures,313358,313395,37
Jensen_Eisai_groupB,2,5,ts-global_detected_seizures,313433,313460,27
Jensen_Eisai_groupB,2,5,ts-global_detected_seizures,313492,313517,25
Jensen_Eisai_groupB,2,5,ts-global_detected_seizures,313683,313705,22
Jensen_Eisai_groupB,1,4,ts-global_detected_seizures,313756,313824,68
Jensen_Eisai_groupB,2,5,ts-global_detected_seizures,313758,313781,23
Jensen_Eisai_groupB,2,5,ts-global_detected_seizures,313823,314073,250
Jensen_Eisai_groupB,1,4,ts-global_detected_seizures,313825,313884,59
Jensen_Eisai_groupB,1,4,ts-global_detected_seizures,313925,313952,27
Jensen_Eisai_groupB,2,5,ts-global_detected_seizures,314074,314108,34
Jensen_Eisai_groupB,2,5,ts-global_detected_seizures,314109,314611,502
Jensen_Eisai_groupB,1,4,ts-global_detected_seizures,314364,314622,258
Jensen_Eisai_groupB,2,5,ts-global_detected_seizures,314612,315390,778
Jensen_Eisai_groupB,1,4,ts-global_detected_seizures,314623,314783,160
Jensen_Eisai_groupB,1,4,ts-global_detected_seizures,314784,315054,270
Jensen_Eisai_groupB,1,4,ts-global_detected_seizures,315055,315134,79
Jensen_Eisai_groupB,1,4,ts-global_detected_seizures,315135,315203,68
Jensen_Eisai_groupB,1,4,ts-global_detected_seizures,315204,315232,28
Jensen_Eisai_groupB,1,4,ts-global_detected_seizures,315233,315334,101
Jensen_Eisai_groupB,1,4,ts-global_detected_seizures,315335,315515,180
Jensen_Eisai_groupB,2,5,ts-global_detected_seizures,315398,315434,36
Jensen_Eisai_groupB,1,4,ts-global_detected_seizures,315516,315834,318
Jensen_Eisai_groupB,2,5,ts-global_detected_seizures,315517,315544,27
Jensen_Eisai_groupB,2,5,ts-global_detected_seizures,315585,315613,28
Jensen_Eisai_groupB,2,5,ts-global_detected_seizures,315620,316388,768
Jensen_Eisai_groupB,1,4,ts-global_detected_seizures,315852,315882,30
Jensen_Eisai_groupB,1,4,ts-global_detected_seizures,315883,315956,73
Jensen_Eisai_groupB,1,4,ts-global_detected_seizures,315957,316205,248
Jensen_Eisai_groupB,1,4,ts-global_detected_seizures,316207,316256,49
Jensen_Eisai_groupB,1,4,ts-global_detected_seizures,316257,316354,97
Jensen_Eisai_groupB,1,4,ts-global_detected_seizures,316355,316389,34
Jensen_Eisai_groupB,2,5,ts-global_detected_seizures,316389,316458,69
Jensen_Eisai_groupB,1,4,ts-global_detected_seizures,316390,317443,1053
Jensen_Eisai_groupB,2,5,ts-global_detected_seizures,316602,316624,22
Jensen_Eisai_groupB,2,5,ts-global_detected_seizures,316717,316749,32
Jensen_Eisai_groupB,2,5,ts-global_detected_seizures,316823,316850,27
Jensen_Eisai_groupB,2,5,ts-global_detected_seizures,316997,317035,38
Jensen_Eisai_groupB,2,5,ts-global_detected_seizures,317046,317078,32
Jensen_Eisai_groupB,2,5,ts-global_detected_seizures,317204,317232,28
Jensen_Eisai_groupB,2,5,ts-global_detected_seizures,317302,317330,28
Jensen_Eisai_groupB,2,5,ts-global_detected_seizures,317405,317428,23
Jensen_Eisai_groupB,1,4,ts-global_detected_seizures,317457,317568,111
Jensen_Eisai_groupB,2,5,ts-global_detected_seizures,317481,317545,64
Jensen_Eisai_groupB,2,5,ts-global_detected_seizures,317546,317592,46
Jensen_Eisai_groupB,1,4,ts-global_detected_seizures,317588,317664,76
Jensen_Eisai_groupB,2,5,ts-global_detected_seizures,317593,318774,1181
Jensen_Eisai_groupB,1,4,ts-global_detected_seizures,317665,317774,109
Jensen_Eisai_groupB,1,4,ts-global_detected_seizures,317786,317825,39
Jensen_Eisai_groupB,1,4,ts-global_detected_seizures,317861,317910,49
Jensen_Eisai_groupB,1,4,ts-global_detected_seizures,317911,318132,221
Jensen_Eisai_groupB,1,4,ts-global_detected_seizures,318211,318282,71
Jensen_Eisai_groupB,3,6,ts-global_detected_seizures,318462,345586,27124
Jensen_Eisai_groupB,1,4,ts-global_detected_seizures,318884,318912,28
Jensen_Eisai_groupB,1,4,ts-global_detected_seizures,318983,319038,55
Jensen_Eisai_groupB,2,5,ts-global_detected_seizures,318996,319044,48
Jensen_Eisai_groupB,2,5,ts-global_detected_seizures,319080,319108,28
Jensen_Eisai_groupB,2,5,ts-global_detected_seizures,319120,319144,24
Jensen_Eisai_groupB,2,5,ts-global_detected_seizures,319267,319295,28
Jensen_Eisai_groupB,2,5,ts-global_detected_seizures,319349,319376,27
Jensen_Eisai_groupB,2,5,ts-global_detected_seizures,319522,319571,49
Jensen_Eisai_groupB,1,4,ts-global_detected_seizures,319542,319610,68
Jensen_Eisai_groupB,1,4,ts-global_detected_seizures,319611,319633,22
Jensen_Eisai_groupB,1,4,ts-global_detected_seizures,319634,319989,355
Jensen_Eisai_groupB,2,5,ts-global_detected_seizures,319671,319694,23
Jensen_Eisai_groupB,2,5,ts-global_detected_seizures,319781,319806,25
Jensen_Eisai_groupB,2,5,ts-global_detected_seizures,319866,319892,26
Jensen_Eisai_groupB,2,5,ts-global_detected_seizures,319923,319965,42
Jensen_Eisai_groupB,2,5,ts-global_detected_seizures,320014,320036,22
Jensen_Eisai_groupB,1,4,ts-global_detected_seizures,320020,320062,42
Jensen_Eisai_groupB,1,4,ts-global_detected_seizures,320165,320222,57
Jensen_Eisai_groupB,1,4,ts-global_detected_seizures,320226,320291,65
Jensen_Eisai_groupB,2,5,ts-global_detected_seizures,320229,320259,30
Jensen_Eisai_groupB,2,5,ts-global_detected_seizures,320267,320289,22
Jensen_Eisai_groupB,1,4,ts-global_detected_seizures,320327,320354,27
Jensen_Eisai_groupB,1,4,ts-global_detected_seizures,320355,320378,23
Jensen_Eisai_groupB,1,4,ts-global_detected_seizures,320380,320406,26
Jensen_Eisai_groupB,2,5,ts-global_detected_seizures,320388,320416,28
Jensen_Eisai_groupB,2,5,ts-global_detected_seizures,320432,320470,38
Jensen_Eisai_groupB,2,5,ts-global_detected_seizures,320477,320523,46
Jensen_Eisai_groupB,1,4,ts-global_detected_seizures,320584,320637,53
Jensen_Eisai_groupB,2,5,ts-global_detected_seizures,320596,320622,26
Jensen_Eisai_groupB,1,4,ts-global_detected_seizures,320665,320724,59
Jensen_Eisai_groupB,2,5,ts-global_detected_seizures,320673,320698,25
Jensen_Eisai_groupB,1,4,ts-global_detected_seizures,320725,320794,69
Jensen_Eisai_groupB,2,5,ts-global_detected_seizures,320794,321982,1188
Jensen_Eisai_groupB,1,4,ts-global_detected_seizures,320796,320988,192
Jensen_Eisai_groupB,1,4,ts-global_detected_seizures,320989,321030,41
Jensen_Eisai_groupB,1,4,ts-global_detected_seizures,321041,321066,25
Jensen_Eisai_groupB,1,4,ts-global_detected_seizures,321085,321131,46
Jensen_Eisai_groupB,1,4,ts-global_detected_seizures,321134,321211,77
Jensen_Eisai_groupB,1,4,ts-global_detected_seizures,321238,321348,110
Jensen_Eisai_groupB,1,4,ts-global_detected_seizures,321349,321504,155
Jensen_Eisai_groupB,1,4,ts-global_detected_seizures,321505,321529,24
Jensen_Eisai_groupB,1,4,ts-global_detected_seizures,321562,321633,71
Jensen_Eisai_groupB,1,4,ts-global_detected_seizures,321709,321789,80
Jensen_Eisai_groupB,1,4,ts-global_detected_seizures,321833,321876,43
Jensen_Eisai_groupB,1,4,ts-global_detected_seizures,321878,322038,160
Jensen_Eisai_groupB,2,5,ts-global_detected_seizures,321984,322058,74
Jensen_Eisai_groupB,1,4,ts-global_detected_seizures,322058,322288,230
Jensen_Eisai_groupB,2,5,ts-global_detected_seizures,322102,322125,23
Jensen_Eisai_groupB,2,5,ts-global_detected_seizures,322158,322192,34
Jensen_Eisai_groupB,2,5,ts-global_detected_seizures,322225,322250,25
Jensen_Eisai_groupB,1,4,ts-global_detected_seizures,322289,322312,23
Jensen_Eisai_groupB,2,5,ts-global_detected_seizures,322311,322337,26
Jensen_Eisai_groupB,1,4,ts-global_detected_seizures,322332,322492,160
Jensen_Eisai_groupB,2,5,ts-global_detected_seizures,322445,322472,27
Jensen_Eisai_groupB,2,5,ts-global_detected_seizures,322494,322528,34
Jensen_Eisai_groupB,2,5,ts-global_detected_seizures,322540,322564,24
Jensen_Eisai_groupB,2,5,ts-global_detected_seizures,322579,322622,43
Jensen_Eisai_groupB,1,4,ts-global_detected_seizures,322601,322629,28
Jensen_Eisai_groupB,1,4,ts-global_detected_seizures,322630,322656,26
Jensen_Eisai_groupB,2,5,ts-global_detected_seizures,322633,322935,302
Jensen_Eisai_groupB,1,4,ts-global_detected_seizures,322658,322907,249
Jensen_Eisai_groupB,1,4,ts-global_detected_seizures,322926,322960,34
Jensen_Eisai_groupB,1,4,ts-global_detected_seizures,322961,323011,50
Jensen_Eisai_groupB,1,4,ts-global_detected_seizures,323012,323038,26
Jensen_Eisai_groupB,1,4,ts-global_detected_seizures,323039,323066,27
Jensen_Eisai_groupB,1,4,ts-global_detected_seizures,323067,323353,286
Jensen_Eisai_groupB,2,5,ts-global_detected_seizures,323320,323351,31
Jensen_Eisai_groupB,1,4,ts-global_detected_seizures,323355,323675,320
Jensen_Eisai_groupB,2,5,ts-global_detected_seizures,323459,323490,31
Jensen_Eisai_groupB,2,5,ts-global_detected_seizures,323539,323570,31
Jensen_Eisai_groupB,2,5,ts-global_detected_seizures,323575,323617,42
Jensen_Eisai_groupB,2,5,ts-global_detected_seizures,323624,323670,46
Jensen_Eisai_groupB,1,4,ts-global_detected_seizures,323705,323940,235
Jensen_Eisai_groupB,2,5,ts-global_detected_seizures,323736,323761,25
Jensen_Eisai_groupB,2,5,ts-global_detected_seizures,323773,323801,28
Jensen_Eisai_groupB,2,5,ts-global_detected_seizures,323892,323920,28
Jensen_Eisai_groupB,1,4,ts-global_detected_seizures,323955,323986,31
Jensen_Eisai_groupB,2,5,ts-global_detected_seizures,323976,324001,25
Jensen_Eisai_groupB,1,4,ts-global_detected_seizures,323987,324069,82
Jensen_Eisai_groupB,2,5,ts-global_detected_seizures,324026,324048,22
Jensen_Eisai_groupB,1,4,ts-global_detected_seizures,324070,324095,25
Jensen_Eisai_groupB,2,5,ts-global_detected_seizures,324080,324106,26
Jensen_Eisai_groupB,1,4,ts-global_detected_seizures,324096,324321,225
Jensen_Eisai_groupB,2,5,ts-global_detected_seizures,324284,324323,39
Jensen_Eisai_groupB,2,5,ts-global_detected_seizures,324324,324346,22
Jensen_Eisai_groupB,1,4,ts-global_detected_seizures,324329,324356,27
Jensen_Eisai_groupB,1,4,ts-global_detected_seizures,324357,324407,50
Jensen_Eisai_groupB,2,5,ts-global_detected_seizures,324372,324416,44
Jensen_Eisai_groupB,1,4,ts-global_detected_seizures,324408,324433,25
Jensen_Eisai_groupB,1,4,ts-global_detected_seizures,324473,324656,183
Jensen_Eisai_groupB,2,5,ts-global_detected_seizures,324531,324571,40
Jensen_Eisai_groupB,2,5,ts-global_detected_seizures,324637,324665,28
Jensen_Eisai_groupB,1,4,ts-global_detected_seizures,324657,324979,322
Jensen_Eisai_groupB,2,5,ts-global_detected_seizures,324728,324756,28
Jensen_Eisai_groupB,2,5,ts-global_detected_seizures,324820,324846,26
Jensen_Eisai_groupB,2,5,ts-global_detected_seizures,324932,324989,57
Jensen_Eisai_groupB,1,4,ts-global_detected_seizures,324980,325125,145
Jensen_Eisai_groupB,2,5,ts-global_detected_seizures,325005,325356,351
Jensen_Eisai_groupB,1,4,ts-global_detected_seizures,325135,325243,108
Jensen_Eisai_groupB,1,4,ts-global_detected_seizures,325244,326009,765
Jensen_Eisai_groupB,2,5,ts-global_detected_seizures,325358,326423,1065
Jensen_Eisai_groupB,1,4,ts-global_detected_seizures,326010,326364,354
Jensen_Eisai_groupB,1,4,ts-global_detected_seizures,326376,326417,41
Jensen_Eisai_groupB,1,4,ts-global_detected_seizures,326418,326927,509
Jensen_Eisai_groupB,2,5,ts-global_detected_seizures,326424,327857,1433
Jensen_Eisai_groupB,1,4,ts-global_detected_seizures,326939,327126,187
Jensen_Eisai_groupB,1,4,ts-global_detected_seizures,327129,327245,116
Jensen_Eisai_groupB,1,4,ts-global_detected_seizures,327247,327516,269
Jensen_Eisai_groupB,1,4,ts-global_detected_seizures,327517,327558,41
Jensen_Eisai_groupB,1,4,ts-global_detected_seizures,327559,327754,195
Jensen_Eisai_groupB,1,4,ts-global_detected_seizures,327755,327803,48
Jensen_Eisai_groupB,1,4,ts-global_detected_seizures,327810,327961,151
Jensen_Eisai_groupB,2,5,ts-global_detected_seizures,327876,329820,1944
Jensen_Eisai_groupB,1,4,ts-global_detected_seizures,327967,328046,79
Jensen_Eisai_groupB,1,4,ts-global_detected_seizures,328047,328162,115
Jensen_Eisai_groupB,1,4,ts-global_detected_seizures,328163,328229,66
Jensen_Eisai_groupB,1,4,ts-global_detected_seizures,328230,328507,277
Jensen_Eisai_groupB,1,4,ts-global_detected_seizures,328508,328780,272
Jensen_Eisai_groupB,1,4,ts-global_detected_seizures,328781,328827,46
Jensen_Eisai_groupB,1,4,ts-global_detected_seizures,328828,329988,1160
Jensen_Eisai_groupB,2,5,ts-global_detected_seizures,329982,330024,42
Jensen_Eisai_groupB,1,4,ts-global_detected_seizures,329989,330098,109
Jensen_Eisai_groupB,2,5,ts-global_detected_seizures,330088,330155,67
Jensen_Eisai_groupB,1,4,ts-global_detected_seizures,330099,330566,467
Jensen_Eisai_groupB,2,5,ts-global_detected_seizures,330290,330330,40
Jensen_Eisai_groupB,2,5,ts-global_detected_seizures,330333,330390,57
Jensen_Eisai_groupB,2,5,ts-global_detected_seizures,330391,330438,47
Jensen_Eisai_groupB,2,5,ts-global_detected_seizures,330470,330512,42
Jensen_Eisai_groupB,1,4,ts-global_detected_seizures,330567,330590,23
Jensen_Eisai_groupB,2,5,ts-global_detected_seizures,330587,330760,173
Jensen_Eisai_groupB,1,4,ts-global_detected_seizures,330602,330641,39
Jensen_Eisai_groupB,1,4,ts-global_detected_seizures,330681,330715,34
Jensen_Eisai_groupB,1,4,ts-global_detected_seizures,330716,330768,52
Jensen_Eisai_groupB,2,5,ts-global_detected_seizures,330761,330795,34
Jensen_Eisai_groupB,1,4,ts-global_detected_seizures,330769,331242,473
Jensen_Eisai_groupB,2,5,ts-global_detected_seizures,330813,330835,22
Jensen_Eisai_groupB,2,5,ts-global_detected_seizures,330872,330906,34
Jensen_Eisai_groupB,2,5,ts-global_detected_seizures,330972,331036,64
Jensen_Eisai_groupB,2,5,ts-global_detected_seizures,331084,331173,89
Jensen_Eisai_groupB,1,4,ts-global_detected_seizures,331243,331474,231
Jensen_Eisai_groupB,2,5,ts-global_detected_seizures,331277,331300,23
Jensen_Eisai_groupB,2,5,ts-global_detected_seizures,331327,331975,648
Jensen_Eisai_groupB,1,4,ts-global_detected_seizures,331475,331610,135
Jensen_Eisai_groupB,1,4,ts-global_detected_seizures,331612,331656,44
Jensen_Eisai_groupB,1,4,ts-global_detected_seizures,331684,331741,57
Jensen_Eisai_groupB,1,4,ts-global_detected_seizures,331742,331767,25
Jensen_Eisai_groupB,1,4,ts-global_detected_seizures,331791,331813,22
Jensen_Eisai_groupB,1,4,ts-global_detected_seizures,331832,331863,31
Jensen_Eisai_groupB,1,4,ts-global_detected_seizures,331864,332005,141
Jensen_Eisai_groupB,2,5,ts-global_detected_seizures,331988,332455,467
Jensen_Eisai_groupB,1,4,ts-global_detected_seizures,332006,332244,238
Jensen_Eisai_groupB,1,4,ts-global_detected_seizures,332245,332271,26
Jensen_Eisai_groupB,1,4,ts-global_detected_seizures,332279,332309,30
Jensen_Eisai_groupB,1,4,ts-global_detected_seizures,332311,332347,36
Jensen_Eisai_groupB,1,4,ts-global_detected_seizures,332408,332431,23
Jensen_Eisai_groupB,1,4,ts-global_detected_seizures,332460,332487,27
Jensen_Eisai_groupB,1,4,ts-global_detected_seizures,332523,332590,67
Jensen_Eisai_groupB,2,5,ts-global_detected_seizures,332570,332592,22
Jensen_Eisai_groupB,1,4,ts-global_detected_seizures,332598,332628,30
Jensen_Eisai_groupB,1,4,ts-global_detected_seizures,332631,332660,29
Jensen_Eisai_groupB,2,5,ts-global_detected_seizures,332665,332711,46
Jensen_Eisai_groupB,2,5,ts-global_detected_seizures,332712,332734,22
Jensen_Eisai_groupB,1,4,ts-global_detected_seizures,332717,332746,29
Jensen_Eisai_groupB,2,5,ts-global_detected_seizures,332835,332858,23
Jensen_Eisai_groupB,2,5,ts-global_detected_seizures,332883,332915,32
Jensen_Eisai_groupB,2,5,ts-global_detected_seizures,332966,332991,25
Jensen_Eisai_groupB,2,5,ts-global_detected_seizures,333030,333052,22
Jensen_Eisai_groupB,2,5,ts-global_detected_seizures,333127,333160,33
Jensen_Eisai_groupB,2,5,ts-global_detected_seizures,333273,333301,28
Jensen_Eisai_groupB,2,5,ts-global_detected_seizures,333303,333368,65
Jensen_Eisai_groupB,2,5,ts-global_detected_seizures,333399,333424,25
Jensen_Eisai_groupB,2,5,ts-global_detected_seizures,333447,333481,34
Jensen_Eisai_groupB,2,5,ts-global_detected_seizures,333528,333550,22
Jensen_Eisai_groupB,2,5,ts-global_detected_seizures,333631,333665,34
Jensen_Eisai_groupB,2,5,ts-global_detected_seizures,333715,333740,25
Jensen_Eisai_groupB,1,4,ts-global_detected_seizures,333761,333884,123
Jensen_Eisai_groupB,2,5,ts-global_detected_seizures,333765,333829,64
Jensen_Eisai_groupB,2,5,ts-global_detected_seizures,333870,333894,24
Jensen_Eisai_groupB,1,4,ts-global_detected_seizures,333970,333993,23
Jensen_Eisai_groupB,2,5,ts-global_detected_seizures,333995,334039,44
Jensen_Eisai_groupB,1,4,ts-global_detected_seizures,334060,334083,23
Jensen_Eisai_groupB,2,5,ts-global_detected_seizures,334117,334144,27
Jensen_Eisai_groupB,2,5,ts-global_detected_seizures,334164,334209,45
Jensen_Eisai_groupB,1,4,ts-global_detected_seizures,334197,334233,36
Jensen_Eisai_groupB,2,5,ts-global_detected_seizures,334252,334290,38
Jensen_Eisai_groupB,1,4,ts-global_detected_seizures,334269,334293,24
Jensen_Eisai_groupB,2,5,ts-global_detected_seizures,334292,334321,29
Jensen_Eisai_groupB,2,5,ts-global_detected_seizures,334355,334382,27
Jensen_Eisai_groupB,2,5,ts-global_detected_seizures,334407,334436,29
Jensen_Eisai_groupB,2,5,ts-global_detected_seizures,334440,334548,108
Jensen_Eisai_groupB,1,4,ts-global_detected_seizures,334565,334596,31
Jensen_Eisai_groupB,1,4,ts-global_detected_seizures,334637,334681,44
Jensen_Eisai_groupB,2,5,ts-global_detected_seizures,334641,334668,27
Jensen_Eisai_groupB,2,5,ts-global_detected_seizures,334721,334770,49
Jensen_Eisai_groupB,1,4,ts-global_detected_seizures,334735,334796,61
Jensen_Eisai_groupB,1,4,ts-global_detected_seizures,334801,334833,32
Jensen_Eisai_groupB,2,5,ts-global_detected_seizures,334811,334847,36
Jensen_Eisai_groupB,1,4,ts-global_detected_seizures,334851,334919,68
Jensen_Eisai_groupB,2,5,ts-global_detected_seizures,334928,334958,30
Jensen_Eisai_groupB,1,4,ts-global_detected_seizures,334931,334966,35
Jensen_Eisai_groupB,2,5,ts-global_detected_seizures,334959,334994,35
Jensen_Eisai_groupB,2,5,ts-global_detected_seizures,335008,335530,522
Jensen_Eisai_groupB,1,4,ts-global_detected_seizures,335234,335348,114
Jensen_Eisai_groupB,1,4,ts-global_detected_seizures,335505,335555,50
Jensen_Eisai_groupB,2,5,ts-global_detected_seizures,335551,335701,150
Jensen_Eisai_groupB,1,4,ts-global_detected_seizures,335583,335611,28
Jensen_Eisai_groupB,1,4,ts-global_detected_seizures,335635,335661,26
Jensen_Eisai_groupB,1,4,ts-global_detected_seizures,335662,335697,35
Jensen_Eisai_groupB,2,5,ts-global_detected_seizures,335702,336019,317
Jensen_Eisai_groupB,1,4,ts-global_detected_seizures,335712,335741,29
Jensen_Eisai_groupB,1,4,ts-global_detected_seizures,335841,335883,42
Jensen_Eisai_groupB,1,4,ts-global_detected_seizures,335912,335944,32
Jensen_Eisai_groupB,1,4,ts-global_detected_seizures,335954,335982,28
Jensen_Eisai_groupB,1,4,ts-global_detected_seizures,335996,336020,24
Jensen_Eisai_groupB,2,5,ts-global_detected_seizures,336020,336069,49
Jensen_Eisai_groupB,1,4,ts-global_detected_seizures,336094,336124,30
Jensen_Eisai_groupB,1,4,ts-global_detected_seizures,336125,336167,42
Jensen_Eisai_groupB,2,5,ts-global_detected_seizures,336131,336159,28
Jensen_Eisai_groupB,2,5,ts-global_detected_seizures,336190,336230,40
Jensen_Eisai_groupB,1,4,ts-global_detected_seizures,336281,336367,86
Jensen_Eisai_groupB,2,5,ts-global_detected_seizures,336284,336306,22
Jensen_Eisai_groupB,1,4,ts-global_detected_seizures,336369,340709,4340
Jensen_Eisai_groupB,2,5,ts-global_detected_seizures,336404,336460,56
Jensen_Eisai_groupB,2,5,ts-global_detected_seizures,336488,336510,22
Jensen_Eisai_groupB,2,5,ts-global_detected_seizures,336590,336625,35
Jensen_Eisai_groupB,2,5,ts-global_detected_seizures,336661,336684,23
Jensen_Eisai_groupB,2,5,ts-global_detected_seizures,336769,336803,34
Jensen_Eisai_groupB,2,5,ts-global_detected_seizures,336804,336890,86
Jensen_Eisai_groupB,2,5,ts-global_detected_seizures,337164,337189,25
Jensen_Eisai_groupB,2,5,ts-global_detected_seizures,337305,337331,26
Jensen_Eisai_groupB,2,5,ts-global_detected_seizures,337392,337421,29
Jensen_Eisai_groupB,2,5,ts-global_detected_seizures,337581,337648,67
Jensen_Eisai_groupB,2,5,ts-global_detected_seizures,337649,337684,35
Jensen_Eisai_groupB,2,5,ts-global_detected_seizures,337813,337835,22
Jensen_Eisai_groupB,2,5,ts-global_detected_seizures,337836,337867,31
Jensen_Eisai_groupB,2,5,ts-global_detected_seizures,337948,338004,56
Jensen_Eisai_groupB,2,5,ts-global_detected_seizures,338027,338050,23
Jensen_Eisai_groupB,2,5,ts-global_detected_seizures,338173,338198,25
Jensen_Eisai_groupB,2,5,ts-global_detected_seizures,338255,338280,25
Jensen_Eisai_groupB,2,5,ts-global_detected_seizures,338311,338336,25
Jensen_Eisai_groupB,2,5,ts-global_detected_seizures,338356,338384,28
Jensen_Eisai_groupB,2,5,ts-global_detected_seizures,338450,338497,47
Jensen_Eisai_groupB,2,5,ts-global_detected_seizures,338522,338595,73
Jensen_Eisai_groupB,2,5,ts-global_detected_seizures,338596,338642,46
Jensen_Eisai_groupB,2,5,ts-global_detected_seizures,338646,338677,31
Jensen_Eisai_groupB,2,5,ts-global_detected_seizures,338696,338819,123
Jensen_Eisai_groupB,2,5,ts-global_detected_seizures,338860,338882,22
Jensen_Eisai_groupB,2,5,ts-global_detected_seizures,338955,338991,36
Jensen_Eisai_groupB,2,5,ts-global_detected_seizures,339024,339113,89
Jensen_Eisai_groupB,2,5,ts-global_detected_seizures,339171,339228,57
Jensen_Eisai_groupB,2,5,ts-global_detected_seizures,339279,339311,32
Jensen_Eisai_groupB,2,5,ts-global_detected_seizures,339362,339387,25
Jensen_Eisai_groupB,2,5,ts-global_detected_seizures,339388,339411,23
Jensen_Eisai_groupB,2,5,ts-global_detected_seizures,339412,339435,23
Jensen_Eisai_groupB,2,5,ts-global_detected_seizures,339436,339471,35
Jensen_Eisai_groupB,2,5,ts-global_detected_seizures,339485,339508,23
Jensen_Eisai_groupB,2,5,ts-global_detected_seizures,339613,339640,27
Jensen_Eisai_groupB,2,5,ts-global_detected_seizures,339761,339786,25
Jensen_Eisai_groupB,2,5,ts-global_detected_seizures,339851,339880,29
Jensen_Eisai_groupB,2,5,ts-global_detected_seizures,339899,339939,40
Jensen_Eisai_groupB,2,5,ts-global_detected_seizures,339981,340005,24
Jensen_Eisai_groupB,2,5,ts-global_detected_seizures,340037,340082,45
Jensen_Eisai_groupB,2,5,ts-global_detected_seizures,340136,340175,39
Jensen_Eisai_groupB,2,5,ts-global_detected_seizures,340264,340287,23
Jensen_Eisai_groupB,2,5,ts-global_detected_seizures,340288,340401,113
Jensen_Eisai_groupB,2,5,ts-global_detected_seizures,340403,340429,26
Jensen_Eisai_groupB,2,5,ts-global_detected_seizures,340442,340489,47
Jensen_Eisai_groupB,2,5,ts-global_detected_seizures,340493,340516,23
Jensen_Eisai_groupB,2,5,ts-global_detected_seizures,340541,340567,26
Jensen_Eisai_groupB,2,5,ts-global_detected_seizures,340608,341191,583
Jensen_Eisai_groupB,1,4,ts-global_detected_seizures,340710,342551,1841
Jensen_Eisai_groupB,2,5,ts-global_detected_seizures,341192,342602,1410
Jensen_Eisai_groupB,1,4,ts-global_detected_seizures,342552,342577,25
Jensen_Eisai_groupB,1,4,ts-global_detected_seizures,342585,343181,596
Jensen_Eisai_groupB,2,5,ts-global_detected_seizures,342627,342670,43
Jensen_Eisai_groupB,2,5,ts-global_detected_seizures,342701,342726,25
Jensen_Eisai_groupB,2,5,ts-global_detected_seizures,342812,342855,43
Jensen_Eisai_groupB,2,5,ts-global_detected_seizures,342890,342921,31
Jensen_Eisai_groupB,2,5,ts-global_detected_seizures,342923,345586,2663
Jensen_Eisai_groupB,1,4,ts-global_detected_seizures,343267,343297,30
Jensen_Eisai_groupB,1,4,ts-global_detected_seizures,343380,343402,22
Jensen_Eisai_groupB,1,4,ts-global_detected_seizures,343484,343527,43
Jensen_Eisai_groupB,1,4,ts-global_detected_seizures,343722,343755,33
Jensen_Eisai_groupB,1,4,ts-global_detected_seizures,343853,343929,76
Jensen_Eisai_groupB,1,4,ts-global_detected_seizures,343931,343954,23
Jensen_Eisai_groupB,1,4,ts-global_detected_seizures,343956,343979,23
Jensen_Eisai_groupB,1,4,ts-global_detected_seizures,344234,344264,30
Jensen_Eisai_groupB,1,4,ts-global_detected_seizures,344285,344312,27
Jensen_Eisai_groupB,1,4,ts-global_detected_seizures,344365,344453,88
Jensen_Eisai_groupB,1,4,ts-global_detected_seizures,344486,344516,30
Jensen_Eisai_groupB,1,4,ts-global_detected_seizures,344517,344551,34
Jensen_Eisai_groupB,1,4,ts-global_detected_seizures,344637,344672,35
Jensen_Eisai_groupB,1,4,ts-global_detected_seizures,344709,344736,27
Jensen_Eisai_groupB,1,4,ts-global_detected_seizures,344737,344760,23
Jensen_Eisai_groupB,1,4,ts-global_detected_seizures,344779,344879,100
Jensen_Eisai_groupB,1,4,ts-global_detected_seizures,344881,345315,434
Jensen_Eisai_groupB,1,4,ts-global_detected_seizures,345316,345586,270
Jensen_Eisai_groupB,3,6,ts-global_detected_seizures,345968,346938,970
Jensen_Eisai_groupB,2,5,ts-global_detected_seizures,346303,346442,139
Jensen_Eisai_groupB,1,4,ts-global_detected_seizures,346396,346458,62
Jensen_Eisai_groupB,2,5,ts-global_detected_seizures,346443,346497,54
Jensen_Eisai_groupB,1,4,ts-global_detected_seizures,346459,346998,539
Jensen_Eisai_groupB,1,4,ts-global_detected_seizures,346459,346998,539
Jensen_Eisai_groupB,2,5,ts-global_detected_seizures,346499,346522,23
Jensen_Eisai_groupB,2,5,ts-global_detected_seizures,346523,346558,35
Jensen_Eisai_groupB,2,5,ts-global_detected_seizures,346559,346671,112
Jensen_Eisai_groupB,2,5,ts-global_detected_seizures,346672,346870,198
Jensen_Eisai_groupB,2,5,ts-global_detected_seizures,346881,346914,33
Jensen_Eisai_groupB,2,5,ts-global_detected_seizures,346915,346938,23
Jensen_Eisai_groupB,3,6,ts-global_detected_seizures,346939,364707,17768
Jensen_Eisai_groupB,2,5,ts-global_detected_seizures,346983,347019,36
Jensen_Eisai_groupB,1,4,ts-global_detected_seizures,346999,347116,117
Jensen_Eisai_groupB,2,5,ts-global_detected_seizures,347020,347105,85
Jensen_Eisai_groupB,2,5,ts-global_detected_seizures,347121,347144,23
Jensen_Eisai_groupB,1,4,ts-global_detected_seizures,347129,347399,270
Jensen_Eisai_groupB,2,5,ts-global_detected_seizures,347163,347195,32
Jensen_Eisai_groupB,2,5,ts-global_detected_seizures,347208,347289,81
Jensen_Eisai_groupB,2,5,ts-global_detected_seizures,347290,347334,44
Jensen_Eisai_groupB,2,5,ts-global_detected_seizures,347335,347362,27
Jensen_Eisai_groupB,2,5,ts-global_detected_seizures,347364,347388,24
Jensen_Eisai_groupB,1,4,ts-global_detected_seizures,347401,347664,263
Jensen_Eisai_groupB,2,5,ts-global_detected_seizures,347405,347432,27
Jensen_Eisai_groupB,2,5,ts-global_detected_seizures,347433,347483,50
Jensen_Eisai_groupB,2,5,ts-global_detected_seizures,347488,347510,22
Jensen_Eisai_groupB,2,5,ts-global_detected_seizures,347532,347664,132
Jensen_Eisai_groupB,1,4,ts-global_detected_seizures,347665,347711,46
Jensen_Eisai_groupB,2,5,ts-global_detected_seizures,347666,347720,54
Jensen_Eisai_groupB,1,4,ts-global_detected_seizures,347712,348082,370
Jensen_Eisai_groupB,2,5,ts-global_detected_seizures,347742,347766,24
Jensen_Eisai_groupB,2,5,ts-global_detected_seizures,347768,347811,43
Jensen_Eisai_groupB,2,5,ts-global_detected_seizures,347890,347923,33
Jensen_Eisai_groupB,2,5,ts-global_detected_seizures,347938,347989,51
Jensen_Eisai_groupB,1,4,ts-global_detected_seizures,348083,348237,154
Jensen_Eisai_groupB,2,5,ts-global_detected_seizures,348224,348285,61
Jensen_Eisai_groupB,1,4,ts-global_detected_seizures,348260,348287,27
Jensen_Eisai_groupB,1,4,ts-global_detected_seizures,348288,348508,220
Jensen_Eisai_groupB,2,5,ts-global_detected_seizures,348321,348359,38
Jensen_Eisai_groupB,2,5,ts-global_detected_seizures,348388,348410,22
Jensen_Eisai_groupB,2,5,ts-global_detected_seizures,348412,348441,29
Jensen_Eisai_groupB,2,5,ts-global_detected_seizures,348467,348499,32
Jensen_Eisai_groupB,1,4,ts-global_detected_seizures,348509,348535,26
Jensen_Eisai_groupB,1,4,ts-global_detected_seizures,348536,348662,126
Jensen_Eisai_groupB,2,5,ts-global_detected_seizures,348540,348562,22
Jensen_Eisai_groupB,2,5,ts-global_detected_seizures,348580,348610,30
Jensen_Eisai_groupB,2,5,ts-global_detected_seizures,348611,348669,58
Jensen_Eisai_groupB,1,4,ts-global_detected_seizures,348663,348720,57
Jensen_Eisai_groupB,1,4,ts-global_detected_seizures,348722,348899,177
Jensen_Eisai_groupB,2,5,ts-global_detected_seizures,348727,348761,34
Jensen_Eisai_groupB,2,5,ts-global_detected_seizures,348766,348790,24
Jensen_Eisai_groupB,2,5,ts-global_detected_seizures,348801,348824,23
Jensen_Eisai_groupB,2,5,ts-global_detected_seizures,348883,348930,47
Jensen_Eisai_groupB,1,4,ts-global_detected_seizures,348905,348932,27
Jensen_Eisai_groupB,1,4,ts-global_detected_seizures,348935,349026,91
Jensen_Eisai_groupB,2,5,ts-global_detected_seizures,348939,348981,42
Jensen_Eisai_groupB,1,4,ts-global_detected_seizures,349041,349077,36
Jensen_Eisai_groupB,1,4,ts-global_detected_seizures,349078,349321,243
Jensen_Eisai_groupB,2,5,ts-global_detected_seizures,349250,349327,77
Jensen_Eisai_groupB,1,4,ts-global_detected_seizures,349322,349433,111
Jensen_Eisai_groupB,2,5,ts-global_detected_seizures,349328,349384,56
Jensen_Eisai_groupB,2,5,ts-global_detected_seizures,349424,349452,28
Jensen_Eisai_groupB,1,4,ts-global_detected_seizures,349434,349457,23
Jensen_Eisai_groupB,1,4,ts-global_detected_seizures,349458,349748,290
Jensen_Eisai_groupB,2,5,ts-global_detected_seizures,349503,349526,23
Jensen_Eisai_groupB,2,5,ts-global_detected_seizures,349736,349780,44
Jensen_Eisai_groupB,1,4,ts-global_detected_seizures,349751,349963,212
Jensen_Eisai_groupB,2,5,ts-global_detected_seizures,349781,349854,73
Jensen_Eisai_groupB,2,5,ts-global_detected_seizures,349855,349897,42
Jensen_Eisai_groupB,2,5,ts-global_detected_seizures,349922,349957,35
Jensen_Eisai_groupB,2,5,ts-global_detected_seizures,349958,350001,43
Jensen_Eisai_groupB,1,4,ts-global_detected_seizures,349964,350046,82
Jensen_Eisai_groupB,2,5,ts-global_detected_seizures,350004,350061,57
Jensen_Eisai_groupB,1,4,ts-global_detected_seizures,350056,350338,282
Jensen_Eisai_groupB,2,5,ts-global_detected_seizures,350062,350136,74
Jensen_Eisai_groupB,2,5,ts-global_detected_seizures,350137,350162,25
Jensen_Eisai_groupB,2,5,ts-global_detected_seizures,350186,350247,61
Jensen_Eisai_groupB,2,5,ts-global_detected_seizures,350248,350271,23
Jensen_Eisai_groupB,2,5,ts-global_detected_seizures,350277,350386,109
Jensen_Eisai_groupB,2,5,ts-global_detected_seizures,350394,350474,80
Jensen_Eisai_groupB,1,4,ts-global_detected_seizures,350485,350632,147
Jensen_Eisai_groupB,2,5,ts-global_detected_seizures,350535,350610,75
Jensen_Eisai_groupB,2,5,ts-global_detected_seizures,350611,350640,29
Jensen_Eisai_groupB,2,5,ts-global_detected_seizures,350641,350740,99
Jensen_Eisai_groupB,1,4,ts-global_detected_seizures,350703,350796,93
Jensen_Eisai_groupB,2,5,ts-global_detected_seizures,350741,350789,48
Jensen_Eisai_groupB,2,5,ts-global_detected_seizures,350901,350939,38
Jensen_Eisai_groupB,1,4,ts-global_detected_seizures,350958,350986,28
Jensen_Eisai_groupB,1,4,ts-global_detected_seizures,351126,351148,22
Jensen_Eisai_groupB,2,5,ts-global_detected_seizures,351206,351233,27
Jensen_Eisai_groupB,1,4,ts-global_detected_seizures,351238,351260,22
Jensen_Eisai_groupB,2,5,ts-global_detected_seizures,351289,351335,46
Jensen_Eisai_groupB,2,5,ts-global_detected_seizures,351336,351368,32
Jensen_Eisai_groupB,2,5,ts-global_detected_seizures,351369,351397,28
Jensen_Eisai_groupB,1,4,ts-global_detected_seizures,351429,351451,22
Jensen_Eisai_groupB,1,4,ts-global_detected_seizures,351509,351568,59
Jensen_Eisai_groupB,1,4,ts-global_detected_seizures,351594,351624,30
Jensen_Eisai_groupB,1,4,ts-global_detected_seizures,351635,351670,35
Jensen_Eisai_groupB,2,5,ts-global_detected_seizures,351643,351665,22
Jensen_Eisai_groupB,1,4,ts-global_detected_seizures,351775,351803,28
Jensen_Eisai_groupB,2,5,ts-global_detected_seizures,351845,352089,244
Jensen_Eisai_groupB,1,4,ts-global_detected_seizures,351863,351891,28
Jensen_Eisai_groupB,1,4,ts-global_detected_seizures,351999,352022,23
Jensen_Eisai_groupB,2,5,ts-global_detected_seizures,352090,352151,61
Jensen_Eisai_groupB,1,4,ts-global_detected_seizures,352131,352167,36
Jensen_Eisai_groupB,2,5,ts-global_detected_seizures,352152,352300,148
Jensen_Eisai_groupB,1,4,ts-global_detected_seizures,352168,352209,41
Jensen_Eisai_groupB,1,4,ts-global_detected_seizures,352263,352296,33
Jensen_Eisai_groupB,2,5,ts-global_detected_seizures,352301,352931,630
Jensen_Eisai_groupB,1,4,ts-global_detected_seizures,352349,352382,33
Jensen_Eisai_groupB,1,4,ts-global_detected_seizures,352494,352519,25
Jensen_Eisai_groupB,1,4,ts-global_detected_seizures,352567,352628,61
Jensen_Eisai_groupB,1,4,ts-global_detected_seizures,352638,352664,26
Jensen_Eisai_groupB,1,4,ts-global_detected_seizures,352714,352761,47
Jensen_Eisai_groupB,1,4,ts-global_detected_seizures,352886,352924,38
Jensen_Eisai_groupB,1,4,ts-global_detected_seizures,352925,352961,36
Jensen_Eisai_groupB,2,5,ts-global_detected_seizures,352932,353004,72
Jensen_Eisai_groupB,2,5,ts-global_detected_seizures,353005,353191,186
Jensen_Eisai_groupB,1,4,ts-global_detected_seizures,353071,353114,43
Jensen_Eisai_groupB,1,4,ts-global_detected_seizures,353116,353138,22
Jensen_Eisai_groupB,1,4,ts-global_detected_seizures,353175,353221,46
Jensen_Eisai_groupB,2,5,ts-global_detected_seizures,353192,353316,124
Jensen_Eisai_groupB,1,4,ts-global_detected_seizures,353227,353253,26
Jensen_Eisai_groupB,1,4,ts-global_detected_seizures,353259,353322,63
Jensen_Eisai_groupB,2,5,ts-global_detected_seizures,353317,353347,30
Jensen_Eisai_groupB,2,5,ts-global_detected_seizures,353348,353493,145
Jensen_Eisai_groupB,1,4,ts-global_detected_seizures,353373,353399,26
Jensen_Eisai_groupB,1,4,ts-global_detected_seizures,353451,353488,37
Jensen_Eisai_groupB,1,4,ts-global_detected_seizures,353489,353512,23
Jensen_Eisai_groupB,2,5,ts-global_detected_seizures,353494,353931,437
Jensen_Eisai_groupB,1,4,ts-global_detected_seizures,353584,353618,34
Jensen_Eisai_groupB,1,4,ts-global_detected_seizures,353625,353679,54
Jensen_Eisai_groupB,1,4,ts-global_detected_seizures,353693,353718,25
Jensen_Eisai_groupB,1,4,ts-global_detected_seizures,353737,353767,30
Jensen_Eisai_groupB,1,4,ts-global_detected_seizures,353822,353953,131
Jensen_Eisai_groupB,2,5,ts-global_detected_seizures,353933,354502,569
Jensen_Eisai_groupB,1,4,ts-global_detected_seizures,353954,353976,22
Jensen_Eisai_groupB,1,4,ts-global_detected_seizures,353978,354002,24
Jensen_Eisai_groupB,1,4,ts-global_detected_seizures,354003,354029,26
Jensen_Eisai_groupB,1,4,ts-global_detected_seizures,354035,354074,39
Jensen_Eisai_groupB,1,4,ts-global_detected_seizures,354092,354173,81
Jensen_Eisai_groupB,1,4,ts-global_detected_seizures,354186,354237,51
Jensen_Eisai_groupB,1,4,ts-global_detected_seizures,354282,354342,60
Jensen_Eisai_groupB,1,4,ts-global_detected_seizures,354350,354392,42
Jensen_Eisai_groupB,1,4,ts-global_detected_seizures,354394,354431,37
Jensen_Eisai_groupB,1,4,ts-global_detected_seizures,354442,354529,87
Jensen_Eisai_groupB,2,5,ts-global_detected_seizures,354503,354535,32
Jensen_Eisai_groupB,1,4,ts-global_detected_seizures,354532,354882,350
Jensen_Eisai_groupB,2,5,ts-global_detected_seizures,354578,354965,387
Jensen_Eisai_groupB,1,4,ts-global_detected_seizures,354884,354977,93
Jensen_Eisai_groupB,2,5,ts-global_detected_seizures,354974,355207,233
Jensen_Eisai_groupB,1,4,ts-global_detected_seizures,355015,355122,107
Jensen_Eisai_groupB,1,4,ts-global_detected_seizures,355123,355716,593
Jensen_Eisai_groupB,2,5,ts-global_detected_seizures,355383,355416,33
Jensen_Eisai_groupB,2,5,ts-global_detected_seizures,355593,355624,31
Jensen_Eisai_groupB,2,5,ts-global_detected_seizures,355647,355674,27
Jensen_Eisai_groupB,1,4,ts-global_detected_seizures,355717,355751,34
Jensen_Eisai_groupB,1,4,ts-global_detected_seizures,355752,356102,350
Jensen_Eisai_groupB,2,5,ts-global_detected_seizures,355764,355790,26
Jensen_Eisai_groupB,2,5,ts-global_detected_seizures,355869,355895,26
Jensen_Eisai_groupB,2,5,ts-global_detected_seizures,355983,356023,40
Jensen_Eisai_groupB,1,4,ts-global_detected_seizures,356123,356163,40
Jensen_Eisai_groupB,1,4,ts-global_detected_seizures,356165,356191,26
Jensen_Eisai_groupB,2,5,ts-global_detected_seizures,356187,356217,30
Jensen_Eisai_groupB,1,4,ts-global_detected_seizures,356226,356275,49
Jensen_Eisai_groupB,1,4,ts-global_detected_seizures,356276,356302,26
Jensen_Eisai_groupB,2,5,ts-global_detected_seizures,356291,356318,27
Jensen_Eisai_groupB,1,4,ts-global_detected_seizures,356319,356574,255
Jensen_Eisai_groupB,2,5,ts-global_detected_seizures,356417,356463,46
Jensen_Eisai_groupB,2,5,ts-global_detected_seizures,356479,356512,33
Jensen_Eisai_groupB,2,5,ts-global_detected_seizures,356570,356596,26
Jensen_Eisai_groupB,1,4,ts-global_detected_seizures,356594,356628,34
Jensen_Eisai_groupB,2,5,ts-global_detected_seizures,356671,356696,25
Jensen_Eisai_groupB,1,4,ts-global_detected_seizures,356726,356753,27
Jensen_Eisai_groupB,2,5,ts-global_detected_seizures,356737,356763,26
Jensen_Eisai_groupB,1,4,ts-global_detected_seizures,356812,356835,23
Jensen_Eisai_groupB,2,5,ts-global_detected_seizures,356834,356885,51
Jensen_Eisai_groupB,1,4,ts-global_detected_seizures,356878,356901,23
Jensen_Eisai_groupB,2,5,ts-global_detected_seizures,356886,356909,23
Jensen_Eisai_groupB,1,4,ts-global_detected_seizures,356981,357023,42
Jensen_Eisai_groupB,1,4,ts-global_detected_seizures,357032,357058,26
Jensen_Eisai_groupB,2,5,ts-global_detected_seizures,357043,357165,122
Jensen_Eisai_groupB,1,4,ts-global_detected_seizures,357121,357149,28
Jensen_Eisai_groupB,2,5,ts-global_detected_seizures,357166,357191,25
Jensen_Eisai_groupB,1,4,ts-global_detected_seizures,357188,357223,35
Jensen_Eisai_groupB,2,5,ts-global_detected_seizures,357248,357293,45
Jensen_Eisai_groupB,1,4,ts-global_detected_seizures,357255,357291,36
Jensen_Eisai_groupB,1,4,ts-global_detected_seizures,357312,357340,28
Jensen_Eisai_groupB,2,5,ts-global_detected_seizures,357351,357379,28
Jensen_Eisai_groupB,2,5,ts-global_detected_seizures,357382,357498,116
Jensen_Eisai_groupB,1,4,ts-global_detected_seizures,357406,357428,22
Jensen_Eisai_groupB,1,4,ts-global_detected_seizures,357489,358548,1059
Jensen_Eisai_groupB,1,4,ts-global_detected_seizures,358555,358587,32
Jensen_Eisai_groupB,2,5,ts-global_detected_seizures,358557,358591,34
Jensen_Eisai_groupB,1,4,ts-global_detected_seizures,358588,358622,34
Jensen_Eisai_groupB,2,5,ts-global_detected_seizures,358644,358667,23
Jensen_Eisai_groupB,1,4,ts-global_detected_seizures,358653,358677,24
Jensen_Eisai_groupB,1,4,ts-global_detected_seizures,358745,358775,30
Jensen_Eisai_groupB,2,5,ts-global_detected_seizures,358762,358792,30
Jensen_Eisai_groupB,2,5,ts-global_detected_seizures,358815,358838,23
Jensen_Eisai_groupB,1,4,ts-global_detected_seizures,358838,358877,39
Jensen_Eisai_groupB,2,5,ts-global_detected_seizures,358883,358914,31
Jensen_Eisai_groupB,2,5,ts-global_detected_seizures,358945,359000,55
Jensen_Eisai_groupB,1,4,ts-global_detected_seizures,359006,359033,27
Jensen_Eisai_groupB,2,5,ts-global_detected_seizures,359017,359076,59
Jensen_Eisai_groupB,1,4,ts-global_detected_seizures,359069,359103,34
Jensen_Eisai_groupB,1,4,ts-global_detected_seizures,359109,359135,26
Jensen_Eisai_groupB,2,5,ts-global_detected_seizures,359127,359170,43
Jensen_Eisai_groupB,2,5,ts-global_detected_seizures,359186,359339,153
Jensen_Eisai_groupB,1,4,ts-global_detected_seizures,359206,359311,105
Jensen_Eisai_groupB,1,4,ts-global_detected_seizures,359319,359350,31
Jensen_Eisai_groupB,2,5,ts-global_detected_seizures,359367,359391,24
Jensen_Eisai_groupB,2,5,ts-global_detected_seizures,359392,359422,30
Jensen_Eisai_groupB,1,4,ts-global_detected_seizures,359393,359442,49
Jensen_Eisai_groupB,2,5,ts-global_detected_seizures,359423,359874,451
Jensen_Eisai_groupB,1,4,ts-global_detected_seizures,359476,359532,56
Jensen_Eisai_groupB,1,4,ts-global_detected_seizures,359572,359601,29
Jensen_Eisai_groupB,1,4,ts-global_detected_seizures,359605,359641,36
Jensen_Eisai_groupB,1,4,ts-global_detected_seizures,359686,359709,23
Jensen_Eisai_groupB,1,4,ts-global_detected_seizures,359856,359983,127
Jensen_Eisai_groupB,2,5,ts-global_detected_seizures,359875,359898,23
Jensen_Eisai_groupB,2,5,ts-global_detected_seizures,359900,359960,60
Jensen_Eisai_groupB,2,5,ts-global_detected_seizures,359967,359991,24
Jensen_Eisai_groupB,2,5,ts-global_detected_seizures,359997,360020,23
Jensen_Eisai_groupB,1,4,ts-global_detected_seizures,360025,360076,51
Jensen_Eisai_groupB,2,5,ts-global_detected_seizures,360050,360073,23
Jensen_Eisai_groupB,1,4,ts-global_detected_seizures,360090,360117,27
Jensen_Eisai_groupB,2,5,ts-global_detected_seizures,360094,360123,29
Jensen_Eisai_groupB,1,4,ts-global_detected_seizures,360131,360173,42
Jensen_Eisai_groupB,2,5,ts-global_detected_seizures,360192,360229,37
Jensen_Eisai_groupB,1,4,ts-global_detected_seizures,360201,360264,63
Jensen_Eisai_groupB,1,4,ts-global_detected_seizures,360325,360390,65
Jensen_Eisai_groupB,1,4,ts-global_detected_seizures,360412,360452,40
Jensen_Eisai_groupB,1,4,ts-global_detected_seizures,360458,360518,60
Jensen_Eisai_groupB,2,5,ts-global_detected_seizures,360482,360507,25
Jensen_Eisai_groupB,2,5,ts-global_detected_seizures,360532,360557,25
Jensen_Eisai_groupB,1,4,ts-global_detected_seizures,360570,360596,26
Jensen_Eisai_groupB,2,5,ts-global_detected_seizures,360598,360625,27
Jensen_Eisai_groupB,1,4,ts-global_detected_seizures,360616,360647,31
Jensen_Eisai_groupB,1,4,ts-global_detected_seizures,360651,360674,23
Jensen_Eisai_groupB,1,4,ts-global_detected_seizures,360675,360698,23
Jensen_Eisai_groupB,2,5,ts-global_detected_seizures,360727,360762,35
Jensen_Eisai_groupB,1,4,ts-global_detected_seizures,360766,360788,22
Jensen_Eisai_groupB,2,5,ts-global_detected_seizures,360787,360834,47
Jensen_Eisai_groupB,1,4,ts-global_detected_seizures,360808,360838,30
Jensen_Eisai_groupB,1,4,ts-global_detected_seizures,360892,360970,78
Jensen_Eisai_groupB,2,5,ts-global_detected_seizures,360936,360958,22
Jensen_Eisai_groupB,1,4,ts-global_detected_seizures,360971,361002,31
Jensen_Eisai_groupB,1,4,ts-global_detected_seizures,361028,361054,26
Jensen_Eisai_groupB,2,5,ts-global_detected_seizures,361039,361149,110
Jensen_Eisai_groupB,1,4,ts-global_detected_seizures,361068,361095,27
Jensen_Eisai_groupB,1,4,ts-global_detected_seizures,361125,361171,46
Jensen_Eisai_groupB,1,4,ts-global_detected_seizures,361269,361423,154
Jensen_Eisai_groupB,2,5,ts-global_detected_seizures,361304,361354,50
Jensen_Eisai_groupB,2,5,ts-global_detected_seizures,361381,361407,26
Jensen_Eisai_groupB,1,4,ts-global_detected_seizures,361424,361482,58
Jensen_Eisai_groupB,2,5,ts-global_detected_seizures,361444,361487,43
Jensen_Eisai_groupB,1,4,ts-global_detected_seizures,361499,361532,33
Jensen_Eisai_groupB,1,4,ts-global_detected_seizures,361534,361560,26
Jensen_Eisai_groupB,1,4,ts-global_detected_seizures,361561,361597,36
Jensen_Eisai_groupB,1,4,ts-global_detected_seizures,361608,361658,50
Jensen_Eisai_groupB,1,4,ts-global_detected_seizures,361683,361730,47
Jensen_Eisai_groupB,2,5,ts-global_detected_seizures,361711,361745,34
Jensen_Eisai_groupB,2,5,ts-global_detected_seizures,361749,361853,104
Jensen_Eisai_groupB,1,4,ts-global_detected_seizures,361763,361845,82
Jensen_Eisai_groupB,1,4,ts-global_detected_seizures,361846,361896,50
Jensen_Eisai_groupB,2,5,ts-global_detected_seizures,361882,361905,23
Jensen_Eisai_groupB,1,4,ts-global_detected_seizures,361897,361923,26
Jensen_Eisai_groupB,1,4,ts-global_detected_seizures,361956,362024,68
Jensen_Eisai_groupB,2,5,ts-global_detected_seizures,362015,362037,22
Jensen_Eisai_groupB,2,5,ts-global_detected_seizures,362056,362082,26
Jensen_Eisai_groupB,1,4,ts-global_detected_seizures,362058,362086,28
Jensen_Eisai_groupB,1,4,ts-global_detected_seizures,362153,362307,154
Jensen_Eisai_groupB,2,5,ts-global_detected_seizures,362181,362205,24
Jensen_Eisai_groupB,2,5,ts-global_detected_seizures,362212,362302,90
Jensen_Eisai_groupB,2,5,ts-global_detected_seizures,362307,362331,24
Jensen_Eisai_groupB,1,4,ts-global_detected_seizures,362326,362368,42
Jensen_Eisai_groupB,2,5,ts-global_detected_seizures,362346,362372,26
Jensen_Eisai_groupB,1,4,ts-global_detected_seizures,362376,362436,60
Jensen_Eisai_groupB,2,5,ts-global_detected_seizures,362457,362491,34
Jensen_Eisai_groupB,1,4,ts-global_detected_seizures,362470,362510,40
Jensen_Eisai_groupB,1,4,ts-global_detected_seizures,362512,362644,132
Jensen_Eisai_groupB,2,5,ts-global_detected_seizures,362536,362564,28
Jensen_Eisai_groupB,2,5,ts-global_detected_seizures,362575,362601,26
Jensen_Eisai_groupB,2,5,ts-global_detected_seizures,362630,362673,43
Jensen_Eisai_groupB,1,4,ts-global_detected_seizures,362645,362689,44
Jensen_Eisai_groupB,1,4,ts-global_detected_seizures,362701,363971,1270
Jensen_Eisai_groupB,2,5,ts-global_detected_seizures,362702,362831,129
Jensen_Eisai_groupB,2,5,ts-global_detected_seizures,362835,362857,22
Jensen_Eisai_groupB,2,5,ts-global_detected_seizures,362862,362938,76
Jensen_Eisai_groupB,2,5,ts-global_detected_seizures,362981,363023,42
Jensen_Eisai_groupB,2,5,ts-global_detected_seizures,363061,363086,25
Jensen_Eisai_groupB,2,5,ts-global_detected_seizures,363214,363239,25
Jensen_Eisai_groupB,2,5,ts-global_detected_seizures,363244,363271,27
Jensen_Eisai_groupB,2,5,ts-global_detected_seizures,363312,363343,31
Jensen_Eisai_groupB,2,5,ts-global_detected_seizures,363403,363431,28
Jensen_Eisai_groupB,2,5,ts-global_detected_seizures,363616,363786,170
Jensen_Eisai_groupB,2,5,ts-global_detected_seizures,363886,364531,645
Jensen_Eisai_groupB,1,4,ts-global_detected_seizures,363972,364774,802
Jensen_Eisai_groupB,2,5,ts-global_detected_seizures,364532,364960,428
Jensen_Eisai_groupB,3,6,ts-global_detected_seizures,364708,387605,22897
Jensen_Eisai_groupB,1,4,ts-global_detected_seizures,364775,364798,23
Jensen_Eisai_groupB,1,4,ts-global_detected_seizures,364853,364880,27
Jensen_Eisai_groupB,1,4,ts-global_detected_seizures,364888,364944,56
Jensen_Eisai_groupB,1,4,ts-global_detected_seizures,364948,364977,29
Jensen_Eisai_groupB,2,5,ts-global_detected_seizures,364962,365526,564
Jensen_Eisai_groupB,1,4,ts-global_detected_seizures,364982,365010,28
Jensen_Eisai_groupB,1,4,ts-global_detected_seizures,365026,365048,22
Jensen_Eisai_groupB,1,4,ts-global_detected_seizures,365057,365351,294
Jensen_Eisai_groupB,2,5,ts-global_detected_seizures,365534,365597,63
Jensen_Eisai_groupB,2,5,ts-global_detected_seizures,365598,365620,22
Jensen_Eisai_groupB,2,5,ts-global_detected_seizures,365666,365688,22
Jensen_Eisai_groupB,1,4,ts-global_detected_seizures,365696,365720,24
Jensen_Eisai_groupB,1,4,ts-global_detected_seizures,365727,365764,37
Jensen_Eisai_groupB,2,5,ts-global_detected_seizures,365731,365753,22
Jensen_Eisai_groupB,1,4,ts-global_detected_seizures,365770,365793,23
Jensen_Eisai_groupB,1,4,ts-global_detected_seizures,365810,365852,42
Jensen_Eisai_groupB,2,5,ts-global_detected_seizures,365827,365853,26
Jensen_Eisai_groupB,2,5,ts-global_detected_seizures,365877,365901,24
Jensen_Eisai_groupB,1,4,ts-global_detected_seizures,365898,365930,32
Jensen_Eisai_groupB,1,4,ts-global_detected_seizures,365945,366086,141
Jensen_Eisai_groupB,2,5,ts-global_detected_seizures,365976,366004,28
Jensen_Eisai_groupB,2,5,ts-global_detected_seizures,366025,366047,22
Jensen_Eisai_groupB,1,4,ts-global_detected_seizures,366087,366113,26
Jensen_Eisai_groupB,1,4,ts-global_detected_seizures,366129,366201,72
Jensen_Eisai_groupB,2,5,ts-global_detected_seizures,366170,366202,32
Jensen_Eisai_groupB,2,5,ts-global_detected_seizures,366210,366238,28
Jensen_Eisai_groupB,1,4,ts-global_detected_seizures,366234,366296,62
Jensen_Eisai_groupB,1,4,ts-global_detected_seizures,366297,366389,92
Jensen_Eisai_groupB,2,5,ts-global_detected_seizures,366345,366369,24
Jensen_Eisai_groupB,1,4,ts-global_detected_seizures,366390,366470,80
Jensen_Eisai_groupB,2,5,ts-global_detected_seizures,366440,366462,22
Jensen_Eisai_groupB,2,5,ts-global_detected_seizures,366463,366552,89
Jensen_Eisai_groupB,1,4,ts-global_detected_seizures,366492,366551,59
Jensen_Eisai_groupB,1,4,ts-global_detected_seizures,366575,366633,58
Jensen_Eisai_groupB,1,4,ts-global_detected_seizures,366652,366722,70
Jensen_Eisai_groupB,2,5,ts-global_detected_seizures,366679,366725,46
Jensen_Eisai_groupB,1,4,ts-global_detected_seizures,366729,366778,49
Jensen_Eisai_groupB,2,5,ts-global_detected_seizures,366758,366837,79
Jensen_Eisai_groupB,2,5,ts-global_detected_seizures,366838,366915,77
Jensen_Eisai_groupB,1,4,ts-global_detected_seizures,366859,366888,29
Jensen_Eisai_groupB,2,5,ts-global_detected_seizures,366923,366949,26
Jensen_Eisai_groupB,2,5,ts-global_detected_seizures,366956,366978,22
Jensen_Eisai_groupB,1,4,ts-global_detected_seizures,366972,367067,95
Jensen_Eisai_groupB,1,4,ts-global_detected_seizures,367068,367099,31
Jensen_Eisai_groupB,2,5,ts-global_detected_seizures,367108,367133,25
Jensen_Eisai_groupB,1,4,ts-global_detected_seizures,367111,367162,51
Jensen_Eisai_groupB,1,4,ts-global_detected_seizures,367198,367231,33
Jensen_Eisai_groupB,2,5,ts-global_detected_seizures,367201,367233,32
Jensen_Eisai_groupB,2,5,ts-global_detected_seizures,367246,367269,23
Jensen_Eisai_groupB,1,4,ts-global_detected_seizures,367263,367301,38
Jensen_Eisai_groupB,1,4,ts-global_detected_seizures,367312,367362,50
Jensen_Eisai_groupB,2,5,ts-global_detected_seizures,367347,367377,30
Jensen_Eisai_groupB,1,4,ts-global_detected_seizures,367370,367453,83
Jensen_Eisai_groupB,2,5,ts-global_detected_seizures,367410,367452,42
Jensen_Eisai_groupB,1,4,ts-global_detected_seizures,367454,367562,108
Jensen_Eisai_groupB,2,5,ts-global_detected_seizures,367496,367527,31
Jensen_Eisai_groupB,1,4,ts-global_detected_seizures,367563,367636,73
Jensen_Eisai_groupB,2,5,ts-global_detected_seizures,367609,367639,30
Jensen_Eisai_groupB,1,4,ts-global_detected_seizures,367637,367703,66
Jensen_Eisai_groupB,2,5,ts-global_detected_seizures,367660,367705,45
Jensen_Eisai_groupB,1,4,ts-global_detected_seizures,367704,367751,47
Jensen_Eisai_groupB,2,5,ts-global_detected_seizures,367745,367768,23
Jensen_Eisai_groupB,1,4,ts-global_detected_seizures,367769,367839,70
Jensen_Eisai_groupB,1,4,ts-global_detected_seizures,367840,367936,96
Jensen_Eisai_groupB,2,5,ts-global_detected_seizures,367868,367923,55
Jensen_Eisai_groupB,2,5,ts-global_detected_seizures,367988,368259,271
Jensen_Eisai_groupB,1,4,ts-global_detected_seizures,367998,368033,35
Jensen_Eisai_groupB,1,4,ts-global_detected_seizures,368034,368076,42
Jensen_Eisai_groupB,1,4,ts-global_detected_seizures,368124,368199,75
Jensen_Eisai_groupB,1,4,ts-global_detected_seizures,368203,368293,90
Jensen_Eisai_groupB,2,5,ts-global_detected_seizures,368260,368291,31
Jensen_Eisai_groupB,2,5,ts-global_detected_seizures,368306,368366,60
Jensen_Eisai_groupB,1,4,ts-global_detected_seizures,368309,368335,26
Jensen_Eisai_groupB,1,4,ts-global_detected_seizures,368336,368372,36
Jensen_Eisai_groupB,1,4,ts-global_detected_seizures,368378,368404,26
Jensen_Eisai_groupB,2,5,ts-global_detected_seizures,368420,368456,36
Jensen_Eisai_groupB,2,5,ts-global_detected_seizures,368457,368479,22
Jensen_Eisai_groupB,1,4,ts-global_detected_seizures,368466,368520,54
Jensen_Eisai_groupB,1,4,ts-global_detected_seizures,368530,368714,184
Jensen_Eisai_groupB,2,5,ts-global_detected_seizures,368576,368602,26
Jensen_Eisai_groupB,2,5,ts-global_detected_seizures,368674,368707,33
Jensen_Eisai_groupB,1,4,ts-global_detected_seizures,368715,368739,24
Jensen_Eisai_groupB,2,5,ts-global_detected_seizures,368731,368775,44
Jensen_Eisai_groupB,1,4,ts-global_detected_seizures,368762,368796,34
Jensen_Eisai_groupB,2,5,ts-global_detected_seizures,368829,368865,36
Jensen_Eisai_groupB,1,4,ts-global_detected_seizures,368833,368915,82
Jensen_Eisai_groupB,2,5,ts-global_detected_seizures,368892,368922,30
Jensen_Eisai_groupB,1,4,ts-global_detected_seizures,368916,368943,27
Jensen_Eisai_groupB,2,5,ts-global_detected_seizures,368924,368949,25
Jensen_Eisai_groupB,1,4,ts-global_detected_seizures,368952,368986,34
Jensen_Eisai_groupB,2,5,ts-global_detected_seizures,368961,368990,29
Jensen_Eisai_groupB,1,4,ts-global_detected_seizures,368988,369043,55
Jensen_Eisai_groupB,2,5,ts-global_detected_seizures,369034,369062,28
Jensen_Eisai_groupB,2,5,ts-global_detected_seizures,369070,369145,75
Jensen_Eisai_groupB,2,5,ts-global_detected_seizures,369147,369178,31
Jensen_Eisai_groupB,1,4,ts-global_detected_seizures,369149,369192,43
Jensen_Eisai_groupB,2,5,ts-global_detected_seizures,369190,369223,33
Jensen_Eisai_groupB,1,4,ts-global_detected_seizures,369193,369218,25
Jensen_Eisai_groupB,2,5,ts-global_detected_seizures,369244,369271,27
Jensen_Eisai_groupB,1,4,ts-global_detected_seizures,369246,369269,23
Jensen_Eisai_groupB,1,4,ts-global_detected_seizures,369281,369331,50
Jensen_Eisai_groupB,2,5,ts-global_detected_seizures,369373,369396,23
Jensen_Eisai_groupB,1,4,ts-global_detected_seizures,369391,369452,61
Jensen_Eisai_groupB,2,5,ts-global_detected_seizures,369412,369449,37
Jensen_Eisai_groupB,1,4,ts-global_detected_seizures,369458,369489,31
Jensen_Eisai_groupB,2,5,ts-global_detected_seizures,369472,369522,50
Jensen_Eisai_groupB,1,4,ts-global_detected_seizures,369607,369641,34
Jensen_Eisai_groupB,1,4,ts-global_detected_seizures,369663,369689,26
Jensen_Eisai_groupB,2,5,ts-global_detected_seizures,369668,369690,22
Jensen_Eisai_groupB,1,4,ts-global_detected_seizures,369714,369813,99
Jensen_Eisai_groupB,2,5,ts-global_detected_seizures,369733,369756,23
Jensen_Eisai_groupB,2,5,ts-global_detected_seizures,369783,369817,34
Jensen_Eisai_groupB,1,4,ts-global_detected_seizures,369814,369872,58
Jensen_Eisai_groupB,2,5,ts-global_detected_seizures,369864,369897,33
Jensen_Eisai_groupB,1,4,ts-global_detected_seizures,369873,369899,26
Jensen_Eisai_groupB,1,4,ts-global_detected_seizures,369905,369967,62
Jensen_Eisai_groupB,2,5,ts-global_detected_seizures,369934,369968,34
Jensen_Eisai_groupB,1,4,ts-global_detected_seizures,369987,370110,123
Jensen_Eisai_groupB,2,5,ts-global_detected_seizures,370008,370038,30
Jensen_Eisai_groupB,2,5,ts-global_detected_seizures,370064,370100,36
Jensen_Eisai_groupB,1,4,ts-global_detected_seizures,370111,370135,24
Jensen_Eisai_groupB,1,4,ts-global_detected_seizures,370137,370176,39
Jensen_Eisai_groupB,2,5,ts-global_detected_seizures,370142,370189,47
Jensen_Eisai_groupB,1,4,ts-global_detected_seizures,370184,370226,42
Jensen_Eisai_groupB,1,4,ts-global_detected_seizures,370257,370446,189
Jensen_Eisai_groupB,2,5,ts-global_detected_seizures,370293,370315,22
Jensen_Eisai_groupB,2,5,ts-global_detected_seizures,370349,370387,38
Jensen_Eisai_groupB,2,5,ts-global_detected_seizures,370417,370521,104
Jensen_Eisai_groupB,1,4,ts-global_detected_seizures,370490,370513,23
Jensen_Eisai_groupB,2,5,ts-global_detected_seizures,370551,370578,27
Jensen_Eisai_groupB,1,4,ts-global_detected_seizures,370554,370602,48
Jensen_Eisai_groupB,2,5,ts-global_detected_seizures,370605,370633,28
Jensen_Eisai_groupB,1,4,ts-global_detected_seizures,370622,370660,38
Jensen_Eisai_groupB,2,5,ts-global_detected_seizures,370651,370681,30
Jensen_Eisai_groupB,1,4,ts-global_detected_seizures,370674,370701,27
Jensen_Eisai_groupB,2,5,ts-global_detected_seizures,370698,370734,36
Jensen_Eisai_groupB,1,4,ts-global_detected_seizures,370725,370759,34
Jensen_Eisai_groupB,1,4,ts-global_detected_seizures,370760,370878,118
Jensen_Eisai_groupB,2,5,ts-global_detected_seizures,370766,370790,24
Jensen_Eisai_groupB,2,5,ts-global_detected_seizures,370813,370856,43
Jensen_Eisai_groupB,1,4,ts-global_detected_seizures,370879,370946,67
Jensen_Eisai_groupB,2,5,ts-global_detected_seizures,370961,370998,37
Jensen_Eisai_groupB,2,5,ts-global_detected_seizures,370999,371021,22
Jensen_Eisai_groupB,1,4,ts-global_detected_seizures,371005,371047,42
Jensen_Eisai_groupB,2,5,ts-global_detected_seizures,371044,371090,46
Jensen_Eisai_groupB,1,4,ts-global_detected_seizures,371048,371070,22
Jensen_Eisai_groupB,1,4,ts-global_detected_seizures,371112,371223,111
Jensen_Eisai_groupB,2,5,ts-global_detected_seizures,371175,371313,138
Jensen_Eisai_groupB,1,4,ts-global_detected_seizures,371229,371370,141
Jensen_Eisai_groupB,2,5,ts-global_detected_seizures,371365,371425,60
Jensen_Eisai_groupB,1,4,ts-global_detected_seizures,371371,371488,117
Jensen_Eisai_groupB,2,5,ts-global_detected_seizures,371443,371470,27
Jensen_Eisai_groupB,2,5,ts-global_detected_seizures,371487,371516,29
Jensen_Eisai_groupB,1,4,ts-global_detected_seizures,371489,371613,124
Jensen_Eisai_groupB,1,4,ts-global_detected_seizures,371614,371644,30
Jensen_Eisai_groupB,2,5,ts-global_detected_seizures,371620,371642,22
Jensen_Eisai_groupB,1,4,ts-global_detected_seizures,371647,372429,782
Jensen_Eisai_groupB,2,5,ts-global_detected_seizures,371688,371746,58
Jensen_Eisai_groupB,2,5,ts-global_detected_seizures,371799,371830,31
Jensen_Eisai_groupB,2,5,ts-global_detected_seizures,371844,371884,40
Jensen_Eisai_groupB,2,5,ts-global_detected_seizures,371896,371929,33
Jensen_Eisai_groupB,2,5,ts-global_detected_seizures,372051,372086,35
Jensen_Eisai_groupB,2,5,ts-global_detected_seizures,372147,372193,46
Jensen_Eisai_groupB,2,5,ts-global_detected_seizures,372221,372254,33
Jensen_Eisai_groupB,2,5,ts-global_detected_seizures,372258,372298,40
Jensen_Eisai_groupB,2,5,ts-global_detected_seizures,372299,372324,25
Jensen_Eisai_groupB,2,5,ts-global_detected_seizures,372371,372414,43
Jensen_Eisai_groupB,1,4,ts-global_detected_seizures,372430,373239,809
Jensen_Eisai_groupB,2,5,ts-global_detected_seizures,372433,372473,40
Jensen_Eisai_groupB,2,5,ts-global_detected_seizures,372486,372521,35
Jensen_Eisai_groupB,2,5,ts-global_detected_seizures,372568,372597,29
Jensen_Eisai_groupB,2,5,ts-global_detected_seizures,372617,372693,76
Jensen_Eisai_groupB,2,5,ts-global_detected_seizures,372714,372742,28
Jensen_Eisai_groupB,2,5,ts-global_detected_seizures,372776,372808,32
Jensen_Eisai_groupB,2,5,ts-global_detected_seizures,372825,372851,26
Jensen_Eisai_groupB,2,5,ts-global_detected_seizures,372864,372895,31
Jensen_Eisai_groupB,2,5,ts-global_detected_seizures,372940,372963,23
Jensen_Eisai_groupB,2,5,ts-global_detected_seizures,372966,373056,90
Jensen_Eisai_groupB,2,5,ts-global_detected_seizures,373082,373107,25
Jensen_Eisai_groupB,2,5,ts-global_detected_seizures,373122,373161,39
Jensen_Eisai_groupB,2,5,ts-global_detected_seizures,373196,373245,49
Jensen_Eisai_groupB,1,4,ts-global_detected_seizures,373240,373267,27
Jensen_Eisai_groupB,1,4,ts-global_detected_seizures,373268,373357,89
Jensen_Eisai_groupB,2,5,ts-global_detected_seizures,373271,373308,37
Jensen_Eisai_groupB,2,5,ts-global_detected_seizures,373333,373372,39
Jensen_Eisai_groupB,1,4,ts-global_detected_seizures,373358,373398,40
Jensen_Eisai_groupB,1,4,ts-global_detected_seizures,373420,373452,32
Jensen_Eisai_groupB,2,5,ts-global_detected_seizures,373446,373478,32
Jensen_Eisai_groupB,1,4,ts-global_detected_seizures,373462,373537,75
Jensen_Eisai_groupB,2,5,ts-global_detected_seizures,373550,373582,32
Jensen_Eisai_groupB,1,4,ts-global_detected_seizures,373561,373591,30
Jensen_Eisai_groupB,2,5,ts-global_detected_seizures,373596,373627,31
Jensen_Eisai_groupB,1,4,ts-global_detected_seizures,373627,373666,39
Jensen_Eisai_groupB,2,5,ts-global_detected_seizures,373654,373701,47
Jensen_Eisai_groupB,1,4,ts-global_detected_seizures,373711,373754,43
Jensen_Eisai_groupB,2,5,ts-global_detected_seizures,373741,373797,56
Jensen_Eisai_groupB,1,4,ts-global_detected_seizures,373808,373915,107
Jensen_Eisai_groupB,2,5,ts-global_detected_seizures,373821,373869,48
Jensen_Eisai_groupB,2,5,ts-global_detected_seizures,373892,373924,32
Jensen_Eisai_groupB,1,4,ts-global_detected_seizures,373917,374071,154
Jensen_Eisai_groupB,2,5,ts-global_detected_seizures,373938,373961,23
Jensen_Eisai_groupB,2,5,ts-global_detected_seizures,373968,373991,23
Jensen_Eisai_groupB,2,5,ts-global_detected_seizures,373992,374024,32
Jensen_Eisai_groupB,2,5,ts-global_detected_seizures,374037,374065,28
Jensen_Eisai_groupB,1,4,ts-global_detected_seizures,374095,374121,26
Jensen_Eisai_groupB,2,5,ts-global_detected_seizures,374111,374148,37
Jensen_Eisai_groupB,1,4,ts-global_detected_seizures,374168,374202,34
Jensen_Eisai_groupB,1,4,ts-global_detected_seizures,374267,374301,34
Jensen_Eisai_groupB,2,5,ts-global_detected_seizures,374272,374302,30
Jensen_Eisai_groupB,2,5,ts-global_detected_seizures,374337,374752,415
Jensen_Eisai_groupB,1,4,ts-global_detected_seizures,374338,374380,42
Jensen_Eisai_groupB,1,4,ts-global_detected_seizures,374391,374510,119
Jensen_Eisai_groupB,1,4,ts-global_detected_seizures,374522,374547,25
Jensen_Eisai_groupB,1,4,ts-global_detected_seizures,374551,374583,32
Jensen_Eisai_groupB,1,4,ts-global_detected_seizures,374594,374618,24
Jensen_Eisai_groupB,1,4,ts-global_detected_seizures,374636,374678,42
Jensen_Eisai_groupB,1,4,ts-global_detected_seizures,374714,374750,36
Jensen_Eisai_groupB,1,4,ts-global_detected_seizures,374752,374790,38
Jensen_Eisai_groupB,2,5,ts-global_detected_seizures,374753,374781,28
Jensen_Eisai_groupB,2,5,ts-global_detected_seizures,374784,374909,125
Jensen_Eisai_groupB,1,4,ts-global_detected_seizures,374802,374839,37
Jensen_Eisai_groupB,1,4,ts-global_detected_seizures,374846,374896,50
Jensen_Eisai_groupB,2,5,ts-global_detected_seizures,374910,375144,234
Jensen_Eisai_groupB,1,4,ts-global_detected_seizures,374949,375162,213
Jensen_Eisai_groupB,2,5,ts-global_detected_seizures,375170,375789,619
Jensen_Eisai_groupB,1,4,ts-global_detected_seizures,375219,375321,102
Jensen_Eisai_groupB,1,4,ts-global_detected_seizures,375322,375346,24
Jensen_Eisai_groupB,1,4,ts-global_detected_seizures,375390,375420,30
Jensen_Eisai_groupB,1,4,ts-global_detected_seizures,375454,375501,47
Jensen_Eisai_groupB,1,4,ts-global_detected_seizures,375538,375567,29
Jensen_Eisai_groupB,1,4,ts-global_detected_seizures,375568,375651,83
Jensen_Eisai_groupB,1,4,ts-global_detected_seizures,375652,375678,26
Jensen_Eisai_groupB,1,4,ts-global_detected_seizures,375692,375771,79
Jensen_Eisai_groupB,2,5,ts-global_detected_seizures,375790,375820,30
Jensen_Eisai_groupB,2,5,ts-global_detected_seizures,375837,375906,69
Jensen_Eisai_groupB,1,4,ts-global_detected_seizures,375839,375878,39
Jensen_Eisai_groupB,1,4,ts-global_detected_seizures,375880,375910,30
Jensen_Eisai_groupB,2,5,ts-global_detected_seizures,375907,375935,28
Jensen_Eisai_groupB,1,4,ts-global_detected_seizures,375921,375961,40
Jensen_Eisai_groupB,2,5,ts-global_detected_seizures,375947,376063,116
Jensen_Eisai_groupB,2,5,ts-global_detected_seizures,375947,376063,116
Jensen_Eisai_groupB,1,4,ts-global_detected_seizures,375995,376054,59
Jensen_Eisai_groupB,1,4,ts-global_detected_seizures,376074,376105,31
Jensen_Eisai_groupB,2,5,ts-global_detected_seizures,376101,376131,30
Jensen_Eisai_groupB,1,4,ts-global_detected_seizures,376114,376150,36
Jensen_Eisai_groupB,2,5,ts-global_detected_seizures,376151,376174,23
Jensen_Eisai_groupB,1,4,ts-global_detected_seizures,376174,376360,186
Jensen_Eisai_groupB,2,5,ts-global_detected_seizures,376211,376234,23
Jensen_Eisai_groupB,2,5,ts-global_detected_seizures,376256,376289,33
Jensen_Eisai_groupB,2,5,ts-global_detected_seizures,376363,376392,29
Jensen_Eisai_groupB,2,5,ts-global_detected_seizures,376421,376446,25
Jensen_Eisai_groupB,2,5,ts-global_detected_seizures,376579,376619,40
Jensen_Eisai_groupB,2,5,ts-global_detected_seizures,376644,376671,27
Jensen_Eisai_groupB,2,5,ts-global_detected_seizures,376687,376709,22
Jensen_Eisai_groupB,2,5,ts-global_detected_seizures,376711,376751,40
Jensen_Eisai_groupB,1,4,ts-global_detected_seizures,376792,376819,27
Jensen_Eisai_groupB,2,5,ts-global_detected_seizures,376836,376858,22
Jensen_Eisai_groupB,1,4,ts-global_detected_seizures,376846,376919,73
Jensen_Eisai_groupB,2,5,ts-global_detected_seizures,376867,376892,25
Jensen_Eisai_groupB,1,4,ts-global_detected_seizures,376954,376988,34
Jensen_Eisai_groupB,1,4,ts-global_detected_seizures,376994,377035,41
Jensen_Eisai_groupB,2,5,ts-global_detected_seizures,377019,377049,30
Jensen_Eisai_groupB,1,4,ts-global_detected_seizures,377073,377150,77
Jensen_Eisai_groupB,2,5,ts-global_detected_seizures,377085,377109,24
Jensen_Eisai_groupB,2,5,ts-global_detected_seizures,377150,377174,24
Jensen_Eisai_groupB,1,4,ts-global_detected_seizures,377226,377325,99
Jensen_Eisai_groupB,2,5,ts-global_detected_seizures,377277,377310,33
Jensen_Eisai_groupB,2,5,ts-global_detected_seizures,377312,377380,68
Jensen_Eisai_groupB,1,4,ts-global_detected_seizures,377327,377354,27
Jensen_Eisai_groupB,1,4,ts-global_detected_seizures,377357,377398,41
Jensen_Eisai_groupB,2,5,ts-global_detected_seizures,377406,377441,35
Jensen_Eisai_groupB,2,5,ts-global_detected_seizures,377448,377477,29
Jensen_Eisai_groupB,1,4,ts-global_detected_seizures,377471,377591,120
Jensen_Eisai_groupB,2,5,ts-global_detected_seizures,377563,377585,22
Jensen_Eisai_groupB,1,4,ts-global_detected_seizures,377592,377633,41
Jensen_Eisai_groupB,2,5,ts-global_detected_seizures,377611,377651,40
Jensen_Eisai_groupB,1,4,ts-global_detected_seizures,377686,377827,141
Jensen_Eisai_groupB,2,5,ts-global_detected_seizures,377699,377726,27
Jensen_Eisai_groupB,2,5,ts-global_detected_seizures,377739,377773,34
Jensen_Eisai_groupB,2,5,ts-global_detected_seizures,377786,377818,32
Jensen_Eisai_groupB,1,4,ts-global_detected_seizures,377828,377865,37
Jensen_Eisai_groupB,2,5,ts-global_detected_seizures,377849,377874,25
Jensen_Eisai_groupB,2,5,ts-global_detected_seizures,377875,377986,111
Jensen_Eisai_groupB,1,4,ts-global_detected_seizures,377879,377937,58
Jensen_Eisai_groupB,1,4,ts-global_detected_seizures,377956,378012,56
Jensen_Eisai_groupB,2,5,ts-global_detected_seizures,377990,378012,22
Jensen_Eisai_groupB,1,4,ts-global_detected_seizures,378017,378076,59
Jensen_Eisai_groupB,2,5,ts-global_detected_seizures,378026,378068,42
Jensen_Eisai_groupB,2,5,ts-global_detected_seizures,378094,378121,27
Jensen_Eisai_groupB,1,4,ts-global_detected_seizures,378118,378155,37
Jensen_Eisai_groupB,2,5,ts-global_detected_seizures,378167,378193,26
Jensen_Eisai_groupB,1,4,ts-global_detected_seizures,378168,378222,54
Jensen_Eisai_groupB,2,5,ts-global_detected_seizures,378194,378218,24
Jensen_Eisai_groupB,1,4,ts-global_detected_seizures,378239,378277,38
Jensen_Eisai_groupB,1,4,ts-global_detected_seizures,378295,378380,85
Jensen_Eisai_groupB,2,5,ts-global_detected_seizures,378309,378369,60
Jensen_Eisai_groupB,1,4,ts-global_detected_seizures,378389,378629,240
Jensen_Eisai_groupB,2,5,ts-global_detected_seizures,378438,378460,22
Jensen_Eisai_groupB,2,5,ts-global_detected_seizures,378585,378625,40
Jensen_Eisai_groupB,1,4,ts-global_detected_seizures,378630,378654,24
Jensen_Eisai_groupB,1,4,ts-global_detected_seizures,378659,378712,53
Jensen_Eisai_groupB,2,5,ts-global_detected_seizures,378664,378690,26
Jensen_Eisai_groupB,2,5,ts-global_detected_seizures,378700,378731,31
Jensen_Eisai_groupB,1,4,ts-global_detected_seizures,378714,378742,28
Jensen_Eisai_groupB,1,4,ts-global_detected_seizures,378767,378818,51
Jensen_Eisai_groupB,2,5,ts-global_detected_seizures,378796,378819,23
Jensen_Eisai_groupB,2,5,ts-global_detected_seizures,378830,378860,30
Jensen_Eisai_groupB,1,4,ts-global_detected_seizures,378870,379997,1127
Jensen_Eisai_groupB,2,5,ts-global_detected_seizures,378873,378895,22
Jensen_Eisai_groupB,2,5,ts-global_detected_seizures,378899,379111,212
Jensen_Eisai_groupB,2,5,ts-global_detected_seizures,379150,379173,23
Jensen_Eisai_groupB,2,5,ts-global_detected_seizures,379183,379212,29
Jensen_Eisai_groupB,2,5,ts-global_detected_seizures,379243,379279,36
Jensen_Eisai_groupB,2,5,ts-global_detected_seizures,379358,379384,26
Jensen_Eisai_groupB,2,5,ts-global_detected_seizures,379423,379464,41
Jensen_Eisai_groupB,2,5,ts-global_detected_seizures,379525,379577,52
Jensen_Eisai_groupB,2,5,ts-global_detected_seizures,379625,379649,24
Jensen_Eisai_groupB,2,5,ts-global_detected_seizures,379713,379760,47
Jensen_Eisai_groupB,2,5,ts-global_detected_seizures,379819,379847,28
Jensen_Eisai_groupB,2,5,ts-global_detected_seizures,379870,379910,40
Jensen_Eisai_groupB,2,5,ts-global_detected_seizures,379960,379993,33
Jensen_Eisai_groupB,1,4,ts-global_detected_seizures,379998,380114,116
Jensen_Eisai_groupB,2,5,ts-global_detected_seizures,380038,380254,216
Jensen_Eisai_groupB,1,4,ts-global_detected_seizures,380128,380328,200
Jensen_Eisai_groupB,2,5,ts-global_detected_seizures,380255,380320,65
Jensen_Eisai_groupB,2,5,ts-global_detected_seizures,380352,380539,187
Jensen_Eisai_groupB,1,4,ts-global_detected_seizures,380366,380401,35
Jensen_Eisai_groupB,1,4,ts-global_detected_seizures,380497,380549,52
Jensen_Eisai_groupB,2,5,ts-global_detected_seizures,380540,381163,623
Jensen_Eisai_groupB,1,4,ts-global_detected_seizures,380615,380659,44
Jensen_Eisai_groupB,1,4,ts-global_detected_seizures,380682,380709,27
Jensen_Eisai_groupB,1,4,ts-global_detected_seizures,380726,380748,22
Jensen_Eisai_groupB,1,4,ts-global_detected_seizures,380804,380879,75
Jensen_Eisai_groupB,1,4,ts-global_detected_seizures,380880,380914,34
Jensen_Eisai_groupB,1,4,ts-global_detected_seizures,380967,381017,50
Jensen_Eisai_groupB,1,4,ts-global_detected_seizures,381018,381049,31
Jensen_Eisai_groupB,1,4,ts-global_detected_seizures,381063,381091,28
Jensen_Eisai_groupB,1,4,ts-global_detected_seizures,381142,381170,28
Jensen_Eisai_groupB,2,5,ts-global_detected_seizures,381164,381198,34
Jensen_Eisai_groupB,2,5,ts-global_detected_seizures,381199,382370,1171
Jensen_Eisai_groupB,1,4,ts-global_detected_seizures,381290,381404,114
Jensen_Eisai_groupB,1,4,ts-global_detected_seizures,381460,381643,183
Jensen_Eisai_groupB,1,4,ts-global_detected_seizures,381644,381677,33
Jensen_Eisai_groupB,1,4,ts-global_detected_seizures,381715,381750,35
Jensen_Eisai_groupB,1,4,ts-global_detected_seizures,381790,381841,51
Jensen_Eisai_groupB,1,4,ts-global_detected_seizures,381843,381871,28
Jensen_Eisai_groupB,1,4,ts-global_detected_seizures,381887,381927,40
Jensen_Eisai_groupB,1,4,ts-global_detected_seizures,381973,381995,22
Jensen_Eisai_groupB,1,4,ts-global_detected_seizures,382021,382076,55
Jensen_Eisai_groupB,1,4,ts-global_detected_seizures,382081,382122,41
Jensen_Eisai_groupB,1,4,ts-global_detected_seizures,382146,382195,49
Jensen_Eisai_groupB,1,4,ts-global_detected_seizures,382214,382242,28
Jensen_Eisai_groupB,1,4,ts-global_detected_seizures,382263,382313,50
Jensen_Eisai_groupB,1,4,ts-global_detected_seizures,382338,382361,23
Jensen_Eisai_groupB,1,4,ts-global_detected_seizures,382362,382419,57
Jensen_Eisai_groupB,2,5,ts-global_detected_seizures,382453,382488,35
Jensen_Eisai_groupB,1,4,ts-global_detected_seizures,382471,382587,116
Jensen_Eisai_groupB,1,4,ts-global_detected_seizures,382591,382687,96
Jensen_Eisai_groupB,2,5,ts-global_detected_seizures,382642,382681,39
Jensen_Eisai_groupB,1,4,ts-global_detected_seizures,382689,382767,78
Jensen_Eisai_groupB,1,4,ts-global_detected_seizures,382768,382810,42
Jensen_Eisai_groupB,1,4,ts-global_detected_seizures,382812,382874,62
Jensen_Eisai_groupB,2,5,ts-global_detected_seizures,382820,382846,26
Jensen_Eisai_groupB,2,5,ts-global_detected_seizures,382868,382911,43
Jensen_Eisai_groupB,1,4,ts-global_detected_seizures,382875,382912,37
Jensen_Eisai_groupB,1,4,ts-global_detected_seizures,382934,383266,332
Jensen_Eisai_groupB,2,5,ts-global_detected_seizures,382955,382991,36
Jensen_Eisai_groupB,2,5,ts-global_detected_seizures,383057,383123,66
Jensen_Eisai_groupB,2,5,ts-global_detected_seizures,383207,383246,39
Jensen_Eisai_groupB,1,4,ts-global_detected_seizures,383267,383309,42
Jensen_Eisai_groupB,2,5,ts-global_detected_seizures,383310,383339,29
Jensen_Eisai_groupB,1,4,ts-global_detected_seizures,383311,383362,51
Jensen_Eisai_groupB,2,5,ts-global_detected_seizures,383341,383409,68
Jensen_Eisai_groupB,1,4,ts-global_detected_seizures,383385,383449,64
Jensen_Eisai_groupB,2,5,ts-global_detected_seizures,383410,383442,32
Jensen_Eisai_groupB,1,4,ts-global_detected_seizures,383451,383505,54
Jensen_Eisai_groupB,2,5,ts-global_detected_seizures,383489,383519,30
Jensen_Eisai_groupB,1,4,ts-global_detected_seizures,383541,383591,50
Jensen_Eisai_groupB,2,5,ts-global_detected_seizures,383573,383611,38
Jensen_Eisai_groupB,1,4,ts-global_detected_seizures,383596,383623,27
Jensen_Eisai_groupB,1,4,ts-global_detected_seizures,383629,383666,37
Jensen_Eisai_groupB,1,4,ts-global_detected_seizures,383700,383728,28
Jensen_Eisai_groupB,1,4,ts-global_detected_seizures,383733,383761,28
Jensen_Eisai_groupB,2,5,ts-global_detected_seizures,383745,383771,26
Jensen_Eisai_groupB,1,4,ts-global_detected_seizures,383762,383802,40
Jensen_Eisai_groupB,1,4,ts-global_detected_seizures,383823,383848,25
Jensen_Eisai_groupB,1,4,ts-global_detected_seizures,383865,383903,38
Jensen_Eisai_groupB,2,5,ts-global_detected_seizures,383882,383927,45
Jensen_Eisai_groupB,1,4,ts-global_detected_seizures,383929,383994,65
Jensen_Eisai_groupB,2,5,ts-global_detected_seizures,383968,384002,34
Jensen_Eisai_groupB,2,5,ts-global_detected_seizures,384003,384125,122
Jensen_Eisai_groupB,1,4,ts-global_detected_seizures,384029,384091,62
Jensen_Eisai_groupB,2,5,ts-global_detected_seizures,384127,384198,71
Jensen_Eisai_groupB,1,4,ts-global_detected_seizures,384151,384199,48
Jensen_Eisai_groupB,1,4,ts-global_detected_seizures,384208,384242,34
Jensen_Eisai_groupB,2,5,ts-global_detected_seizures,384211,384236,25
Jensen_Eisai_groupB,2,5,ts-global_detected_seizures,384250,384289,39
Jensen_Eisai_groupB,1,4,ts-global_detected_seizures,384268,384317,49
Jensen_Eisai_groupB,2,5,ts-global_detected_seizures,384298,384321,23
Jensen_Eisai_groupB,1,4,ts-global_detected_seizures,384318,384364,46
Jensen_Eisai_groupB,2,5,ts-global_detected_seizures,384337,384378,41
Jensen_Eisai_groupB,1,4,ts-global_detected_seizures,384374,384410,36
Jensen_Eisai_groupB,2,5,ts-global_detected_seizures,384386,384429,43
Jensen_Eisai_groupB,1,4,ts-global_detected_seizures,384445,384479,34
Jensen_Eisai_groupB,2,5,ts-global_detected_seizures,384476,384511,35
Jensen_Eisai_groupB,1,4,ts-global_detected_seizures,384490,384523,33
Jensen_Eisai_groupB,2,5,ts-global_detected_seizures,384552,384589,37
Jensen_Eisai_groupB,1,4,ts-global_detected_seizures,384591,384736,145
Jensen_Eisai_groupB,2,5,ts-global_detected_seizures,384605,384629,24
Jensen_Eisai_groupB,2,5,ts-global_detected_seizures,384631,384656,25
Jensen_Eisai_groupB,2,5,ts-global_detected_seizures,384681,384704,23
Jensen_Eisai_groupB,2,5,ts-global_detected_seizures,384721,384744,23
Jensen_Eisai_groupB,1,4,ts-global_detected_seizures,384743,384775,32
Jensen_Eisai_groupB,1,4,ts-global_detected_seizures,384793,386100,1307
Jensen_Eisai_groupB,2,5,ts-global_detected_seizures,384916,384941,25
Jensen_Eisai_groupB,2,5,ts-global_detected_seizures,385001,385024,23
Jensen_Eisai_groupB,2,5,ts-global_detected_seizures,385420,385452,32
Jensen_Eisai_groupB,2,5,ts-global_detected_seizures,385453,385493,40
Jensen_Eisai_groupB,2,5,ts-global_detected_seizures,385513,385536,23
Jensen_Eisai_groupB,2,5,ts-global_detected_seizures,385680,385713,33
Jensen_Eisai_groupB,2,5,ts-global_detected_seizures,385804,385855,51
Jensen_Eisai_groupB,2,5,ts-global_detected_seizures,385883,385909,26
Jensen_Eisai_groupB,2,5,ts-global_detected_seizures,385931,386055,124
Jensen_Eisai_groupB,1,4,ts-global_detected_seizures,386102,386135,33
Jensen_Eisai_groupB,1,4,ts-global_detected_seizures,386154,386178,24
Jensen_Eisai_groupB,2,5,ts-global_detected_seizures,386174,386203,29
Jensen_Eisai_groupB,1,4,ts-global_detected_seizures,386199,386259,60
Jensen_Eisai_groupB,1,4,ts-global_detected_seizures,386272,386334,62
Jensen_Eisai_groupB,1,4,ts-global_detected_seizures,386358,386458,100
Jensen_Eisai_groupB,2,5,ts-global_detected_seizures,386383,386438,55
Jensen_Eisai_groupB,1,4,ts-global_detected_seizures,386463,386522,59
Jensen_Eisai_groupB,2,5,ts-global_detected_seizures,386479,386504,25
Jensen_Eisai_groupB,1,4,ts-global_detected_seizures,386537,386592,55
Jensen_Eisai_groupB,1,4,ts-global_detected_seizures,386593,386802,209
Jensen_Eisai_groupB,2,5,ts-global_detected_seizures,386690,386726,36
Jensen_Eisai_groupB,2,5,ts-global_detected_seizures,386727,386752,25
Jensen_Eisai_groupB,1,4,ts-global_detected_seizures,386804,386833,29
Jensen_Eisai_groupB,2,5,ts-global_detected_seizures,386807,386832,25
Jensen_Eisai_groupB,2,5,ts-global_detected_seizures,386845,386965,120
Jensen_Eisai_groupB,1,4,ts-global_detected_seizures,386864,386892,28
Jensen_Eisai_groupB,2,5,ts-global_detected_seizures,386998,387035,37
Jensen_Eisai_groupB,1,4,ts-global_detected_seizures,387017,387039,22
Jensen_Eisai_groupB,2,5,ts-global_detected_seizures,387061,387099,38
Jensen_Eisai_groupB,2,5,ts-global_detected_seizures,387121,387213,92
Jensen_Eisai_groupB,1,4,ts-global_detected_seizures,387165,387398,233
Jensen_Eisai_groupB,2,5,ts-global_detected_seizures,387229,387533,304
Jensen_Eisai_groupB,1,4,ts-global_detected_seizures,387399,387528,129
Jensen_Eisai_groupB,1,4,ts-global_detected_seizures,387529,387655,126
Jensen_Eisai_groupB,2,5,ts-global_detected_seizures,387535,387573,38
Jensen_Eisai_groupB,2,5,ts-global_detected_seizures,387596,387710,114
Jensen_Eisai_groupB,3,6,ts-global_detected_seizures,387626,412306,24680
Jensen_Eisai_groupB,1,4,ts-global_detected_seizures,387676,388038,362
Jensen_Eisai_groupB,2,5,ts-global_detected_seizures,387711,387733,22
Jensen_Eisai_groupB,2,5,ts-global_detected_seizures,387754,388382,628
Jensen_Eisai_groupB,1,4,ts-global_detected_seizures,388066,388139,73
Jensen_Eisai_groupB,1,4,ts-global_detected_seizures,388140,388462,322
Jensen_Eisai_groupB,2,5,ts-global_detected_seizures,388388,388416,28
Jensen_Eisai_groupB,2,5,ts-global_detected_seizures,388417,388451,34
Jensen_Eisai_groupB,2,5,ts-global_detected_seizures,388452,388536,84
Jensen_Eisai_groupB,1,4,ts-global_detected_seizures,388463,388528,65
Jensen_Eisai_groupB,1,4,ts-global_detected_seizures,388529,388608,79
Jensen_Eisai_groupB,2,5,ts-global_detected_seizures,388545,388587,42
Jensen_Eisai_groupB,2,5,ts-global_detected_seizures,388588,388669,81
Jensen_Eisai_groupB,1,4,ts-global_detected_seizures,388610,388712,102
Jensen_Eisai_groupB,2,5,ts-global_detected_seizures,388693,388735,42
Jensen_Eisai_groupB,2,5,ts-global_detected_seizures,388736,388759,23
Jensen_Eisai_groupB,2,5,ts-global_detected_seizures,388761,388813,52
Jensen_Eisai_groupB,1,4,ts-global_detected_seizures,388784,388960,176
Jensen_Eisai_groupB,2,5,ts-global_detected_seizures,388828,388891,63
Jensen_Eisai_groupB,2,5,ts-global_detected_seizures,388903,388945,42
Jensen_Eisai_groupB,1,4,ts-global_detected_seizures,388961,389072,111
Jensen_Eisai_groupB,2,5,ts-global_detected_seizures,388975,389015,40
Jensen_Eisai_groupB,2,5,ts-global_detected_seizures,389021,389045,24
Jensen_Eisai_groupB,1,4,ts-global_detected_seizures,389078,389137,59
Jensen_Eisai_groupB,2,5,ts-global_detected_seizures,389080,389112,32
Jensen_Eisai_groupB,2,5,ts-global_detected_seizures,389124,389148,24
Jensen_Eisai_groupB,1,4,ts-global_detected_seizures,389161,389187,26
Jensen_Eisai_groupB,1,4,ts-global_detected_seizures,389188,389220,32
Jensen_Eisai_groupB,2,5,ts-global_detected_seizures,389210,389250,40
Jensen_Eisai_groupB,1,4,ts-global_detected_seizures,389221,389287,66
Jensen_Eisai_groupB,2,5,ts-global_detected_seizures,389271,389388,117
Jensen_Eisai_groupB,1,4,ts-global_detected_seizures,389288,389349,61
Jensen_Eisai_groupB,1,4,ts-global_detected_seizures,389377,389431,54
Jensen_Eisai_groupB,2,5,ts-global_detected_seizures,389421,389457,36
Jensen_Eisai_groupB,1,4,ts-global_detected_seizures,389493,389560,67
Jensen_Eisai_groupB,1,4,ts-global_detected_seizures,389563,389603,40
Jensen_Eisai_groupB,2,5,ts-global_detected_seizures,389579,389617,38
Jensen_Eisai_groupB,2,5,ts-global_detected_seizures,389624,389666,42
Jensen_Eisai_groupB,1,4,ts-global_detected_seizures,389669,389693,24
Jensen_Eisai_groupB,2,5,ts-global_detected_seizures,389720,389764,44
Jensen_Eisai_groupB,1,4,ts-global_detected_seizures,389728,389840,112
Jensen_Eisai_groupB,1,4,ts-global_detected_seizures,389860,389907,47
Jensen_Eisai_groupB,1,4,ts-global_detected_seizures,389908,389948,40
Jensen_Eisai_groupB,1,4,ts-global_detected_seizures,389984,390034,50
Jensen_Eisai_groupB,1,4,ts-global_detected_seizures,390035,390059,24
Jensen_Eisai_groupB,2,5,ts-global_detected_seizures,390080,390118,38
Jensen_Eisai_groupB,1,4,ts-global_detected_seizures,390096,390158,62
Jensen_Eisai_groupB,2,5,ts-global_detected_seizures,390131,390160,29
Jensen_Eisai_groupB,2,5,ts-global_detected_seizures,390161,390195,34
Jensen_Eisai_groupB,2,5,ts-global_detected_seizures,390200,390236,36
Jensen_Eisai_groupB,1,4,ts-global_detected_seizures,390218,390253,35
Jensen_Eisai_groupB,2,5,ts-global_detected_seizures,390250,390288,38
Jensen_Eisai_groupB,1,4,ts-global_detected_seizures,390278,390304,26
Jensen_Eisai_groupB,2,5,ts-global_detected_seizures,390290,390313,23
Jensen_Eisai_groupB,2,5,ts-global_detected_seizures,390314,390336,22
Jensen_Eisai_groupB,2,5,ts-global_detected_seizures,390372,390411,39
Jensen_Eisai_groupB,1,4,ts-global_detected_seizures,390391,390458,67
Jensen_Eisai_groupB,2,5,ts-global_detected_seizures,390478,390500,22
Jensen_Eisai_groupB,2,5,ts-global_detected_seizures,390513,390548,35
Jensen_Eisai_groupB,2,5,ts-global_detected_seizures,390549,390571,22
Jensen_Eisai_groupB,1,4,ts-global_detected_seizures,390553,390644,91
Jensen_Eisai_groupB,2,5,ts-global_detected_seizures,390573,390597,24
Jensen_Eisai_groupB,2,5,ts-global_detected_seizures,390639,390670,31
Jensen_Eisai_groupB,1,4,ts-global_detected_seizures,390653,390680,27
Jensen_Eisai_groupB,2,5,ts-global_detected_seizures,390671,390693,22
Jensen_Eisai_groupB,1,4,ts-global_detected_seizures,390688,390711,23
Jensen_Eisai_groupB,2,5,ts-global_detected_seizures,390699,390721,22
Jensen_Eisai_groupB,1,4,ts-global_detected_seizures,390712,390743,31
Jensen_Eisai_groupB,2,5,ts-global_detected_seizures,390722,390744,22
Jensen_Eisai_groupB,1,4,ts-global_detected_seizures,390832,390912,80
Jensen_Eisai_groupB,2,5,ts-global_detected_seizures,390841,390876,35
Jensen_Eisai_groupB,1,4,ts-global_detected_seizures,390933,390973,40
Jensen_Eisai_groupB,1,4,ts-global_detected_seizures,390974,391019,45
Jensen_Eisai_groupB,2,5,ts-global_detected_seizures,390995,391051,56
Jensen_Eisai_groupB,1,4,ts-global_detected_seizures,391020,391080,60
Jensen_Eisai_groupB,2,5,ts-global_detected_seizures,391068,391123,55
Jensen_Eisai_groupB,1,4,ts-global_detected_seizures,391082,391122,40
Jensen_Eisai_groupB,2,5,ts-global_detected_seizures,391162,391184,22
Jensen_Eisai_groupB,1,4,ts-global_detected_seizures,391177,391241,64
Jensen_Eisai_groupB,2,5,ts-global_detected_seizures,391186,391223,37
Jensen_Eisai_groupB,1,4,ts-global_detected_seizures,391263,391290,27
Jensen_Eisai_groupB,1,4,ts-global_detected_seizures,391291,391340,49
Jensen_Eisai_groupB,2,5,ts-global_detected_seizures,391343,391365,22
Jensen_Eisai_groupB,1,4,ts-global_detected_seizures,391347,391385,38
Jensen_Eisai_groupB,2,5,ts-global_detected_seizures,391367,391402,35
Jensen_Eisai_groupB,2,5,ts-global_detected_seizures,391405,391433,28
Jensen_Eisai_groupB,1,4,ts-global_detected_seizures,391448,391517,69
Jensen_Eisai_groupB,1,4,ts-global_detected_seizures,391563,391604,41
Jensen_Eisai_groupB,2,5,ts-global_detected_seizures,391599,391624,25
Jensen_Eisai_groupB,1,4,ts-global_detected_seizures,391619,391641,22
Jensen_Eisai_groupB,1,4,ts-global_detected_seizures,391683,391719,36
Jensen_Eisai_groupB,1,4,ts-global_detected_seizures,391722,391761,39
Jensen_Eisai_groupB,2,5,ts-global_detected_seizures,391727,391780,53
Jensen_Eisai_groupB,1,4,ts-global_detected_seizures,391835,391881,46
Jensen_Eisai_groupB,1,4,ts-global_detected_seizures,391911,391959,48
Jensen_Eisai_groupB,1,4,ts-global_detected_seizures,391994,392031,37
Jensen_Eisai_groupB,1,4,ts-global_detected_seizures,392036,392060,24
Jensen_Eisai_groupB,2,5,ts-global_detected_seizures,392045,392215,170
Jensen_Eisai_groupB,1,4,ts-global_detected_seizures,392073,392135,62
Jensen_Eisai_groupB,1,4,ts-global_detected_seizures,392138,392183,45
Jensen_Eisai_groupB,2,5,ts-global_detected_seizures,392216,392302,86
Jensen_Eisai_groupB,1,4,ts-global_detected_seizures,392236,392302,66
Jensen_Eisai_groupB,1,4,ts-global_detected_seizures,392303,392338,35
Jensen_Eisai_groupB,2,5,ts-global_detected_seizures,392319,392400,81
Jensen_Eisai_groupB,1,4,ts-global_detected_seizures,392372,392395,23
Jensen_Eisai_groupB,2,5,ts-global_detected_seizures,392401,392564,163
Jensen_Eisai_groupB,1,4,ts-global_detected_seizures,392411,392456,45
Jensen_Eisai_groupB,1,4,ts-global_detected_seizures,392487,392551,64
Jensen_Eisai_groupB,2,5,ts-global_detected_seizures,392565,392613,48
Jensen_Eisai_groupB,1,4,ts-global_detected_seizures,392568,392605,37
Jensen_Eisai_groupB,1,4,ts-global_detected_seizures,392622,392665,43
Jensen_Eisai_groupB,1,4,ts-global_detected_seizures,392702,392737,35
Jensen_Eisai_groupB,1,4,ts-global_detected_seizures,392739,392762,23
Jensen_Eisai_groupB,1,4,ts-global_detected_seizures,392763,392835,72
Jensen_Eisai_groupB,1,4,ts-global_detected_seizures,392838,392868,30
Jensen_Eisai_groupB,2,5,ts-global_detected_seizures,392852,392989,137
Jensen_Eisai_groupB,1,4,ts-global_detected_seizures,392914,392956,42
Jensen_Eisai_groupB,1,4,ts-global_detected_seizures,392959,393068,109
Jensen_Eisai_groupB,2,5,ts-global_detected_seizures,393014,393062,48
Jensen_Eisai_groupB,1,4,ts-global_detected_seizures,393069,393098,29
Jensen_Eisai_groupB,1,4,ts-global_detected_seizures,393104,393278,174
Jensen_Eisai_groupB,1,4,ts-global_detected_seizures,393326,393383,57
Jensen_Eisai_groupB,1,4,ts-global_detected_seizures,393384,393414,30
Jensen_Eisai_groupB,2,5,ts-global_detected_seizures,393392,393414,22
Jensen_Eisai_groupB,1,4,ts-global_detected_seizures,393415,393450,35
Jensen_Eisai_groupB,2,5,ts-global_detected_seizures,393471,393502,31
Jensen_Eisai_groupB,1,4,ts-global_detected_seizures,393472,393528,56
Jensen_Eisai_groupB,1,4,ts-global_detected_seizures,393535,393650,115
Jensen_Eisai_groupB,2,5,ts-global_detected_seizures,393582,393606,24
Jensen_Eisai_groupB,1,4,ts-global_detected_seizures,393680,393770,90
Jensen_Eisai_groupB,2,5,ts-global_detected_seizures,393753,394176,423
Jensen_Eisai_groupB,1,4,ts-global_detected_seizures,393782,393882,100
Jensen_Eisai_groupB,1,4,ts-global_detected_seizures,393903,393987,84
Jensen_Eisai_groupB,1,4,ts-global_detected_seizures,394039,394073,34
Jensen_Eisai_groupB,1,4,ts-global_detected_seizures,394074,394300,226
Jensen_Eisai_groupB,2,5,ts-global_detected_seizures,394177,394629,452
Jensen_Eisai_groupB,1,4,ts-global_detected_seizures,394306,394361,55
Jensen_Eisai_groupB,1,4,ts-global_detected_seizures,394388,394469,81
Jensen_Eisai_groupB,1,4,ts-global_detected_seizures,394470,394509,39
Jensen_Eisai_groupB,1,4,ts-global_detected_seizures,394544,394579,35
Jensen_Eisai_groupB,1,4,ts-global_detected_seizures,394580,394603,23
Jensen_Eisai_groupB,1,4,ts-global_detected_seizures,394604,394651,47
Jensen_Eisai_groupB,2,5,ts-global_detected_seizures,394640,394683,43
Jensen_Eisai_groupB,2,5,ts-global_detected_seizures,394692,394719,27
Jensen_Eisai_groupB,2,5,ts-global_detected_seizures,394744,394766,22
Jensen_Eisai_groupB,1,4,ts-global_detected_seizures,394764,394806,42
Jensen_Eisai_groupB,1,4,ts-global_detected_seizures,394807,394873,66
Jensen_Eisai_groupB,1,4,ts-global_detected_seizures,394884,394936,52
Jensen_Eisai_groupB,2,5,ts-global_detected_seizures,394916,394938,22
Jensen_Eisai_groupB,1,4,ts-global_detected_seizures,394937,395050,113
Jensen_Eisai_groupB,2,5,ts-global_detected_seizures,394980,395008,28
Jensen_Eisai_groupB,1,4,ts-global_detected_seizures,395051,395262,211
Jensen_Eisai_groupB,1,4,ts-global_detected_seizures,395264,395364,100
Jensen_Eisai_groupB,2,5,ts-global_detected_seizures,395354,395388,34
Jensen_Eisai_groupB,1,4,ts-global_detected_seizures,395365,395476,111
Jensen_Eisai_groupB,2,5,ts-global_detected_seizures,395447,395719,272
Jensen_Eisai_groupB,1,4,ts-global_detected_seizures,395477,395523,46
Jensen_Eisai_groupB,1,4,ts-global_detected_seizures,395533,395916,383
Jensen_Eisai_groupB,2,5,ts-global_detected_seizures,395872,395895,23
Jensen_Eisai_groupB,1,4,ts-global_detected_seizures,395918,395943,25
Jensen_Eisai_groupB,1,4,ts-global_detected_seizures,395944,395978,34
Jensen_Eisai_groupB,1,4,ts-global_detected_seizures,395983,396010,27
Jensen_Eisai_groupB,1,4,ts-global_detected_seizures,396011,396039,28
Jensen_Eisai_groupB,1,4,ts-global_detected_seizures,396041,396119,78
Jensen_Eisai_groupB,2,5,ts-global_detected_seizures,396156,396196,40
Jensen_Eisai_groupB,1,4,ts-global_detected_seizures,396185,396392,207
Jensen_Eisai_groupB,2,5,ts-global_detected_seizures,396225,396250,25
Jensen_Eisai_groupB,2,5,ts-global_detected_seizures,396267,396788,521
Jensen_Eisai_groupB,1,4,ts-global_detected_seizures,396397,396426,29
Jensen_Eisai_groupB,1,4,ts-global_detected_seizures,396432,396463,31
Jensen_Eisai_groupB,1,4,ts-global_detected_seizures,396464,396491,27
Jensen_Eisai_groupB,1,4,ts-global_detected_seizures,396587,396632,45
Jensen_Eisai_groupB,1,4,ts-global_detected_seizures,396736,396764,28
Jensen_Eisai_groupB,2,5,ts-global_detected_seizures,396813,396840,27
Jensen_Eisai_groupB,1,4,ts-global_detected_seizures,396825,396855,30
Jensen_Eisai_groupB,2,5,ts-global_detected_seizures,396853,396900,47
Jensen_Eisai_groupB,1,4,ts-global_detected_seizures,396890,396943,53
Jensen_Eisai_groupB,1,4,ts-global_detected_seizures,396957,397048,91
Jensen_Eisai_groupB,2,5,ts-global_detected_seizures,396960,396997,37
Jensen_Eisai_groupB,1,4,ts-global_detected_seizures,397049,397173,124
Jensen_Eisai_groupB,2,5,ts-global_detected_seizures,397131,397160,29
Jensen_Eisai_groupB,1,4,ts-global_detected_seizures,397206,397231,25
Jensen_Eisai_groupB,2,5,ts-global_detected_seizures,397244,397272,28
Jensen_Eisai_groupB,1,4,ts-global_detected_seizures,397260,397316,56
Jensen_Eisai_groupB,1,4,ts-global_detected_seizures,397317,397366,49
Jensen_Eisai_groupB,1,4,ts-global_detected_seizures,397367,397463,96
Jensen_Eisai_groupB,2,5,ts-global_detected_seizures,397391,397416,25
Jensen_Eisai_groupB,1,4,ts-global_detected_seizures,397480,397581,101
Jensen_Eisai_groupB,2,5,ts-global_detected_seizures,397553,397582,29
Jensen_Eisai_groupB,1,4,ts-global_detected_seizures,397582,397653,71
Jensen_Eisai_groupB,1,4,ts-global_detected_seizures,397660,397724,64
Jensen_Eisai_groupB,2,5,ts-global_detected_seizures,397683,397711,28
Jensen_Eisai_groupB,1,4,ts-global_detected_seizures,397736,397760,24
Jensen_Eisai_groupB,1,4,ts-global_detected_seizures,397768,397849,81
Jensen_Eisai_groupB,2,5,ts-global_detected_seizures,397831,397880,49
Jensen_Eisai_groupB,1,4,ts-global_detected_seizures,397851,398426,575
Jensen_Eisai_groupB,2,5,ts-global_detected_seizures,397933,397957,24
Jensen_Eisai_groupB,2,5,ts-global_detected_seizures,397983,398005,22
Jensen_Eisai_groupB,2,5,ts-global_detected_seizures,398052,398081,29
Jensen_Eisai_groupB,2,5,ts-global_detected_seizures,398228,399014,786
Jensen_Eisai_groupB,1,4,ts-global_detected_seizures,398441,398464,23
Jensen_Eisai_groupB,1,4,ts-global_detected_seizures,398477,398642,165
Jensen_Eisai_groupB,1,4,ts-global_detected_seizures,398654,398691,37
Jensen_Eisai_groupB,1,4,ts-global_detected_seizures,398692,398740,48
Jensen_Eisai_groupB,1,4,ts-global_detected_seizures,398741,398821,80
Jensen_Eisai_groupB,1,4,ts-global_detected_seizures,398822,398897,75
Jensen_Eisai_groupB,1,4,ts-global_detected_seizures,398898,399095,197
Jensen_Eisai_groupB,2,5,ts-global_detected_seizures,399016,400162,1146
Jensen_Eisai_groupB,1,4,ts-global_detected_seizures,399096,399120,24
Jensen_Eisai_groupB,1,4,ts-global_detected_seizures,399140,399181,41
Jensen_Eisai_groupB,1,4,ts-global_detected_seizures,399186,399328,142
Jensen_Eisai_groupB,1,4,ts-global_detected_seizures,399329,399383,54
Jensen_Eisai_groupB,1,4,ts-global_detected_seizures,399384,399422,38
Jensen_Eisai_groupB,1,4,ts-global_detected_seizures,399423,399452,29
Jensen_Eisai_groupB,1,4,ts-global_detected_seizures,399453,399481,28
Jensen_Eisai_groupB,1,4,ts-global_detected_seizures,399482,399575,93
Jensen_Eisai_groupB,1,4,ts-global_detected_seizures,399576,399638,62
Jensen_Eisai_groupB,1,4,ts-global_detected_seizures,399639,399665,26
Jensen_Eisai_groupB,1,4,ts-global_detected_seizures,399694,399819,125
Jensen_Eisai_groupB,1,4,ts-global_detected_seizures,399820,399889,69
Jensen_Eisai_groupB,1,4,ts-global_detected_seizures,399890,400500,610
Jensen_Eisai_groupB,1,4,ts-global_detected_seizures,399890,400500,610
Jensen_Eisai_groupB,2,5,ts-global_detected_seizures,400163,400302,139
Jensen_Eisai_groupB,2,5,ts-global_detected_seizures,400303,400352,49
Jensen_Eisai_groupB,2,5,ts-global_detected_seizures,400353,400936,583
Jensen_Eisai_groupB,1,4,ts-global_detected_seizures,400520,400806,286
Jensen_Eisai_groupB,1,4,ts-global_detected_seizures,400816,400844,28
Jensen_Eisai_groupB,1,4,ts-global_detected_seizures,400845,400885,40
Jensen_Eisai_groupB,2,5,ts-global_detected_seizures,400937,401320,383
Jensen_Eisai_groupB,1,4,ts-global_detected_seizures,400940,401032,92
Jensen_Eisai_groupB,1,4,ts-global_detected_seizures,401033,401251,218
Jensen_Eisai_groupB,1,4,ts-global_detected_seizures,401259,401350,91
Jensen_Eisai_groupB,2,5,ts-global_detected_seizures,401321,401697,376
Jensen_Eisai_groupB,1,4,ts-global_detected_seizures,401399,401427,28
Jensen_Eisai_groupB,1,4,ts-global_detected_seizures,401469,401551,82
Jensen_Eisai_groupB,1,4,ts-global_detected_seizures,401556,401619,63
Jensen_Eisai_groupB,1,4,ts-global_detected_seizures,401631,401694,63
Jensen_Eisai_groupB,1,4,ts-global_detected_seizures,401734,401843,109
Jensen_Eisai_groupB,1,4,ts-global_detected_seizures,401844,401985,141
Jensen_Eisai_groupB,2,5,ts-global_detected_seizures,401899,401922,23
Jensen_Eisai_groupB,1,4,ts-global_detected_seizures,401986,402064,78
Jensen_Eisai_groupB,2,5,ts-global_detected_seizures,402015,402043,28
Jensen_Eisai_groupB,1,4,ts-global_detected_seizures,402065,402268,203
Jensen_Eisai_groupB,2,5,ts-global_detected_seizures,402195,402240,45
Jensen_Eisai_groupB,1,4,ts-global_detected_seizures,402286,402322,36
Jensen_Eisai_groupB,2,5,ts-global_detected_seizures,402289,402312,23
Jensen_Eisai_groupB,1,4,ts-global_detected_seizures,402324,402403,79
Jensen_Eisai_groupB,1,4,ts-global_detected_seizures,402405,402690,285
Jensen_Eisai_groupB,2,5,ts-global_detected_seizures,402491,402539,48
Jensen_Eisai_groupB,1,4,ts-global_detected_seizures,402691,402908,217
Jensen_Eisai_groupB,2,5,ts-global_detected_seizures,402819,402842,23
Jensen_Eisai_groupB,1,4,ts-global_detected_seizures,402910,403075,165
Jensen_Eisai_groupB,2,5,ts-global_detected_seizures,402955,403574,619
Jensen_Eisai_groupB,1,4,ts-global_detected_seizures,403076,403189,113
Jensen_Eisai_groupB,1,4,ts-global_detected_seizures,403190,403329,139
Jensen_Eisai_groupB,1,4,ts-global_detected_seizures,403355,403442,87
Jensen_Eisai_groupB,1,4,ts-global_detected_seizures,403443,403503,60
Jensen_Eisai_groupB,1,4,ts-global_detected_seizures,403504,403576,72
Jensen_Eisai_groupB,1,4,ts-global_detected_seizures,403577,403643,66
Jensen_Eisai_groupB,1,4,ts-global_detected_seizures,403646,403902,256
Jensen_Eisai_groupB,2,5,ts-global_detected_seizures,403834,403856,22
Jensen_Eisai_groupB,1,4,ts-global_detected_seizures,403915,404054,139
Jensen_Eisai_groupB,2,5,ts-global_detected_seizures,404023,404046,23
Jensen_Eisai_groupB,1,4,ts-global_detected_seizures,404067,404129,62
Jensen_Eisai_groupB,2,5,ts-global_detected_seizures,404081,404121,40
Jensen_Eisai_groupB,1,4,ts-global_detected_seizures,404185,404241,56
Jensen_Eisai_groupB,2,5,ts-global_detected_seizures,404226,404254,28
Jensen_Eisai_groupB,1,4,ts-global_detected_seizures,404242,404270,28
Jensen_Eisai_groupB,1,4,ts-global_detected_seizures,404271,404461,190
Jensen_Eisai_groupB,2,5,ts-global_detected_seizures,404348,404371,23
Jensen_Eisai_groupB,1,4,ts-global_detected_seizures,404462,404609,147
Jensen_Eisai_groupB,2,5,ts-global_detected_seizures,404463,405143,680
Jensen_Eisai_groupB,1,4,ts-global_detected_seizures,404663,404702,39
Jensen_Eisai_groupB,1,4,ts-global_detected_seizures,404704,404745,41
Jensen_Eisai_groupB,1,4,ts-global_detected_seizures,404842,404898,56
Jensen_Eisai_groupB,2,5,ts-global_detected_seizures,405144,405967,823
Jensen_Eisai_groupB,1,4,ts-global_detected_seizures,405209,405290,81
Jensen_Eisai_groupB,1,4,ts-global_detected_seizures,405296,405323,27
Jensen_Eisai_groupB,1,4,ts-global_detected_seizures,405360,405674,314
Jensen_Eisai_groupB,1,4,ts-global_detected_seizures,405675,409023,3348
Jensen_Eisai_groupB,2,5,ts-global_detected_seizures,405968,406082,114
Jensen_Eisai_groupB,2,5,ts-global_detected_seizures,406222,406257,35
Jensen_Eisai_groupB,2,5,ts-global_detected_seizures,406358,406396,38
Jensen_Eisai_groupB,2,5,ts-global_detected_seizures,406528,406551,23
Jensen_Eisai_groupB,2,5,ts-global_detected_seizures,406621,406644,23
Jensen_Eisai_groupB,2,5,ts-global_detected_seizures,406668,406692,24
Jensen_Eisai_groupB,2,5,ts-global_detected_seizures,406806,406832,26
Jensen_Eisai_groupB,2,5,ts-global_detected_seizures,406996,407022,26
Jensen_Eisai_groupB,2,5,ts-global_detected_seizures,407151,407173,22
Jensen_Eisai_groupB,2,5,ts-global_detected_seizures,407231,407255,24
Jensen_Eisai_groupB,2,5,ts-global_detected_seizures,407294,407320,26
Jensen_Eisai_groupB,2,5,ts-global_detected_seizures,407402,407434,32
Jensen_Eisai_groupB,2,5,ts-global_detected_seizures,407565,407600,35
Jensen_Eisai_groupB,2,5,ts-global_detected_seizures,407613,407664,51
Jensen_Eisai_groupB,2,5,ts-global_detected_seizures,407715,407739,24
Jensen_Eisai_groupB,2,5,ts-global_detected_seizures,407825,408826,1001
Jensen_Eisai_groupB,2,5,ts-global_detected_seizures,408827,410121,1294
Jensen_Eisai_groupB,1,4,ts-global_detected_seizures,409024,409625,601
Jensen_Eisai_groupB,1,4,ts-global_detected_seizures,409626,410906,1280
Jensen_Eisai_groupB,2,5,ts-global_detected_seizures,410122,410182,60
Jensen_Eisai_groupB,2,5,ts-global_detected_seizures,410184,411029,845
Jensen_Eisai_groupB,1,4,ts-global_detected_seizures,410907,412419,1512
Jensen_Eisai_groupB,2,5,ts-global_detected_seizures,411038,413597,2559
Jensen_Eisai_groupB,3,6,ts-global_detected_seizures,412307,417961,5654
Jensen_Eisai_groupB,1,4,ts-global_detected_seizures,412420,414612,2192
Jensen_Eisai_groupB,2,5,ts-global_detected_seizures,413598,413823,225
Jensen_Eisai_groupB,2,5,ts-global_detected_seizures,413851,413883,32
Jensen_Eisai_groupB,2,5,ts-global_detected_seizures,413896,413923,27
Jensen_Eisai_groupB,2,5,ts-global_detected_seizures,413936,413977,41
Jensen_Eisai_groupB,2,5,ts-global_detected_seizures,414102,414132,30
Jensen_Eisai_groupB,2,5,ts-global_detected_seizures,414229,414254,25
Jensen_Eisai_groupB,2,5,ts-global_detected_seizures,414425,414468,43
Jensen_Eisai_groupB,2,5,ts-global_detected_seizures,414515,414549,34
Jensen_Eisai_groupB,2,5,ts-global_detected_seizures,414613,414636,23
Jensen_Eisai_groupB,2,5,ts-global_detected_seizures,414698,414721,23
Jensen_Eisai_groupB,2,5,ts-global_detected_seizures,414765,414788,23
Jensen_Eisai_groupB,2,5,ts-global_detected_seizures,414800,414828,28
Jensen_Eisai_groupB,2,5,ts-global_detected_seizures,414841,414867,26
Jensen_Eisai_groupB,1,4,ts-global_detected_seizures,414855,415051,196
Jensen_Eisai_groupB,2,5,ts-global_detected_seizures,414986,416573,1587
Jensen_Eisai_groupB,1,4,ts-global_detected_seizures,415053,415093,40
Jensen_Eisai_groupB,1,4,ts-global_detected_seizures,415100,415250,150
Jensen_Eisai_groupB,1,4,ts-global_detected_seizures,415391,415424,33
Jensen_Eisai_groupB,1,4,ts-global_detected_seizures,415551,415576,25
Jensen_Eisai_groupB,1,4,ts-global_detected_seizures,415885,415915,30
Jensen_Eisai_groupB,1,4,ts-global_detected_seizures,416380,416984,604
Jensen_Eisai_groupB,2,5,ts-global_detected_seizures,416574,416783,209
Jensen_Eisai_groupB,2,5,ts-global_detected_seizures,416792,416831,39
Jensen_Eisai_groupB,2,5,ts-global_detected_seizures,416837,417838,1001
Jensen_Eisai_groupB,1,4,ts-global_detected_seizures,416985,417038,53
Jensen_Eisai_groupB,1,4,ts-global_detected_seizures,417042,417065,23
Jensen_Eisai_groupB,1,4,ts-global_detected_seizures,417157,417181,24
Jensen_Eisai_groupB,1,4,ts-global_detected_seizures,417209,417266,57
Jensen_Eisai_groupB,1,4,ts-global_detected_seizures,417677,417699,22
Jensen_Eisai_groupB,1,4,ts-global_detected_seizures,417725,417970,245
Jensen_Eisai_groupB,3,6,ts-global_detected_seizures,417962,432082,14120
Jensen_Eisai_groupB,1,4,ts-global_detected_seizures,417971,420606,2635
Jensen_Eisai_groupB,2,5,ts-global_detected_seizures,418182,418207,25
Jensen_Eisai_groupB,2,5,ts-global_detected_seizures,418381,418408,27
Jensen_Eisai_groupB,2,5,ts-global_detected_seizures,418466,418488,22
Jensen_Eisai_groupB,2,5,ts-global_detected_seizures,418592,418657,65
Jensen_Eisai_groupB,2,5,ts-global_detected_seizures,418684,418714,30
Jensen_Eisai_groupB,2,5,ts-global_detected_seizures,418789,418812,23
Jensen_Eisai_groupB,2,5,ts-global_detected_seizures,418813,418842,29
Jensen_Eisai_groupB,2,5,ts-global_detected_seizures,418847,419253,406
Jensen_Eisai_groupB,2,5,ts-global_detected_seizures,419275,419297,22
Jensen_Eisai_groupB,2,5,ts-global_detected_seizures,419627,419652,25
Jensen_Eisai_groupB,2,5,ts-global_detected_seizures,419778,419805,27
Jensen_Eisai_groupB,2,5,ts-global_detected_seizures,419951,419978,27
Jensen_Eisai_groupB,2,5,ts-global_detected_seizures,420013,420037,24
Jensen_Eisai_groupB,2,5,ts-global_detected_seizures,420077,420128,51
Jensen_Eisai_groupB,2,5,ts-global_detected_seizures,420129,420227,98
Jensen_Eisai_groupB,2,5,ts-global_detected_seizures,420343,420370,27
Jensen_Eisai_groupB,2,5,ts-global_detected_seizures,420519,420541,22
Jensen_Eisai_groupB,1,4,ts-global_detected_seizures,420608,421151,543
Jensen_Eisai_groupB,2,5,ts-global_detected_seizures,420756,420784,28
Jensen_Eisai_groupB,2,5,ts-global_detected_seizures,420785,420907,122
Jensen_Eisai_groupB,2,5,ts-global_detected_seizures,421007,421032,25
Jensen_Eisai_groupB,1,4,ts-global_detected_seizures,421152,421264,112
Jensen_Eisai_groupB,1,4,ts-global_detected_seizures,421265,421308,43
Jensen_Eisai_groupB,2,5,ts-global_detected_seizures,421286,421568,282
Jensen_Eisai_groupB,1,4,ts-global_detected_seizures,421313,421486,173
Jensen_Eisai_groupB,2,5,ts-global_detected_seizures,421569,421603,34
Jensen_Eisai_groupB,2,5,ts-global_detected_seizures,421628,421655,27
Jensen_Eisai_groupB,1,4,ts-global_detected_seizures,421641,421686,45
Jensen_Eisai_groupB,1,4,ts-global_detected_seizures,421687,421727,40
Jensen_Eisai_groupB,1,4,ts-global_detected_seizures,421728,421764,36
Jensen_Eisai_groupB,1,4,ts-global_detected_seizures,421765,421798,33
Jensen_Eisai_groupB,1,4,ts-global_detected_seizures,421828,421867,39
Jensen_Eisai_groupB,2,5,ts-global_detected_seizures,421869,421892,23
Jensen_Eisai_groupB,1,4,ts-global_detected_seizures,421885,421930,45
Jensen_Eisai_groupB,2,5,ts-global_detected_seizures,421992,422023,31
Jensen_Eisai_groupB,1,4,ts-global_detected_seizures,422038,422080,42
Jensen_Eisai_groupB,2,5,ts-global_detected_seizures,422052,422083,31
Jensen_Eisai_groupB,1,4,ts-global_detected_seizures,422092,422115,23
Jensen_Eisai_groupB,2,5,ts-global_detected_seizures,422186,422215,29
Jensen_Eisai_groupB,2,5,ts-global_detected_seizures,422256,422306,50
Jensen_Eisai_groupB,2,5,ts-global_detected_seizures,422319,422346,27
Jensen_Eisai_groupB,2,5,ts-global_detected_seizures,422347,422378,31
Jensen_Eisai_groupB,2,5,ts-global_detected_seizures,422528,422551,23
Jensen_Eisai_groupB,2,5,ts-global_detected_seizures,422703,422746,43
Jensen_Eisai_groupB,2,5,ts-global_detected_seizures,422798,423217,419
Jensen_Eisai_groupB,1,4,ts-global_detected_seizures,422814,422844,30
Jensen_Eisai_groupB,1,4,ts-global_detected_seizures,423027,423049,22
Jensen_Eisai_groupB,1,4,ts-global_detected_seizures,423350,423373,23
Jensen_Eisai_groupB,2,5,ts-global_detected_seizures,423352,423376,24
Jensen_Eisai_groupB,1,4,ts-global_detected_seizures,423444,423469,25
Jensen_Eisai_groupB,2,5,ts-global_detected_seizures,423549,423576,27
Jensen_Eisai_groupB,2,5,ts-global_detected_seizures,423672,423712,40
Jensen_Eisai_groupB,2,5,ts-global_detected_seizures,423713,423776,63
Jensen_Eisai_groupB,2,5,ts-global_detected_seizures,423788,423814,26
Jensen_Eisai_groupB,2,5,ts-global_detected_seizures,423839,423873,34
Jensen_Eisai_groupB,1,4,ts-global_detected_seizures,423883,423920,37
Jensen_Eisai_groupB,2,5,ts-global_detected_seizures,423896,423923,27
Jensen_Eisai_groupB,1,4,ts-global_detected_seizures,423936,424034,98
Jensen_Eisai_groupB,2,5,ts-global_detected_seizures,424004,424032,28
Jensen_Eisai_groupB,2,5,ts-global_detected_seizures,424070,424102,32
Jensen_Eisai_groupB,1,4,ts-global_detected_seizures,424098,424125,27
Jensen_Eisai_groupB,1,4,ts-global_detected_seizures,424206,424243,37
Jensen_Eisai_groupB,2,5,ts-global_detected_seizures,424272,424303,31
Jensen_Eisai_groupB,2,5,ts-global_detected_seizures,424336,424370,34
Jensen_Eisai_groupB,2,5,ts-global_detected_seizures,424392,424419,27
Jensen_Eisai_groupB,1,4,ts-global_detected_seizures,424417,424450,33
Jensen_Eisai_groupB,2,5,ts-global_detected_seizures,424440,424467,27
Jensen_Eisai_groupB,1,4,ts-global_detected_seizures,424518,424660,142
Jensen_Eisai_groupB,2,5,ts-global_detected_seizures,424587,424618,31
Jensen_Eisai_groupB,2,5,ts-global_detected_seizures,424649,424696,47
Jensen_Eisai_groupB,2,5,ts-global_detected_seizures,424701,424739,38
Jensen_Eisai_groupB,1,4,ts-global_detected_seizures,424763,424816,53
Jensen_Eisai_groupB,2,5,ts-global_detected_seizures,424845,424871,26
Jensen_Eisai_groupB,1,4,ts-global_detected_seizures,424938,424982,44
Jensen_Eisai_groupB,2,5,ts-global_detected_seizures,424985,425572,587
Jensen_Eisai_groupB,1,4,ts-global_detected_seizures,425098,425178,80
Jensen_Eisai_groupB,1,4,ts-global_detected_seizures,425197,425228,31
Jensen_Eisai_groupB,1,4,ts-global_detected_seizures,425255,425887,632
Jensen_Eisai_groupB,2,5,ts-global_detected_seizures,425588,425610,22
Jensen_Eisai_groupB,2,5,ts-global_detected_seizures,425695,425717,22
Jensen_Eisai_groupB,2,5,ts-global_detected_seizures,425806,425837,31
Jensen_Eisai_groupB,2,5,ts-global_detected_seizures,425876,425905,29
Jensen_Eisai_groupB,1,4,ts-global_detected_seizures,425888,427604,1716
Jensen_Eisai_groupB,2,5,ts-global_detected_seizures,425993,426016,23
Jensen_Eisai_groupB,2,5,ts-global_detected_seizures,426020,426053,33
Jensen_Eisai_groupB,2,5,ts-global_detected_seizures,426082,426111,29
Jensen_Eisai_groupB,2,5,ts-global_detected_seizures,426162,426187,25
Jensen_Eisai_groupB,2,5,ts-global_detected_seizures,426206,426241,35
Jensen_Eisai_groupB,2,5,ts-global_detected_seizures,426267,426291,24
Jensen_Eisai_groupB,2,5,ts-global_detected_seizures,426458,426487,29
Jensen_Eisai_groupB,2,5,ts-global_detected_seizures,426511,429600,3089
Jensen_Eisai_groupB,1,4,ts-global_detected_seizures,427606,428964,1358
Jensen_Eisai_groupB,1,4,ts-global_detected_seizures,428965,429425,460
Jensen_Eisai_groupB,1,4,ts-global_detected_seizures,429426,430850,1424
Jensen_Eisai_groupB,2,5,ts-global_detected_seizures,429686,429724,38
Jensen_Eisai_groupB,2,5,ts-global_detected_seizures,429752,429786,34
Jensen_Eisai_groupB,2,5,ts-global_detected_seizures,429899,429934,35
Jensen_Eisai_groupB,2,5,ts-global_detected_seizures,429964,432082,2118
Jensen_Eisai_groupB,1,4,ts-global_detected_seizures,430851,431611,760
Jensen_Eisai_groupB,1,4,ts-global_detected_seizures,431612,431674,62
Jensen_Eisai_groupB,1,4,ts-global_detected_seizures,431682,431710,28
Jensen_Eisai_groupB,1,4,ts-global_detected_seizures,431778,431814,36
Jensen_Eisai_groupB,1,4,ts-global_detected_seizures,431821,431860,39
Jensen_Eisai_groupB,1,4,ts-global_detected_seizures,431954,431992,38
Jensen_Eisai_groupB,1,4,ts-global_detected_seizures,432002,432042,40
Jensen_Eisai_groupB,1,4,ts-global_detected_seizures,432043,432082,39
Jensen_Eisai_groupB,3,6,ts-global_detected_seizures,432506,448304,15798
Jensen_Eisai_groupB,1,4,ts-global_detected_seizures,432739,433134,395
Jensen_Eisai_groupB,2,5,ts-global_detected_seizures,432797,432889,92
Jensen_Eisai_groupB,2,5,ts-global_detected_seizures,432890,432995,105
Jensen_Eisai_groupB,2,5,ts-global_detected_seizures,433004,433059,55
Jensen_Eisai_groupB,2,5,ts-global_detected_seizures,433061,433105,44
Jensen_Eisai_groupB,2,5,ts-global_detected_seizures,433106,433157,51
Jensen_Eisai_groupB,1,4,ts-global_detected_seizures,433135,433208,73
Jensen_Eisai_groupB,2,5,ts-global_detected_seizures,433158,433197,39
Jensen_Eisai_groupB,2,5,ts-global_detected_seizures,433198,433446,248
Jensen_Eisai_groupB,1,4,ts-global_detected_seizures,433249,433312,63
Jensen_Eisai_groupB,1,4,ts-global_detected_seizures,433313,433438,125
Jensen_Eisai_groupB,1,4,ts-global_detected_seizures,433439,433482,43
Jensen_Eisai_groupB,2,5,ts-global_detected_seizures,433453,433514,61
Jensen_Eisai_groupB,1,4,ts-global_detected_seizures,433483,433631,148
Jensen_Eisai_groupB,2,5,ts-global_detected_seizures,433515,433664,149
Jensen_Eisai_groupB,1,4,ts-global_detected_seizures,433648,433670,22
Jensen_Eisai_groupB,2,5,ts-global_detected_seizures,433665,433703,38
Jensen_Eisai_groupB,1,4,ts-global_detected_seizures,433689,433730,41
Jensen_Eisai_groupB,2,5,ts-global_detected_seizures,433704,433760,56
Jensen_Eisai_groupB,1,4,ts-global_detected_seizures,433731,433774,43
Jensen_Eisai_groupB,1,4,ts-global_detected_seizures,433775,433797,22
Jensen_Eisai_groupB,1,4,ts-global_detected_seizures,433798,433874,76
Jensen_Eisai_groupB,2,5,ts-global_detected_seizures,433855,433883,28
Jensen_Eisai_groupB,2,5,ts-global_detected_seizures,433884,433914,30
Jensen_Eisai_groupB,1,4,ts-global_detected_seizures,433897,433932,35
Jensen_Eisai_groupB,1,4,ts-global_detected_seizures,433933,433974,41
Jensen_Eisai_groupB,2,5,ts-global_detected_seizures,433942,434030,88
Jensen_Eisai_groupB,1,4,ts-global_detected_seizures,433976,434053,77
Jensen_Eisai_groupB,2,5,ts-global_detected_seizures,434045,434083,38
Jensen_Eisai_groupB,1,4,ts-global_detected_seizures,434067,434091,24
Jensen_Eisai_groupB,1,4,ts-global_detected_seizures,434092,434131,39
Jensen_Eisai_groupB,2,5,ts-global_detected_seizures,434114,434137,23
Jensen_Eisai_groupB,1,4,ts-global_detected_seizures,434132,434169,37
Jensen_Eisai_groupB,1,4,ts-global_detected_seizures,434174,434214,40
Jensen_Eisai_groupB,2,5,ts-global_detected_seizures,434203,434233,30
Jensen_Eisai_groupB,1,4,ts-global_detected_seizures,434226,434277,51
Jensen_Eisai_groupB,2,5,ts-global_detected_seizures,434250,434282,32
Jensen_Eisai_groupB,1,4,ts-global_detected_seizures,434282,434309,27
Jensen_Eisai_groupB,2,5,ts-global_detected_seizures,434283,434322,39
Jensen_Eisai_groupB,1,4,ts-global_detected_seizures,434333,434366,33
Jensen_Eisai_groupB,2,5,ts-global_detected_seizures,434348,434386,38
Jensen_Eisai_groupB,1,4,ts-global_detected_seizures,434368,434430,62
Jensen_Eisai_groupB,1,4,ts-global_detected_seizures,434431,434536,105
Jensen_Eisai_groupB,2,5,ts-global_detected_seizures,434439,434466,27
Jensen_Eisai_groupB,2,5,ts-global_detected_seizures,434507,434544,37
Jensen_Eisai_groupB,1,4,ts-global_detected_seizures,434537,434574,37
Jensen_Eisai_groupB,2,5,ts-global_detected_seizures,434569,434617,48
Jensen_Eisai_groupB,1,4,ts-global_detected_seizures,434575,434613,38
Jensen_Eisai_groupB,1,4,ts-global_detected_seizures,434614,434656,42
Jensen_Eisai_groupB,2,5,ts-global_detected_seizures,434618,434646,28
Jensen_Eisai_groupB,1,4,ts-global_detected_seizures,434663,434757,94
Jensen_Eisai_groupB,1,4,ts-global_detected_seizures,434758,434836,78
Jensen_Eisai_groupB,1,4,ts-global_detected_seizures,434837,434904,67
Jensen_Eisai_groupB,2,5,ts-global_detected_seizures,434896,434948,52
Jensen_Eisai_groupB,1,4,ts-global_detected_seizures,434905,434934,29
Jensen_Eisai_groupB,1,4,ts-global_detected_seizures,434935,434993,58
Jensen_Eisai_groupB,2,5,ts-global_detected_seizures,434967,435003,36
Jensen_Eisai_groupB,1,4,ts-global_detected_seizures,434994,435065,71
Jensen_Eisai_groupB,1,4,ts-global_detected_seizures,435072,435095,23
Jensen_Eisai_groupB,1,4,ts-global_detected_seizures,435096,435245,149
Jensen_Eisai_groupB,2,5,ts-global_detected_seizures,435139,435201,62
Jensen_Eisai_groupB,2,5,ts-global_detected_seizures,435203,435283,80
Jensen_Eisai_groupB,1,4,ts-global_detected_seizures,435246,435866,620
Jensen_Eisai_groupB,2,5,ts-global_detected_seizures,435285,435344,59
Jensen_Eisai_groupB,2,5,ts-global_detected_seizures,435361,435402,41
Jensen_Eisai_groupB,2,5,ts-global_detected_seizures,435444,435501,57
Jensen_Eisai_groupB,2,5,ts-global_detected_seizures,435505,435530,25
Jensen_Eisai_groupB,2,5,ts-global_detected_seizures,435621,435682,61
Jensen_Eisai_groupB,2,5,ts-global_detected_seizures,435683,435798,115
Jensen_Eisai_groupB,1,4,ts-global_detected_seizures,435867,435937,70
Jensen_Eisai_groupB,2,5,ts-global_detected_seizures,435887,435912,25
Jensen_Eisai_groupB,2,5,ts-global_detected_seizures,435914,436112,198
Jensen_Eisai_groupB,1,4,ts-global_detected_seizures,435938,435986,48
Jensen_Eisai_groupB,1,4,ts-global_detected_seizures,435987,436027,40
Jensen_Eisai_groupB,1,4,ts-global_detected_seizures,436028,436110,82
Jensen_Eisai_groupB,1,4,ts-global_detected_seizures,436112,436535,423
Jensen_Eisai_groupB,2,5,ts-global_detected_seizures,436113,436190,77
Jensen_Eisai_groupB,2,5,ts-global_detected_seizures,436191,436224,33
Jensen_Eisai_groupB,2,5,ts-global_detected_seizures,436261,436308,47
Jensen_Eisai_groupB,2,5,ts-global_detected_seizures,436309,436403,94
Jensen_Eisai_groupB,2,5,ts-global_detected_seizures,436430,436497,67
Jensen_Eisai_groupB,1,4,ts-global_detected_seizures,436536,436647,111
Jensen_Eisai_groupB,1,4,ts-global_detected_seizures,436648,436692,44
Jensen_Eisai_groupB,2,5,ts-global_detected_seizures,436684,436744,60
Jensen_Eisai_groupB,1,4,ts-global_detected_seizures,436693,436767,74
Jensen_Eisai_groupB,1,4,ts-global_detected_seizures,436906,436936,30
Jensen_Eisai_groupB,2,5,ts-global_detected_seizures,437036,437070,34
Jensen_Eisai_groupB,1,4,ts-global_detected_seizures,437045,437085,40
Jensen_Eisai_groupB,2,5,ts-global_detected_seizures,437292,437319,27
Jensen_Eisai_groupB,1,4,ts-global_detected_seizures,437386,437409,23
Jensen_Eisai_groupB,2,5,ts-global_detected_seizures,437527,437550,23
Jensen_Eisai_groupB,2,5,ts-global_detected_seizures,437623,437670,47
Jensen_Eisai_groupB,1,4,ts-global_detected_seizures,437698,437934,236
Jensen_Eisai_groupB,2,5,ts-global_detected_seizures,437720,437742,22
Jensen_Eisai_groupB,2,5,ts-global_detected_seizures,437820,437844,24
Jensen_Eisai_groupB,2,5,ts-global_detected_seizures,437904,437926,22
Jensen_Eisai_groupB,2,5,ts-global_detected_seizures,438063,438178,115
Jensen_Eisai_groupB,1,4,ts-global_detected_seizures,438098,438120,22
Jensen_Eisai_groupB,1,4,ts-global_detected_seizures,438143,438166,23
Jensen_Eisai_groupB,2,5,ts-global_detected_seizures,438218,438246,28
Jensen_Eisai_groupB,1,4,ts-global_detected_seizures,438219,438251,32
Jensen_Eisai_groupB,2,5,ts-global_detected_seizures,438299,438327,28
Jensen_Eisai_groupB,2,5,ts-global_detected_seizures,438378,438401,23
Jensen_Eisai_groupB,1,4,ts-global_detected_seizures,438447,438473,26
Jensen_Eisai_groupB,1,4,ts-global_detected_seizures,438474,438499,25
Jensen_Eisai_groupB,2,5,ts-global_detected_seizures,438638,438666,28
Jensen_Eisai_groupB,1,4,ts-global_detected_seizures,438648,438675,27
Jensen_Eisai_groupB,2,5,ts-global_detected_seizures,438680,438702,22
Jensen_Eisai_groupB,1,4,ts-global_detected_seizures,438699,438753,54
Jensen_Eisai_groupB,1,4,ts-global_detected_seizures,438799,438825,26
Jensen_Eisai_groupB,2,5,ts-global_detected_seizures,438847,438883,36
Jensen_Eisai_groupB,1,4,ts-global_detected_seizures,438852,438952,100
Jensen_Eisai_groupB,1,4,ts-global_detected_seizures,438953,438977,24
Jensen_Eisai_groupB,2,5,ts-global_detected_seizures,438973,438996,23
Jensen_Eisai_groupB,2,5,ts-global_detected_seizures,439033,439062,29
Jensen_Eisai_groupB,1,4,ts-global_detected_seizures,439076,439100,24
Jensen_Eisai_groupB,1,4,ts-global_detected_seizures,439102,439124,22
Jensen_Eisai_groupB,2,5,ts-global_detected_seizures,439113,439174,61
Jensen_Eisai_groupB,2,5,ts-global_detected_seizures,439175,439206,31
Jensen_Eisai_groupB,1,4,ts-global_detected_seizures,439197,439233,36
Jensen_Eisai_groupB,2,5,ts-global_detected_seizures,439207,439255,48
Jensen_Eisai_groupB,2,5,ts-global_detected_seizures,439257,439296,39
Jensen_Eisai_groupB,2,5,ts-global_detected_seizures,439297,439320,23
Jensen_Eisai_groupB,2,5,ts-global_detected_seizures,439321,439346,25
Jensen_Eisai_groupB,1,4,ts-global_detected_seizures,439326,439364,38
Jensen_Eisai_groupB,1,4,ts-global_detected_seizures,439374,439400,26
Jensen_Eisai_groupB,2,5,ts-global_detected_seizures,439451,439474,23
Jensen_Eisai_groupB,1,4,ts-global_detected_seizures,439467,439508,41
Jensen_Eisai_groupB,2,5,ts-global_detected_seizures,439484,439508,24
Jensen_Eisai_groupB,1,4,ts-global_detected_seizures,439511,439568,57
Jensen_Eisai_groupB,2,5,ts-global_detected_seizures,439599,439622,23
Jensen_Eisai_groupB,1,4,ts-global_detected_seizures,439623,439651,28
Jensen_Eisai_groupB,2,5,ts-global_detected_seizures,439672,439696,24
Jensen_Eisai_groupB,2,5,ts-global_detected_seizures,439717,439745,28
Jensen_Eisai_groupB,1,4,ts-global_detected_seizures,439772,439812,40
Jensen_Eisai_groupB,2,5,ts-global_detected_seizures,439798,440046,248
Jensen_Eisai_groupB,1,4,ts-global_detected_seizures,439825,439892,67
Jensen_Eisai_groupB,1,4,ts-global_detected_seizures,439931,439967,36
Jensen_Eisai_groupB,1,4,ts-global_detected_seizures,439976,440003,27
Jensen_Eisai_groupB,1,4,ts-global_detected_seizures,440043,440072,29
Jensen_Eisai_groupB,2,5,ts-global_detected_seizures,440047,440234,187
Jensen_Eisai_groupB,1,4,ts-global_detected_seizures,440161,440203,42
Jensen_Eisai_groupB,1,4,ts-global_detected_seizures,440204,440241,37
Jensen_Eisai_groupB,1,4,ts-global_detected_seizures,440243,440274,31
Jensen_Eisai_groupB,2,5,ts-global_detected_seizures,440247,440280,33
Jensen_Eisai_groupB,2,5,ts-global_detected_seizures,440281,440418,137
Jensen_Eisai_groupB,1,4,ts-global_detected_seizures,440293,440346,53
Jensen_Eisai_groupB,1,4,ts-global_detected_seizures,440378,440427,49
Jensen_Eisai_groupB,2,5,ts-global_detected_seizures,440419,440656,237
Jensen_Eisai_groupB,1,4,ts-global_detected_seizures,440439,440487,48
Jensen_Eisai_groupB,1,4,ts-global_detected_seizures,440512,440556,44
Jensen_Eisai_groupB,1,4,ts-global_detected_seizures,440621,440669,48
Jensen_Eisai_groupB,2,5,ts-global_detected_seizures,440657,440794,137
Jensen_Eisai_groupB,1,4,ts-global_detected_seizures,440687,440717,30
Jensen_Eisai_groupB,1,4,ts-global_detected_seizures,440755,440809,54
Jensen_Eisai_groupB,2,5,ts-global_detected_seizures,440795,440818,23
Jensen_Eisai_groupB,1,4,ts-global_detected_seizures,440811,440838,27
Jensen_Eisai_groupB,2,5,ts-global_detected_seizures,440819,440848,29
Jensen_Eisai_groupB,2,5,ts-global_detected_seizures,440849,441164,315
Jensen_Eisai_groupB,1,4,ts-global_detected_seizures,440865,441742,877
Jensen_Eisai_groupB,2,5,ts-global_detected_seizures,441165,441194,29
Jensen_Eisai_groupB,2,5,ts-global_detected_seizures,441195,441225,30
Jensen_Eisai_groupB,2,5,ts-global_detected_seizures,441226,441960,734
Jensen_Eisai_groupB,1,4,ts-global_detected_seizures,441809,441840,31
Jensen_Eisai_groupB,1,4,ts-global_detected_seizures,441895,441940,45
Jensen_Eisai_groupB,2,5,ts-global_detected_seizures,441961,442001,40
Jensen_Eisai_groupB,2,5,ts-global_detected_seizures,442003,442110,107
Jensen_Eisai_groupB,1,4,ts-global_detected_seizures,442031,442056,25
Jensen_Eisai_groupB,1,4,ts-global_detected_seizures,442057,442106,49
Jensen_Eisai_groupB,2,5,ts-global_detected_seizures,442111,442167,56
Jensen_Eisai_groupB,1,4,ts-global_detected_seizures,442112,442152,40
Jensen_Eisai_groupB,2,5,ts-global_detected_seizures,442183,442208,25
Jensen_Eisai_groupB,2,5,ts-global_detected_seizures,442224,442257,33
Jensen_Eisai_groupB,1,4,ts-global_detected_seizures,442309,442350,41
Jensen_Eisai_groupB,1,4,ts-global_detected_seizures,442378,442443,65
Jensen_Eisai_groupB,2,5,ts-global_detected_seizures,442443,442467,24
Jensen_Eisai_groupB,1,4,ts-global_detected_seizures,442444,442581,137
Jensen_Eisai_groupB,2,5,ts-global_detected_seizures,442537,442560,23
Jensen_Eisai_groupB,1,4,ts-global_detected_seizures,442582,442623,41
Jensen_Eisai_groupB,2,5,ts-global_detected_seizures,442615,442643,28
Jensen_Eisai_groupB,1,4,ts-global_detected_seizures,442626,442654,28
Jensen_Eisai_groupB,1,4,ts-global_detected_seizures,442674,442705,31
Jensen_Eisai_groupB,1,4,ts-global_detected_seizures,442716,442741,25
Jensen_Eisai_groupB,2,5,ts-global_detected_seizures,442717,442766,49
Jensen_Eisai_groupB,1,4,ts-global_detected_seizures,442742,442781,39
Jensen_Eisai_groupB,1,4,ts-global_detected_seizures,442823,442899,76
Jensen_Eisai_groupB,2,5,ts-global_detected_seizures,442957,442981,24
Jensen_Eisai_groupB,1,4,ts-global_detected_seizures,442965,443050,85
Jensen_Eisai_groupB,2,5,ts-global_detected_seizures,442984,443013,29
Jensen_Eisai_groupB,2,5,ts-global_detected_seizures,443065,443148,83
Jensen_Eisai_groupB,1,4,ts-global_detected_seizures,443075,443104,29
Jensen_Eisai_groupB,1,4,ts-global_detected_seizures,443114,443234,120
Jensen_Eisai_groupB,2,5,ts-global_detected_seizures,443210,443238,28
Jensen_Eisai_groupB,2,5,ts-global_detected_seizures,443239,443270,31
Jensen_Eisai_groupB,1,4,ts-global_detected_seizures,443244,443267,23
Jensen_Eisai_groupB,2,5,ts-global_detected_seizures,443271,443298,27
Jensen_Eisai_groupB,1,4,ts-global_detected_seizures,443274,443385,111
Jensen_Eisai_groupB,2,5,ts-global_detected_seizures,443361,443388,27
Jensen_Eisai_groupB,1,4,ts-global_detected_seizures,443391,443452,61
Jensen_Eisai_groupB,1,4,ts-global_detected_seizures,443457,443490,33
Jensen_Eisai_groupB,2,5,ts-global_detected_seizures,443462,443498,36
Jensen_Eisai_groupB,1,4,ts-global_detected_seizures,443491,443554,63
Jensen_Eisai_groupB,2,5,ts-global_detected_seizures,443520,443544,24
Jensen_Eisai_groupB,1,4,ts-global_detected_seizures,443555,443608,53
Jensen_Eisai_groupB,2,5,ts-global_detected_seizures,443590,443620,30
Jensen_Eisai_groupB,1,4,ts-global_detected_seizures,443610,443651,41
Jensen_Eisai_groupB,2,5,ts-global_detected_seizures,443656,443685,29
Jensen_Eisai_groupB,1,4,ts-global_detected_seizures,443676,443713,37
Jensen_Eisai_groupB,1,4,ts-global_detected_seizures,443714,443759,45
Jensen_Eisai_groupB,2,5,ts-global_detected_seizures,443749,443774,25
Jensen_Eisai_groupB,1,4,ts-global_detected_seizures,443770,443935,165
Jensen_Eisai_groupB,2,5,ts-global_detected_seizures,443844,443891,47
Jensen_Eisai_groupB,2,5,ts-global_detected_seizures,443900,443925,25
Jensen_Eisai_groupB,1,4,ts-global_detected_seizures,443936,444069,133
Jensen_Eisai_groupB,2,5,ts-global_detected_seizures,443988,444019,31
Jensen_Eisai_groupB,1,4,ts-global_detected_seizures,444070,444095,25
Jensen_Eisai_groupB,2,5,ts-global_detected_seizures,444077,444435,358
Jensen_Eisai_groupB,1,4,ts-global_detected_seizures,444106,444152,46
Jensen_Eisai_groupB,1,4,ts-global_detected_seizures,444162,444275,113
Jensen_Eisai_groupB,1,4,ts-global_detected_seizures,444283,444326,43
Jensen_Eisai_groupB,1,4,ts-global_detected_seizures,444391,444438,47
Jensen_Eisai_groupB,2,5,ts-global_detected_seizures,444447,444474,27
Jensen_Eisai_groupB,1,4,ts-global_detected_seizures,444460,444522,62
Jensen_Eisai_groupB,1,4,ts-global_detected_seizures,444527,444600,73
Jensen_Eisai_groupB,2,5,ts-global_detected_seizures,444543,444567,24
Jensen_Eisai_groupB,2,5,ts-global_detected_seizures,444585,444616,31
Jensen_Eisai_groupB,1,4,ts-global_detected_seizures,444662,444832,170
Jensen_Eisai_groupB,2,5,ts-global_detected_seizures,444667,444711,44
Jensen_Eisai_groupB,2,5,ts-global_detected_seizures,444729,444762,33
Jensen_Eisai_groupB,2,5,ts-global_detected_seizures,444824,444859,35
Jensen_Eisai_groupB,1,4,ts-global_detected_seizures,444833,444888,55
Jensen_Eisai_groupB,2,5,ts-global_detected_seizures,444913,444954,41
Jensen_Eisai_groupB,1,4,ts-global_detected_seizures,444921,444955,34
Jensen_Eisai_groupB,2,5,ts-global_detected_seizures,445000,445039,39
Jensen_Eisai_groupB,1,4,ts-global_detected_seizures,445007,445034,27
Jensen_Eisai_groupB,2,5,ts-global_detected_seizures,445068,445091,23
Jensen_Eisai_groupB,1,4,ts-global_detected_seizures,445103,445135,32
Jensen_Eisai_groupB,2,5,ts-global_detected_seizures,445158,445181,23
Jensen_Eisai_groupB,2,5,ts-global_detected_seizures,445183,445295,112
Jensen_Eisai_groupB,1,4,ts-global_detected_seizures,445196,445243,47
Jensen_Eisai_groupB,1,4,ts-global_detected_seizures,445282,445445,163
Jensen_Eisai_groupB,2,5,ts-global_detected_seizures,445304,445329,25
Jensen_Eisai_groupB,2,5,ts-global_detected_seizures,445339,445364,25
Jensen_Eisai_groupB,2,5,ts-global_detected_seizures,445404,445441,37
Jensen_Eisai_groupB,1,4,ts-global_detected_seizures,445446,445478,32
Jensen_Eisai_groupB,2,5,ts-global_detected_seizures,445448,445473,25
Jensen_Eisai_groupB,2,5,ts-global_detected_seizures,445474,445501,27
Jensen_Eisai_groupB,1,4,ts-global_detected_seizures,445488,445623,135
Jensen_Eisai_groupB,2,5,ts-global_detected_seizures,445552,445575,23
Jensen_Eisai_groupB,2,5,ts-global_detected_seizures,445585,445618,33
Jensen_Eisai_groupB,1,4,ts-global_detected_seizures,445625,445673,48
Jensen_Eisai_groupB,2,5,ts-global_detected_seizures,445637,445695,58
Jensen_Eisai_groupB,1,4,ts-global_detected_seizures,445695,445722,27
Jensen_Eisai_groupB,2,5,ts-global_detected_seizures,445719,445755,36
Jensen_Eisai_groupB,1,4,ts-global_detected_seizures,445760,445817,57
Jensen_Eisai_groupB,2,5,ts-global_detected_seizures,445795,445854,59
Jensen_Eisai_groupB,1,4,ts-global_detected_seizures,445818,445857,39
Jensen_Eisai_groupB,1,4,ts-global_detected_seizures,445864,445897,33
Jensen_Eisai_groupB,2,5,ts-global_detected_seizures,445914,445951,37
Jensen_Eisai_groupB,1,4,ts-global_detected_seizures,445937,445978,41
Jensen_Eisai_groupB,2,5,ts-global_detected_seizures,445954,445985,31
Jensen_Eisai_groupB,1,4,ts-global_detected_seizures,445979,446011,32
Jensen_Eisai_groupB,1,4,ts-global_detected_seizures,446019,446182,163
Jensen_Eisai_groupB,2,5,ts-global_detected_seizures,446045,446082,37
Jensen_Eisai_groupB,2,5,ts-global_detected_seizures,446106,446134,28
Jensen_Eisai_groupB,2,5,ts-global_detected_seizures,446174,446263,89
Jensen_Eisai_groupB,1,4,ts-global_detected_seizures,446205,446272,67
Jensen_Eisai_groupB,2,5,ts-global_detected_seizures,446264,446326,62
Jensen_Eisai_groupB,1,4,ts-global_detected_seizures,446295,446344,49
Jensen_Eisai_groupB,1,4,ts-global_detected_seizures,446357,446400,43
Jensen_Eisai_groupB,2,5,ts-global_detected_seizures,446361,446386,25
Jensen_Eisai_groupB,1,4,ts-global_detected_seizures,446436,446461,25
Jensen_Eisai_groupB,2,5,ts-global_detected_seizures,446442,446473,31
Jensen_Eisai_groupB,1,4,ts-global_detected_seizures,446482,446524,42
Jensen_Eisai_groupB,2,5,ts-global_detected_seizures,446506,446538,32
Jensen_Eisai_groupB,1,4,ts-global_detected_seizures,446543,446596,53
Jensen_Eisai_groupB,1,4,ts-global_detected_seizures,446628,446791,163
Jensen_Eisai_groupB,2,5,ts-global_detected_seizures,446697,446723,26
Jensen_Eisai_groupB,2,5,ts-global_detected_seizures,446724,446754,30
Jensen_Eisai_groupB,2,5,ts-global_detected_seizures,446770,446792,22
Jensen_Eisai_groupB,1,4,ts-global_detected_seizures,446792,446837,45
Jensen_Eisai_groupB,2,5,ts-global_detected_seizures,446802,446835,33
Jensen_Eisai_groupB,2,5,ts-global_detected_seizures,446861,446919,58
Jensen_Eisai_groupB,1,4,ts-global_detected_seizures,446923,446951,28
Jensen_Eisai_groupB,1,4,ts-global_detected_seizures,446964,447000,36
Jensen_Eisai_groupB,2,5,ts-global_detected_seizures,446967,446994,27
Jensen_Eisai_groupB,1,4,ts-global_detected_seizures,447010,447064,54
Jensen_Eisai_groupB,2,5,ts-global_detected_seizures,447020,447060,40
Jensen_Eisai_groupB,1,4,ts-global_detected_seizures,447069,447097,28
Jensen_Eisai_groupB,2,5,ts-global_detected_seizures,447070,447100,30
Jensen_Eisai_groupB,1,4,ts-global_detected_seizures,447098,447133,35
Jensen_Eisai_groupB,2,5,ts-global_detected_seizures,447112,447136,24
Jensen_Eisai_groupB,2,5,ts-global_detected_seizures,447150,447184,34
Jensen_Eisai_groupB,1,4,ts-global_detected_seizures,447159,447466,307
Jensen_Eisai_groupB,2,5,ts-global_detected_seizures,447202,447228,26
Jensen_Eisai_groupB,2,5,ts-global_detected_seizures,447230,447294,64
Jensen_Eisai_groupB,2,5,ts-global_detected_seizures,447319,447353,34
Jensen_Eisai_groupB,2,5,ts-global_detected_seizures,447423,447618,195
Jensen_Eisai_groupB,1,4,ts-global_detected_seizures,447470,447528,58
Jensen_Eisai_groupB,1,4,ts-global_detected_seizures,447529,447582,53
Jensen_Eisai_groupB,1,4,ts-global_detected_seizures,447585,447612,27
Jensen_Eisai_groupB,1,4,ts-global_detected_seizures,447628,447656,28
Jensen_Eisai_groupB,1,4,ts-global_detected_seizures,447669,447707,38
Jensen_Eisai_groupB,2,5,ts-global_detected_seizures,447675,447702,27
Jensen_Eisai_groupB,1,4,ts-global_detected_seizures,447736,447779,43
Jensen_Eisai_groupB,2,5,ts-global_detected_seizures,447760,447798,38
Jensen_Eisai_groupB,1,4,ts-global_detected_seizures,447782,447818,36
Jensen_Eisai_groupB,2,5,ts-global_detected_seizures,447823,447852,29
Jensen_Eisai_groupB,1,4,ts-global_detected_seizures,447846,447880,34
Jensen_Eisai_groupB,1,4,ts-global_detected_seizures,447884,447942,58
Jensen_Eisai_groupB,2,5,ts-global_detected_seizures,447889,447936,47
Jensen_Eisai_groupB,1,4,ts-global_detected_seizures,447943,447983,40
Jensen_Eisai_groupB,2,5,ts-global_detected_seizures,447964,447994,30
Jensen_Eisai_groupB,1,4,ts-global_detected_seizures,447986,448013,27
Jensen_Eisai_groupB,1,4,ts-global_detected_seizures,448026,448049,23
Jensen_Eisai_groupB,2,5,ts-global_detected_seizures,448070,448111,41
Jensen_Eisai_groupB,1,4,ts-global_detected_seizures,448088,448187,99
Jensen_Eisai_groupB,2,5,ts-global_detected_seizures,448138,448170,32
Jensen_Eisai_groupB,1,4,ts-global_detected_seizures,448189,448357,168
Jensen_Eisai_groupB,2,5,ts-global_detected_seizures,448223,448252,29
Jensen_Eisai_groupB,2,5,ts-global_detected_seizures,448253,448287,34
Jensen_Eisai_groupB,3,6,ts-global_detected_seizures,448305,449678,1373
Jensen_Eisai_groupB,2,5,ts-global_detected_seizures,448309,448355,46
Jensen_Eisai_groupB,2,5,ts-global_detected_seizures,448356,448391,35
Jensen_Eisai_groupB,1,4,ts-global_detected_seizures,448374,451030,2656
Jensen_Eisai_groupB,2,5,ts-global_detected_seizures,448397,448426,29
Jensen_Eisai_groupB,2,5,ts-global_detected_seizures,448457,448497,40
Jensen_Eisai_groupB,2,5,ts-global_detected_seizures,448531,448557,26
Jensen_Eisai_groupB,2,5,ts-global_detected_seizures,448575,448601,26
Jensen_Eisai_groupB,2,5,ts-global_detected_seizures,448633,448671,38
Jensen_Eisai_groupB,2,5,ts-global_detected_seizures,448689,448717,28
Jensen_Eisai_groupB,2,5,ts-global_detected_seizures,448753,448780,27
Jensen_Eisai_groupB,2,5,ts-global_detected_seizures,448788,448813,25
Jensen_Eisai_groupB,2,5,ts-global_detected_seizures,448817,448840,23
Jensen_Eisai_groupB,2,5,ts-global_detected_seizures,448878,448917,39
Jensen_Eisai_groupB,2,5,ts-global_detected_seizures,448991,449035,44
Jensen_Eisai_groupB,2,5,ts-global_detected_seizures,449110,449133,23
Jensen_Eisai_groupB,2,5,ts-global_detected_seizures,449156,449210,54
Jensen_Eisai_groupB,2,5,ts-global_detected_seizures,449234,449260,26
Jensen_Eisai_groupB,2,5,ts-global_detected_seizures,449279,449315,36
Jensen_Eisai_groupB,2,5,ts-global_detected_seizures,449324,449537,213
Jensen_Eisai_groupB,2,5,ts-global_detected_seizures,449558,449584,26
Jensen_Eisai_groupB,2,5,ts-global_detected_seizures,449605,449642,37
Jensen_Eisai_groupB,2,5,ts-global_detected_seizures,449671,449707,36
Jensen_Eisai_groupB,3,6,ts-global_detected_seizures,449679,450317,638
Jensen_Eisai_groupB,2,5,ts-global_detected_seizures,449749,449777,28
Jensen_Eisai_groupB,2,5,ts-global_detected_seizures,449884,449910,26
Jensen_Eisai_groupB,2,5,ts-global_detected_seizures,449911,449933,22
Jensen_Eisai_groupB,2,5,ts-global_detected_seizures,449950,449986,36
Jensen_Eisai_groupB,2,5,ts-global_detected_seizures,450069,450094,25
Jensen_Eisai_groupB,2,5,ts-global_detected_seizures,450069,450094,25
Jensen_Eisai_groupB,2,5,ts-global_detected_seizures,450159,450216,57
Jensen_Eisai_groupB,2,5,ts-global_detected_seizures,450217,450280,63
Jensen_Eisai_groupB,2,5,ts-global_detected_seizures,450281,450308,27
Jensen_Eisai_groupB,2,5,ts-global_detected_seizures,450310,450336,26
Jensen_Eisai_groupB,3,6,ts-global_detected_seizures,450318,462850,12532
Jensen_Eisai_groupB,2,5,ts-global_detected_seizures,450354,450399,45
Jensen_Eisai_groupB,2,5,ts-global_detected_seizures,450442,450478,36
Jensen_Eisai_groupB,2,5,ts-global_detected_seizures,450500,450524,24
Jensen_Eisai_groupB,2,5,ts-global_detected_seizures,450541,450586,45
Jensen_Eisai_groupB,2,5,ts-global_detected_seizures,450595,450618,23
Jensen_Eisai_groupB,2,5,ts-global_detected_seizures,450633,450749,116
Jensen_Eisai_groupB,2,5,ts-global_detected_seizures,450778,450809,31
Jensen_Eisai_groupB,2,5,ts-global_detected_seizures,450820,450855,35
Jensen_Eisai_groupB,2,5,ts-global_detected_seizures,450880,450906,26
Jensen_Eisai_groupB,2,5,ts-global_detected_seizures,450941,450965,24
Jensen_Eisai_groupB,2,5,ts-global_detected_seizures,450985,451014,29
Jensen_Eisai_groupB,1,4,ts-global_detected_seizures,451044,451067,23
Jensen_Eisai_groupB,2,5,ts-global_detected_seizures,451046,451075,29
Jensen_Eisai_groupB,2,5,ts-global_detected_seizures,451118,451148,30
Jensen_Eisai_groupB,1,4,ts-global_detected_seizures,451150,451188,38
Jensen_Eisai_groupB,2,5,ts-global_detected_seizures,451179,451203,24
Jensen_Eisai_groupB,1,4,ts-global_detected_seizures,451189,451215,26
Jensen_Eisai_groupB,2,5,ts-global_detected_seizures,451244,451268,24
Jensen_Eisai_groupB,1,4,ts-global_detected_seizures,451304,451326,22
Jensen_Eisai_groupB,2,5,ts-global_detected_seizures,451311,451334,23
Jensen_Eisai_groupB,2,5,ts-global_detected_seizures,451368,451404,36
Jensen_Eisai_groupB,1,4,ts-global_detected_seizures,451406,451498,92
Jensen_Eisai_groupB,2,5,ts-global_detected_seizures,451421,451445,24
Jensen_Eisai_groupB,2,5,ts-global_detected_seizures,451446,451495,49
Jensen_Eisai_groupB,2,5,ts-global_detected_seizures,451515,451541,26
Jensen_Eisai_groupB,1,4,ts-global_detected_seizures,451539,451576,37
Jensen_Eisai_groupB,1,4,ts-global_detected_seizures,451629,451676,47
Jensen_Eisai_groupB,2,5,ts-global_detected_seizures,451632,451668,36
Jensen_Eisai_groupB,2,5,ts-global_detected_seizures,451698,451736,38
Jensen_Eisai_groupB,1,4,ts-global_detected_seizures,451739,451810,71
Jensen_Eisai_groupB,2,5,ts-global_detected_seizures,451797,451828,31
Jensen_Eisai_groupB,1,4,ts-global_detected_seizures,451847,451888,41
Jensen_Eisai_groupB,2,5,ts-global_detected_seizures,451849,451873,24
Jensen_Eisai_groupB,2,5,ts-global_detected_seizures,451874,451916,42
Jensen_Eisai_groupB,1,4,ts-global_detected_seizures,451890,451938,48
Jensen_Eisai_groupB,2,5,ts-global_detected_seizures,451918,451946,28
Jensen_Eisai_groupB,1,4,ts-global_detected_seizures,452059,452089,30
Jensen_Eisai_groupB,2,5,ts-global_detected_seizures,452065,452095,30
Jensen_Eisai_groupB,1,4,ts-global_detected_seizures,452117,452176,59
Jensen_Eisai_groupB,2,5,ts-global_detected_seizures,452164,452194,30
Jensen_Eisai_groupB,1,4,ts-global_detected_seizures,452195,452230,35
Jensen_Eisai_groupB,2,5,ts-global_detected_seizures,452218,452241,23
Jensen_Eisai_groupB,2,5,ts-global_detected_seizures,452260,452287,27
Jensen_Eisai_groupB,1,4,ts-global_detected_seizures,452312,452541,229
Jensen_Eisai_groupB,2,5,ts-global_detected_seizures,452314,452339,25
Jensen_Eisai_groupB,2,5,ts-global_detected_seizures,452341,452382,41
Jensen_Eisai_groupB,2,5,ts-global_detected_seizures,452391,452473,82
Jensen_Eisai_groupB,2,5,ts-global_detected_seizures,452484,452565,81
Jensen_Eisai_groupB,1,4,ts-global_detected_seizures,452542,452695,153
Jensen_Eisai_groupB,2,5,ts-global_detected_seizures,452600,452625,25
Jensen_Eisai_groupB,2,5,ts-global_detected_seizures,452659,452684,25
Jensen_Eisai_groupB,1,4,ts-global_detected_seizures,452700,452725,25
Jensen_Eisai_groupB,2,5,ts-global_detected_seizures,452701,452738,37
Jensen_Eisai_groupB,2,5,ts-global_detected_seizures,452739,452777,38
Jensen_Eisai_groupB,1,4,ts-global_detected_seizures,452748,452882,134
Jensen_Eisai_groupB,2,5,ts-global_detected_seizures,452810,452838,28
Jensen_Eisai_groupB,2,5,ts-global_detected_seizures,452864,452888,24
Jensen_Eisai_groupB,1,4,ts-global_detected_seizures,452884,452947,63
Jensen_Eisai_groupB,2,5,ts-global_detected_seizures,452936,452959,23
Jensen_Eisai_groupB,2,5,ts-global_detected_seizures,453002,453043,41
Jensen_Eisai_groupB,1,4,ts-global_detected_seizures,453016,453045,29
Jensen_Eisai_groupB,1,4,ts-global_detected_seizures,453068,453095,27
Jensen_Eisai_groupB,2,5,ts-global_detected_seizures,453082,453106,24
Jensen_Eisai_groupB,1,4,ts-global_detected_seizures,453107,453186,79
Jensen_Eisai_groupB,2,5,ts-global_detected_seizures,453108,453160,52
Jensen_Eisai_groupB,2,5,ts-global_detected_seizures,453162,453186,24
Jensen_Eisai_groupB,1,4,ts-global_detected_seizures,453188,453244,56
Jensen_Eisai_groupB,2,5,ts-global_detected_seizures,453235,453279,44
Jensen_Eisai_groupB,1,4,ts-global_detected_seizures,453249,453284,35
Jensen_Eisai_groupB,2,5,ts-global_detected_seizures,453280,453320,40
Jensen_Eisai_groupB,1,4,ts-global_detected_seizures,453287,453330,43
Jensen_Eisai_groupB,1,4,ts-global_detected_seizures,453357,453423,66
Jensen_Eisai_groupB,2,5,ts-global_detected_seizures,453418,453448,30
Jensen_Eisai_groupB,1,4,ts-global_detected_seizures,453436,453460,24
Jensen_Eisai_groupB,2,5,ts-global_detected_seizures,453494,453532,38
Jensen_Eisai_groupB,2,5,ts-global_detected_seizures,453537,453565,28
Jensen_Eisai_groupB,1,4,ts-global_detected_seizures,453565,453587,22
Jensen_Eisai_groupB,2,5,ts-global_detected_seizures,453566,453608,42
Jensen_Eisai_groupB,1,4,ts-global_detected_seizures,453608,453632,24
Jensen_Eisai_groupB,2,5,ts-global_detected_seizures,453637,453722,85
Jensen_Eisai_groupB,1,4,ts-global_detected_seizures,453643,453673,30
Jensen_Eisai_groupB,1,4,ts-global_detected_seizures,453682,453725,43
Jensen_Eisai_groupB,1,4,ts-global_detected_seizures,453756,453793,37
Jensen_Eisai_groupB,2,5,ts-global_detected_seizures,453820,453863,43
Jensen_Eisai_groupB,1,4,ts-global_detected_seizures,453824,453943,119
Jensen_Eisai_groupB,2,5,ts-global_detected_seizures,453880,453903,23
Jensen_Eisai_groupB,2,5,ts-global_detected_seizures,453930,453958,28
Jensen_Eisai_groupB,2,5,ts-global_detected_seizures,453959,453991,32
Jensen_Eisai_groupB,2,5,ts-global_detected_seizures,454000,454056,56
Jensen_Eisai_groupB,1,4,ts-global_detected_seizures,454044,454127,83
Jensen_Eisai_groupB,2,5,ts-global_detected_seizures,454081,454115,34
Jensen_Eisai_groupB,2,5,ts-global_detected_seizures,454128,454155,27
Jensen_Eisai_groupB,1,4,ts-global_detected_seizures,454151,454178,27
Jensen_Eisai_groupB,1,4,ts-global_detected_seizures,454180,454281,101
Jensen_Eisai_groupB,2,5,ts-global_detected_seizures,454231,454283,52
Jensen_Eisai_groupB,1,4,ts-global_detected_seizures,454288,454340,52
Jensen_Eisai_groupB,2,5,ts-global_detected_seizures,454341,454387,46
Jensen_Eisai_groupB,1,4,ts-global_detected_seizures,454367,454452,85
Jensen_Eisai_groupB,2,5,ts-global_detected_seizures,454412,454540,128
Jensen_Eisai_groupB,1,4,ts-global_detected_seizures,454453,454602,149
Jensen_Eisai_groupB,2,5,ts-global_detected_seizures,454541,454564,23
Jensen_Eisai_groupB,2,5,ts-global_detected_seizures,454572,454610,38
Jensen_Eisai_groupB,2,5,ts-global_detected_seizures,454621,454644,23
Jensen_Eisai_groupB,1,4,ts-global_detected_seizures,454645,454717,72
Jensen_Eisai_groupB,2,5,ts-global_detected_seizures,454663,454690,27
Jensen_Eisai_groupB,1,4,ts-global_detected_seizures,454722,454758,36
Jensen_Eisai_groupB,2,5,ts-global_detected_seizures,454730,454769,39
Jensen_Eisai_groupB,1,4,ts-global_detected_seizures,454767,454794,27
Jensen_Eisai_groupB,2,5,ts-global_detected_seizures,454770,454802,32
Jensen_Eisai_groupB,1,4,ts-global_detected_seizures,454806,454836,30
Jensen_Eisai_groupB,2,5,ts-global_detected_seizures,454824,455191,367
Jensen_Eisai_groupB,1,4,ts-global_detected_seizures,454851,454901,50
Jensen_Eisai_groupB,1,4,ts-global_detected_seizures,454902,455193,291
Jensen_Eisai_groupB,2,5,ts-global_detected_seizures,455192,455430,238
Jensen_Eisai_groupB,1,4,ts-global_detected_seizures,455194,455222,28
Jensen_Eisai_groupB,1,4,ts-global_detected_seizures,455234,455299,65
Jensen_Eisai_groupB,1,4,ts-global_detected_seizures,455329,455363,34
Jensen_Eisai_groupB,1,4,ts-global_detected_seizures,455364,455430,66
Jensen_Eisai_groupB,2,5,ts-global_detected_seizures,455431,456959,1528
Jensen_Eisai_groupB,1,4,ts-global_detected_seizures,455666,455772,106
Jensen_Eisai_groupB,1,4,ts-global_detected_seizures,455777,455915,138
Jensen_Eisai_groupB,1,4,ts-global_detected_seizures,455917,456046,129
Jensen_Eisai_groupB,1,4,ts-global_detected_seizures,456098,456190,92
Jensen_Eisai_groupB,1,4,ts-global_detected_seizures,456192,456226,34
Jensen_Eisai_groupB,1,4,ts-global_detected_seizures,456227,456310,83
Jensen_Eisai_groupB,1,4,ts-global_detected_seizures,456324,456492,168
Jensen_Eisai_groupB,1,4,ts-global_detected_seizures,456493,456556,63
Jensen_Eisai_groupB,1,4,ts-global_detected_seizures,456600,456631,31
Jensen_Eisai_groupB,1,4,ts-global_detected_seizures,456643,456697,54
Jensen_Eisai_groupB,1,4,ts-global_detected_seizures,456698,456752,54
Jensen_Eisai_groupB,1,4,ts-global_detected_seizures,456754,456777,23
Jensen_Eisai_groupB,1,4,ts-global_detected_seizures,456784,456822,38
Jensen_Eisai_groupB,1,4,ts-global_detected_seizures,456841,456865,24
Jensen_Eisai_groupB,1,4,ts-global_detected_seizures,456866,456932,66
Jensen_Eisai_groupB,1,4,ts-global_detected_seizures,456933,456955,22
Jensen_Eisai_groupB,2,5,ts-global_detected_seizures,456975,457005,30
Jensen_Eisai_groupB,1,4,ts-global_detected_seizures,456996,457040,44
Jensen_Eisai_groupB,2,5,ts-global_detected_seizures,457030,457053,23
Jensen_Eisai_groupB,1,4,ts-global_detected_seizures,457060,457099,39
Jensen_Eisai_groupB,2,5,ts-global_detected_seizures,457121,457156,35
Jensen_Eisai_groupB,1,4,ts-global_detected_seizures,457150,457174,24
Jensen_Eisai_groupB,1,4,ts-global_detected_seizures,457175,457219,44
Jensen_Eisai_groupB,1,4,ts-global_detected_seizures,457220,457331,111
Jensen_Eisai_groupB,2,5,ts-global_detected_seizures,457275,457308,33
Jensen_Eisai_groupB,2,5,ts-global_detected_seizures,457310,457337,27
Jensen_Eisai_groupB,1,4,ts-global_detected_seizures,457365,457415,50
Jensen_Eisai_groupB,2,5,ts-global_detected_seizures,457386,457421,35
Jensen_Eisai_groupB,1,4,ts-global_detected_seizures,457437,457488,51
Jensen_Eisai_groupB,1,4,ts-global_detected_seizures,457489,457515,26
Jensen_Eisai_groupB,1,4,ts-global_detected_seizures,457516,457567,51
Jensen_Eisai_groupB,1,4,ts-global_detected_seizures,457572,457614,42
Jensen_Eisai_groupB,2,5,ts-global_detected_seizures,457594,457652,58
Jensen_Eisai_groupB,1,4,ts-global_detected_seizures,457642,457674,32
Jensen_Eisai_groupB,1,4,ts-global_detected_seizures,457678,457773,95
Jensen_Eisai_groupB,2,5,ts-global_detected_seizures,457701,457736,35
Jensen_Eisai_groupB,1,4,ts-global_detected_seizures,457774,457809,35
Jensen_Eisai_groupB,2,5,ts-global_detected_seizures,457775,457801,26
Jensen_Eisai_groupB,1,4,ts-global_detected_seizures,457810,457835,25
Jensen_Eisai_groupB,2,5,ts-global_detected_seizures,457837,457865,28
Jensen_Eisai_groupB,1,4,ts-global_detected_seizures,457844,457915,71
Jensen_Eisai_groupB,2,5,ts-global_detected_seizures,457867,457896,29
Jensen_Eisai_groupB,2,5,ts-global_detected_seizures,457898,457936,38
Jensen_Eisai_groupB,1,4,ts-global_detected_seizures,457916,457938,22
Jensen_Eisai_groupB,2,5,ts-global_detected_seizures,457969,457995,26
Jensen_Eisai_groupB,1,4,ts-global_detected_seizures,458006,458195,189
Jensen_Eisai_groupB,2,5,ts-global_detected_seizures,458034,458070,36
Jensen_Eisai_groupB,2,5,ts-global_detected_seizures,458146,458266,120
Jensen_Eisai_groupB,1,4,ts-global_detected_seizures,458199,458243,44
Jensen_Eisai_groupB,1,4,ts-global_detected_seizures,458282,458323,41
Jensen_Eisai_groupB,2,5,ts-global_detected_seizures,458306,458334,28
Jensen_Eisai_groupB,1,4,ts-global_detected_seizures,458332,458385,53
Jensen_Eisai_groupB,2,5,ts-global_detected_seizures,458338,458361,23
Jensen_Eisai_groupB,1,4,ts-global_detected_seizures,458392,458423,31
Jensen_Eisai_groupB,1,4,ts-global_detected_seizures,458439,458497,58
Jensen_Eisai_groupB,2,5,ts-global_detected_seizures,458489,458570,81
Jensen_Eisai_groupB,1,4,ts-global_detected_seizures,458532,458592,60
Jensen_Eisai_groupB,1,4,ts-global_detected_seizures,458606,458670,64
Jensen_Eisai_groupB,2,5,ts-global_detected_seizures,458655,458679,24
Jensen_Eisai_groupB,1,4,ts-global_detected_seizures,458689,458721,32
Jensen_Eisai_groupB,1,4,ts-global_detected_seizures,458729,458782,53
Jensen_Eisai_groupB,1,4,ts-global_detected_seizures,458783,458877,94
Jensen_Eisai_groupB,2,5,ts-global_detected_seizures,458831,458854,23
Jensen_Eisai_groupB,1,4,ts-global_detected_seizures,458878,458904,26
Jensen_Eisai_groupB,1,4,ts-global_detected_seizures,458914,460748,1834
Jensen_Eisai_groupB,2,5,ts-global_detected_seizures,459013,459043,30
Jensen_Eisai_groupB,2,5,ts-global_detected_seizures,459064,459095,31
Jensen_Eisai_groupB,2,5,ts-global_detected_seizures,459198,459223,25
Jensen_Eisai_groupB,2,5,ts-global_detected_seizures,459237,459265,28
Jensen_Eisai_groupB,2,5,ts-global_detected_seizures,459290,459325,35
Jensen_Eisai_groupB,2,5,ts-global_detected_seizures,459363,459391,28
Jensen_Eisai_groupB,2,5,ts-global_detected_seizures,459428,459466,38
Jensen_Eisai_groupB,2,5,ts-global_detected_seizures,459484,459587,103
Jensen_Eisai_groupB,2,5,ts-global_detected_seizures,459592,459615,23
Jensen_Eisai_groupB,2,5,ts-global_detected_seizures,459826,459848,22
Jensen_Eisai_groupB,2,5,ts-global_detected_seizures,459994,460017,23
Jensen_Eisai_groupB,2,5,ts-global_detected_seizures,460074,460101,27
Jensen_Eisai_groupB,2,5,ts-global_detected_seizures,460163,460218,55
Jensen_Eisai_groupB,2,5,ts-global_detected_seizures,460279,460301,22
Jensen_Eisai_groupB,2,5,ts-global_detected_seizures,460358,460394,36
Jensen_Eisai_groupB,2,5,ts-global_detected_seizures,460423,460464,41
Jensen_Eisai_groupB,2,5,ts-global_detected_seizures,460501,460536,35
Jensen_Eisai_groupB,2,5,ts-global_detected_seizures,460581,460752,171
Jensen_Eisai_groupB,1,4,ts-global_detected_seizures,460749,460928,179
Jensen_Eisai_groupB,2,5,ts-global_detected_seizures,460776,460806,30
Jensen_Eisai_groupB,2,5,ts-global_detected_seizures,460852,460887,35
Jensen_Eisai_groupB,1,4,ts-global_detected_seizures,460937,461145,208
Jensen_Eisai_groupB,2,5,ts-global_detected_seizures,460951,460990,39
Jensen_Eisai_groupB,2,5,ts-global_detected_seizures,460991,461025,34
Jensen_Eisai_groupB,2,5,ts-global_detected_seizures,461063,461099,36
Jensen_Eisai_groupB,1,4,ts-global_detected_seizures,461146,461175,29
Jensen_Eisai_groupB,2,5,ts-global_detected_seizures,461156,461199,43
Jensen_Eisai_groupB,1,4,ts-global_detected_seizures,461176,461199,23
Jensen_Eisai_groupB,1,4,ts-global_detected_seizures,461226,461270,44
Jensen_Eisai_groupB,2,5,ts-global_detected_seizures,461256,461281,25
Jensen_Eisai_groupB,1,4,ts-global_detected_seizures,461272,461299,27
Jensen_Eisai_groupB,1,4,ts-global_detected_seizures,461301,461331,30
Jensen_Eisai_groupB,2,5,ts-global_detected_seizures,461308,461344,36
Jensen_Eisai_groupB,2,5,ts-global_detected_seizures,461379,461409,30
Jensen_Eisai_groupB,2,5,ts-global_detected_seizures,461449,461478,29
Jensen_Eisai_groupB,1,4,ts-global_detected_seizures,461476,461548,72
Jensen_Eisai_groupB,2,5,ts-global_detected_seizures,461479,461511,32
Jensen_Eisai_groupB,2,5,ts-global_detected_seizures,461553,461651,98
Jensen_Eisai_groupB,1,4,ts-global_detected_seizures,461559,461596,37
Jensen_Eisai_groupB,1,4,ts-global_detected_seizures,461597,461666,69
Jensen_Eisai_groupB,2,5,ts-global_detected_seizures,461655,461680,25
Jensen_Eisai_groupB,1,4,ts-global_detected_seizures,461699,461762,63
Jensen_Eisai_groupB,2,5,ts-global_detected_seizures,461730,461765,35
Jensen_Eisai_groupB,1,4,ts-global_detected_seizures,461763,461848,85
Jensen_Eisai_groupB,2,5,ts-global_detected_seizures,461806,461850,44
Jensen_Eisai_groupB,2,5,ts-global_detected_seizures,461863,461911,48
Jensen_Eisai_groupB,1,4,ts-global_detected_seizures,461869,461923,54
Jensen_Eisai_groupB,1,4,ts-global_detected_seizures,461925,461953,28
Jensen_Eisai_groupB,2,5,ts-global_detected_seizures,461984,462012,28
Jensen_Eisai_groupB,1,4,ts-global_detected_seizures,462031,462071,40
Jensen_Eisai_groupB,2,5,ts-global_detected_seizures,462041,462066,25
Jensen_Eisai_groupB,1,4,ts-global_detected_seizures,462081,462115,34
Jensen_Eisai_groupB,2,5,ts-global_detected_seizures,462106,462139,33
Jensen_Eisai_groupB,1,4,ts-global_detected_seizures,462116,462216,100
Jensen_Eisai_groupB,2,5,ts-global_detected_seizures,462172,462210,38
Jensen_Eisai_groupB,1,4,ts-global_detected_seizures,462262,462349,87
Jensen_Eisai_groupB,2,5,ts-global_detected_seizures,462282,462322,40
Jensen_Eisai_groupB,1,4,ts-global_detected_seizures,462413,462473,60
Jensen_Eisai_groupB,2,5,ts-global_detected_seizures,462472,462552,80
Jensen_Eisai_groupB,1,4,ts-global_detected_seizures,462485,462511,26
Jensen_Eisai_groupB,1,4,ts-global_detected_seizures,462525,462553,28
Jensen_Eisai_groupB,1,4,ts-global_detected_seizures,462567,462726,159
Jensen_Eisai_groupB,2,5,ts-global_detected_seizures,462592,462622,30
Jensen_Eisai_groupB,2,5,ts-global_detected_seizures,462634,462740,106
Jensen_Eisai_groupB,2,5,ts-global_detected_seizures,462741,462773,32
Jensen_Eisai_groupB,2,5,ts-global_detected_seizures,462787,462811,24
Jensen_Eisai_groupB,1,4,ts-global_detected_seizures,462790,462841,51
Jensen_Eisai_groupB,3,6,ts-global_detected_seizures,462851,464174,1323
Jensen_Eisai_groupB,1,4,ts-global_detected_seizures,462857,462884,27
Jensen_Eisai_groupB,2,5,ts-global_detected_seizures,462871,462896,25
Jensen_Eisai_groupB,1,4,ts-global_detected_seizures,462895,463037,142
Jensen_Eisai_groupB,2,5,ts-global_detected_seizures,462897,462935,38
Jensen_Eisai_groupB,2,5,ts-global_detected_seizures,462965,463020,55
Jensen_Eisai_groupB,1,4,ts-global_detected_seizures,463059,463145,86
Jensen_Eisai_groupB,2,5,ts-global_detected_seizures,463060,463115,55
Jensen_Eisai_groupB,1,4,ts-global_detected_seizures,463146,463168,22
Jensen_Eisai_groupB,2,5,ts-global_detected_seizures,463181,463205,24
Jensen_Eisai_groupB,1,4,ts-global_detected_seizures,463200,463249,49
Jensen_Eisai_groupB,2,5,ts-global_detected_seizures,463221,463257,36
Jensen_Eisai_groupB,2,5,ts-global_detected_seizures,463307,463354,47
Jensen_Eisai_groupB,1,4,ts-global_detected_seizures,463324,463379,55
Jensen_Eisai_groupB,1,4,ts-global_detected_seizures,463385,464483,1098
Jensen_Eisai_groupB,2,5,ts-global_detected_seizures,463418,464070,652
Jensen_Eisai_groupB,2,5,ts-global_detected_seizures,464071,464096,25
Jensen_Eisai_groupB,2,5,ts-global_detected_seizures,464099,464845,746
Jensen_Eisai_groupB,3,6,ts-global_detected_seizures,464182,464453,271
Jensen_Eisai_groupB,3,6,ts-global_detected_seizures,464465,464513,48
Jensen_Eisai_groupB,1,4,ts-global_detected_seizures,464489,464780,291
Jensen_Eisai_groupB,3,6,ts-global_detected_seizures,464533,464566,33
Jensen_Eisai_groupB,3,6,ts-global_detected_seizures,464567,464638,71
Jensen_Eisai_groupB,3,6,ts-global_detected_seizures,464639,464662,23
Jensen_Eisai_groupB,3,6,ts-global_detected_seizures,464663,464753,90
Jensen_Eisai_groupB,3,6,ts-global_detected_seizures,464754,464829,75
Jensen_Eisai_groupB,1,4,ts-global_detected_seizures,464794,465094,300
Jensen_Eisai_groupB,3,6,ts-global_detected_seizures,464830,464876,46
Jensen_Eisai_groupB,2,5,ts-global_detected_seizures,464856,465094,238
Jensen_Eisai_groupB,3,6,ts-global_detected_seizures,464877,464953,76
Jensen_Eisai_groupB,3,6,ts-global_detected_seizures,464954,465094,140
Jensen_Eisai_groupB,3,6,ts-global_detected_seizures,465494,466142,648
Jensen_Eisai_groupB,2,5,ts-global_detected_seizures,465720,465996,276
Jensen_Eisai_groupB,2,5,ts-global_detected_seizures,465997,466337,340
Jensen_Eisai_groupB,1,4,ts-global_detected_seizures,466048,466073,25
Jensen_Eisai_groupB,3,6,ts-global_detected_seizures,466143,474063,7920
Jensen_Eisai_groupB,2,5,ts-global_detected_seizures,466338,466632,294
Jensen_Eisai_groupB,1,4,ts-global_detected_seizures,466341,466372,31
Jensen_Eisai_groupB,1,4,ts-global_detected_seizures,466379,466401,22
Jensen_Eisai_groupB,1,4,ts-global_detected_seizures,466598,466698,100
Jensen_Eisai_groupB,2,5,ts-global_detected_seizures,466633,466782,149
Jensen_Eisai_groupB,1,4,ts-global_detected_seizures,466747,466851,104
Jensen_Eisai_groupB,2,5,ts-global_detected_seizures,466784,467202,418
Jensen_Eisai_groupB,1,4,ts-global_detected_seizures,466965,466993,28
Jensen_Eisai_groupB,1,4,ts-global_detected_seizures,467048,467110,62
Jensen_Eisai_groupB,1,4,ts-global_detected_seizures,467162,467190,28
Jensen_Eisai_groupB,2,5,ts-global_detected_seizures,467203,467711,508
Jensen_Eisai_groupB,1,4,ts-global_detected_seizures,467214,467265,51
Jensen_Eisai_groupB,1,4,ts-global_detected_seizures,467296,467321,25
Jensen_Eisai_groupB,1,4,ts-global_detected_seizures,467336,467371,35
Jensen_Eisai_groupB,1,4,ts-global_detected_seizures,467411,467435,24
Jensen_Eisai_groupB,1,4,ts-global_detected_seizures,467517,467611,94
Jensen_Eisai_groupB,1,4,ts-global_detected_seizures,467705,467729,24
Jensen_Eisai_groupB,2,5,ts-global_detected_seizures,467712,467917,205
Jensen_Eisai_groupB,1,4,ts-global_detected_seizures,467757,467784,27
Jensen_Eisai_groupB,1,4,ts-global_detected_seizures,467785,467813,28
Jensen_Eisai_groupB,1,4,ts-global_detected_seizures,467844,467888,44
Jensen_Eisai_groupB,2,5,ts-global_detected_seizures,467918,468426,508
Jensen_Eisai_groupB,1,4,ts-global_detected_seizures,467943,468027,84
Jensen_Eisai_groupB,1,4,ts-global_detected_seizures,468052,468081,29
Jensen_Eisai_groupB,1,4,ts-global_detected_seizures,468204,468322,118
Jensen_Eisai_groupB,1,4,ts-global_detected_seizures,468376,468400,24
Jensen_Eisai_groupB,1,4,ts-global_detected_seizures,468406,468449,43
Jensen_Eisai_groupB,1,4,ts-global_detected_seizures,468461,468484,23
Jensen_Eisai_groupB,1,4,ts-global_detected_seizures,468486,468517,31
Jensen_Eisai_groupB,1,4,ts-global_detected_seizures,468588,468660,72
Jensen_Eisai_groupB,1,4,ts-global_detected_seizures,468684,468717,33
Jensen_Eisai_groupB,2,5,ts-global_detected_seizures,468706,468734,28
Jensen_Eisai_groupB,1,4,ts-global_detected_seizures,468797,468837,40
Jensen_Eisai_groupB,1,4,ts-global_detected_seizures,468900,468979,79
Jensen_Eisai_groupB,1,4,ts-global_detected_seizures,469024,469049,25
Jensen_Eisai_groupB,2,5,ts-global_detected_seizures,469044,469066,22
Jensen_Eisai_groupB,1,4,ts-global_detected_seizures,469074,469098,24
Jensen_Eisai_groupB,1,4,ts-global_detected_seizures,469099,469129,30
Jensen_Eisai_groupB,1,4,ts-global_detected_seizures,469169,469369,200
Jensen_Eisai_groupB,2,5,ts-global_detected_seizures,469363,469389,26
Jensen_Eisai_groupB,1,4,ts-global_detected_seizures,469370,469418,48
Jensen_Eisai_groupB,1,4,ts-global_detected_seizures,469419,469455,36
Jensen_Eisai_groupB,1,4,ts-global_detected_seizures,469463,469512,49
Jensen_Eisai_groupB,1,4,ts-global_detected_seizures,469553,469594,41
Jensen_Eisai_groupB,1,4,ts-global_detected_seizures,469595,469620,25
Jensen_Eisai_groupB,1,4,ts-global_detected_seizures,469626,469657,31
Jensen_Eisai_groupB,1,4,ts-global_detected_seizures,469706,469899,193
Jensen_Eisai_groupB,2,5,ts-global_detected_seizures,469734,469762,28
Jensen_Eisai_groupB,2,5,ts-global_detected_seizures,469854,469880,26
Jensen_Eisai_groupB,1,4,ts-global_detected_seizures,469900,469923,23
Jensen_Eisai_groupB,1,4,ts-global_detected_seizures,469924,469959,35
Jensen_Eisai_groupB,2,5,ts-global_detected_seizures,469926,469952,26
Jensen_Eisai_groupB,1,4,ts-global_detected_seizures,469999,470076,77
Jensen_Eisai_groupB,2,5,ts-global_detected_seizures,470086,470150,64
Jensen_Eisai_groupB,1,4,ts-global_detected_seizures,470142,470171,29
Jensen_Eisai_groupB,2,5,ts-global_detected_seizures,470228,470252,24
Jensen_Eisai_groupB,1,4,ts-global_detected_seizures,470310,470348,38
Jensen_Eisai_groupB,2,5,ts-global_detected_seizures,470322,470345,23
Jensen_Eisai_groupB,2,5,ts-global_detected_seizures,470383,470407,24
Jensen_Eisai_groupB,1,4,ts-global_detected_seizures,470406,470432,26
Jensen_Eisai_groupB,1,4,ts-global_detected_seizures,470470,470512,42
Jensen_Eisai_groupB,2,5,ts-global_detected_seizures,470516,470548,32
Jensen_Eisai_groupB,1,4,ts-global_detected_seizures,470543,470586,43
Jensen_Eisai_groupB,2,5,ts-global_detected_seizures,470587,470609,22
Jensen_Eisai_groupB,1,4,ts-global_detected_seizures,470635,470671,36
Jensen_Eisai_groupB,2,5,ts-global_detected_seizures,470686,470746,60
Jensen_Eisai_groupB,1,4,ts-global_detected_seizures,470728,470756,28
Jensen_Eisai_groupB,1,4,ts-global_detected_seizures,470802,471213,411
Jensen_Eisai_groupB,2,5,ts-global_detected_seizures,470811,471115,304
Jensen_Eisai_groupB,1,4,ts-global_detected_seizures,471214,471278,64
Jensen_Eisai_groupB,1,4,ts-global_detected_seizures,471279,471366,87
Jensen_Eisai_groupB,1,4,ts-global_detected_seizures,471375,471404,29
Jensen_Eisai_groupB,2,5,ts-global_detected_seizures,471389,471419,30
Jensen_Eisai_groupB,1,4,ts-global_detected_seizures,471435,471479,44
Jensen_Eisai_groupB,2,5,ts-global_detected_seizures,471507,471532,25
Jensen_Eisai_groupB,1,4,ts-global_detected_seizures,471530,471554,24
Jensen_Eisai_groupB,1,4,ts-global_detected_seizures,471556,471582,26
Jensen_Eisai_groupB,2,5,ts-global_detected_seizures,471568,471610,42
Jensen_Eisai_groupB,1,4,ts-global_detected_seizures,471624,471654,30
Jensen_Eisai_groupB,1,4,ts-global_detected_seizures,471681,471741,60
Jensen_Eisai_groupB,2,5,ts-global_detected_seizures,471719,471777,58
Jensen_Eisai_groupB,1,4,ts-global_detected_seizures,471742,471780,38
Jensen_Eisai_groupB,2,5,ts-global_detected_seizures,471788,471819,31
Jensen_Eisai_groupB,1,4,ts-global_detected_seizures,471813,472113,300
Jensen_Eisai_groupB,2,5,ts-global_detected_seizures,471922,471957,35
Jensen_Eisai_groupB,2,5,ts-global_detected_seizures,472001,472032,31
Jensen_Eisai_groupB,1,4,ts-global_detected_seizures,472114,472443,329
Jensen_Eisai_groupB,2,5,ts-global_detected_seizures,472128,472165,37
Jensen_Eisai_groupB,2,5,ts-global_detected_seizures,472234,472694,460
Jensen_Eisai_groupB,1,4,ts-global_detected_seizures,472444,472466,22
Jensen_Eisai_groupB,1,4,ts-global_detected_seizures,472468,472506,38
Jensen_Eisai_groupB,1,4,ts-global_detected_seizures,472522,472573,51
Jensen_Eisai_groupB,1,4,ts-global_detected_seizures,472585,472621,36
Jensen_Eisai_groupB,1,4,ts-global_detected_seizures,472653,472788,135
Jensen_Eisai_groupB,2,5,ts-global_detected_seizures,472695,472783,88
Jensen_Eisai_groupB,2,5,ts-global_detected_seizures,472789,472811,22
Jensen_Eisai_groupB,1,4,ts-global_detected_seizures,472813,472852,39
Jensen_Eisai_groupB,2,5,ts-global_detected_seizures,472825,472852,27
Jensen_Eisai_groupB,2,5,ts-global_detected_seizures,472913,472935,22
Jensen_Eisai_groupB,1,4,ts-global_detected_seizures,472928,473004,76
Jensen_Eisai_groupB,2,5,ts-global_detected_seizures,473167,473199,32
Jensen_Eisai_groupB,2,5,ts-global_detected_seizures,473309,473332,23
Jensen_Eisai_groupB,2,5,ts-global_detected_seizures,473366,473409,43
Jensen_Eisai_groupB,2,5,ts-global_detected_seizures,473430,473452,22
Jensen_Eisai_groupB,2,5,ts-global_detected_seizures,473462,473514,52
Jensen_Eisai_groupB,2,5,ts-global_detected_seizures,473522,474229,707
Jensen_Eisai_groupB,1,4,ts-global_detected_seizures,473617,473648,31
Jensen_Eisai_groupB,1,4,ts-global_detected_seizures,473683,473755,72
Jensen_Eisai_groupB,1,4,ts-global_detected_seizures,473756,473847,91
Jensen_Eisai_groupB,1,4,ts-global_detected_seizures,473848,473878,30
Jensen_Eisai_groupB,1,4,ts-global_detected_seizures,473905,474032,127
Jensen_Eisai_groupB,1,4,ts-global_detected_seizures,474033,474118,85
Jensen_Eisai_groupB,3,6,ts-global_detected_seizures,474088,474151,63
Jensen_Eisai_groupB,1,4,ts-global_detected_seizures,474170,474229,59
Jensen_Eisai_groupB,3,6,ts-global_detected_seizures,474172,474311,139
Jensen_Eisai_groupB,1,4,ts-global_detected_seizures,474241,474280,39
Jensen_Eisai_groupB,2,5,ts-global_detected_seizures,474266,474785,519
Jensen_Eisai_groupB,1,4,ts-global_detected_seizures,474281,484305,10024
Jensen_Eisai_groupB,3,6,ts-global_detected_seizures,474317,474341,24
Jensen_Eisai_groupB,3,6,ts-global_detected_seizures,474390,474416,26
Jensen_Eisai_groupB,3,6,ts-global_detected_seizures,474445,474475,30
Jensen_Eisai_groupB,3,6,ts-global_detected_seizures,474539,474610,71
Jensen_Eisai_groupB,3,6,ts-global_detected_seizures,474618,474641,23
Jensen_Eisai_groupB,3,6,ts-global_detected_seizures,474659,474717,58
Jensen_Eisai_groupB,3,6,ts-global_detected_seizures,474719,474866,147
Jensen_Eisai_groupB,2,5,ts-global_detected_seizures,474786,474823,37
Jensen_Eisai_groupB,2,5,ts-global_detected_seizures,474824,475032,208
Jensen_Eisai_groupB,3,6,ts-global_detected_seizures,474867,474891,24
Jensen_Eisai_groupB,3,6,ts-global_detected_seizures,474916,475023,107
Jensen_Eisai_groupB,3,6,ts-global_detected_seizures,475024,475083,59
Jensen_Eisai_groupB,2,5,ts-global_detected_seizures,475034,475066,32
Jensen_Eisai_groupB,2,5,ts-global_detected_seizures,475067,475100,33
Jensen_Eisai_groupB,3,6,ts-global_detected_seizures,475084,475192,108
Jensen_Eisai_groupB,2,5,ts-global_detected_seizures,475139,475208,69
Jensen_Eisai_groupB,3,6,ts-global_detected_seizures,475193,475285,92
Jensen_Eisai_groupB,2,5,ts-global_detected_seizures,475210,475243,33
Jensen_Eisai_groupB,2,5,ts-global_detected_seizures,475244,475266,22
Jensen_Eisai_groupB,2,5,ts-global_detected_seizures,475269,475303,34
Jensen_Eisai_groupB,3,6,ts-global_detected_seizures,475286,479931,4645
Jensen_Eisai_groupB,2,5,ts-global_detected_seizures,475312,475369,57
Jensen_Eisai_groupB,2,5,ts-global_detected_seizures,475380,475403,23
Jensen_Eisai_groupB,2,5,ts-global_detected_seizures,475566,475593,27
Jensen_Eisai_groupB,2,5,ts-global_detected_seizures,475594,475618,24
Jensen_Eisai_groupB,2,5,ts-global_detected_seizures,475676,475698,22
Jensen_Eisai_groupB,2,5,ts-global_detected_seizures,475923,475945,22
Jensen_Eisai_groupB,2,5,ts-global_detected_seizures,476064,476091,27
Jensen_Eisai_groupB,2,5,ts-global_detected_seizures,476094,476116,22
Jensen_Eisai_groupB,2,5,ts-global_detected_seizures,476269,476318,49
Jensen_Eisai_groupB,2,5,ts-global_detected_seizures,476378,476415,37
Jensen_Eisai_groupB,2,5,ts-global_detected_seizures,476416,476438,22
Jensen_Eisai_groupB,2,5,ts-global_detected_seizures,476469,476498,29
Jensen_Eisai_groupB,2,5,ts-global_detected_seizures,476623,476668,45
Jensen_Eisai_groupB,2,5,ts-global_detected_seizures,476734,476761,27
Jensen_Eisai_groupB,2,5,ts-global_detected_seizures,476901,476932,31
Jensen_Eisai_groupB,2,5,ts-global_detected_seizures,476968,476994,26
Jensen_Eisai_groupB,2,5,ts-global_detected_seizures,476996,477035,39
Jensen_Eisai_groupB,2,5,ts-global_detected_seizures,477036,477067,31
Jensen_Eisai_groupB,2,5,ts-global_detected_seizures,477156,477200,44
Jensen_Eisai_groupB,2,5,ts-global_detected_seizures,477201,477233,32
Jensen_Eisai_groupB,2,5,ts-global_detected_seizures,477235,477299,64
Jensen_Eisai_groupB,2,5,ts-global_detected_seizures,477360,477416,56
Jensen_Eisai_groupB,2,5,ts-global_detected_seizures,477418,477462,44
Jensen_Eisai_groupB,2,5,ts-global_detected_seizures,477470,477494,24
Jensen_Eisai_groupB,2,5,ts-global_detected_seizures,477529,477584,55
Jensen_Eisai_groupB,2,5,ts-global_detected_seizures,477589,477655,66
Jensen_Eisai_groupB,2,5,ts-global_detected_seizures,477675,477720,45
Jensen_Eisai_groupB,2,5,ts-global_detected_seizures,477726,477773,47
Jensen_Eisai_groupB,2,5,ts-global_detected_seizures,477790,477815,25
Jensen_Eisai_groupB,2,5,ts-global_detected_seizures,477816,477843,27
Jensen_Eisai_groupB,2,5,ts-global_detected_seizures,477852,477884,32
Jensen_Eisai_groupB,2,5,ts-global_detected_seizures,477946,477983,37
Jensen_Eisai_groupB,2,5,ts-global_detected_seizures,477984,478074,90
Jensen_Eisai_groupB,2,5,ts-global_detected_seizures,478075,478099,24
Jensen_Eisai_groupB,2,5,ts-global_detected_seizures,478101,478125,24
Jensen_Eisai_groupB,2,5,ts-global_detected_seizures,478127,478175,48
Jensen_Eisai_groupB,2,5,ts-global_detected_seizures,478216,478258,42
Jensen_Eisai_groupB,2,5,ts-global_detected_seizures,478272,478316,44
Jensen_Eisai_groupB,2,5,ts-global_detected_seizures,478327,478363,36
Jensen_Eisai_groupB,2,5,ts-global_detected_seizures,478416,478438,22
Jensen_Eisai_groupB,2,5,ts-global_detected_seizures,478439,478534,95
Jensen_Eisai_groupB,2,5,ts-global_detected_seizures,478646,478706,60
Jensen_Eisai_groupB,2,5,ts-global_detected_seizures,478730,478793,63
Jensen_Eisai_groupB,2,5,ts-global_detected_seizures,478794,478820,26
Jensen_Eisai_groupB,2,5,ts-global_detected_seizures,478821,478909,88
Jensen_Eisai_groupB,2,5,ts-global_detected_seizures,478913,478977,64
Jensen_Eisai_groupB,2,5,ts-global_detected_seizures,478993,479082,89
Jensen_Eisai_groupB,2,5,ts-global_detected_seizures,479097,479231,134
Jensen_Eisai_groupB,2,5,ts-global_detected_seizures,479232,479336,104
Jensen_Eisai_groupB,2,5,ts-global_detected_seizures,479359,479415,56
Jensen_Eisai_groupB,2,5,ts-global_detected_seizures,479424,479503,79
Jensen_Eisai_groupB,2,5,ts-global_detected_seizures,479522,479599,77
Jensen_Eisai_groupB,2,5,ts-global_detected_seizures,479600,479623,23
Jensen_Eisai_groupB,2,5,ts-global_detected_seizures,479652,479696,44
Jensen_Eisai_groupB,2,5,ts-global_detected_seizures,479699,479741,42
Jensen_Eisai_groupB,2,5,ts-global_detected_seizures,479749,479790,41
Jensen_Eisai_groupB,2,5,ts-global_detected_seizures,479791,479850,59
Jensen_Eisai_groupB,2,5,ts-global_detected_seizures,479876,479938,62
Jensen_Eisai_groupB,3,6,ts-global_detected_seizures,479932,518243,38311
Jensen_Eisai_groupB,2,5,ts-global_detected_seizures,479939,480070,131
Jensen_Eisai_groupB,2,5,ts-global_detected_seizures,480441,480463,22
Jensen_Eisai_groupB,2,5,ts-global_detected_seizures,480600,480626,26
Jensen_Eisai_groupB,2,5,ts-global_detected_seizures,481113,481137,24
Jensen_Eisai_groupB,2,5,ts-global_detected_seizures,481165,481533,368
Jensen_Eisai_groupB,2,5,ts-global_detected_seizures,481534,481735,201
Jensen_Eisai_groupB,2,5,ts-global_detected_seizures,481736,481770,34
Jensen_Eisai_groupB,2,5,ts-global_detected_seizures,481771,481978,207
Jensen_Eisai_groupB,2,5,ts-global_detected_seizures,482002,482042,40
Jensen_Eisai_groupB,2,5,ts-global_detected_seizures,482095,482376,281
Jensen_Eisai_groupB,2,5,ts-global_detected_seizures,482377,482698,321
Jensen_Eisai_groupB,2,5,ts-global_detected_seizures,482766,482790,24
Jensen_Eisai_groupB,2,5,ts-global_detected_seizures,483166,483212,46
Jensen_Eisai_groupB,2,5,ts-global_detected_seizures,483437,483478,41
Jensen_Eisai_groupB,2,5,ts-global_detected_seizures,483479,483727,248
Jensen_Eisai_groupB,2,5,ts-global_detected_seizures,484073,484100,27
Jensen_Eisai_groupB,2,5,ts-global_detected_seizures,484234,484266,32
Jensen_Eisai_groupB,2,5,ts-global_detected_seizures,484274,484349,75
Jensen_Eisai_groupB,1,4,ts-global_detected_seizures,484306,486897,2591
Jensen_Eisai_groupB,2,5,ts-global_detected_seizures,484527,484555,28
Jensen_Eisai_groupB,2,5,ts-global_detected_seizures,484906,484965,59
Jensen_Eisai_groupB,2,5,ts-global_detected_seizures,485089,486044,955
Jensen_Eisai_groupB,2,5,ts-global_detected_seizures,486045,486241,196
Jensen_Eisai_groupB,1,4,ts-global_detected_seizures,486898,487193,295
Jensen_Eisai_groupB,2,5,ts-global_detected_seizures,487016,487234,218
Jensen_Eisai_groupB,1,4,ts-global_detected_seizures,487194,488620,1426
Jensen_Eisai_groupB,2,5,ts-global_detected_seizures,487554,487576,22
Jensen_Eisai_groupB,2,5,ts-global_detected_seizures,487709,487742,33
Jensen_Eisai_groupB,2,5,ts-global_detected_seizures,488018,488963,945
Jensen_Eisai_groupB,1,4,ts-global_detected_seizures,488621,493050,4429
Jensen_Eisai_groupB,2,5,ts-global_detected_seizures,488964,489293,329
Jensen_Eisai_groupB,2,5,ts-global_detected_seizures,489294,489910,616
Jensen_Eisai_groupB,2,5,ts-global_detected_seizures,489911,490340,429
Jensen_Eisai_groupB,2,5,ts-global_detected_seizures,490359,490511,152
Jensen_Eisai_groupB,2,5,ts-global_detected_seizures,490512,490751,239
Jensen_Eisai_groupB,2,5,ts-global_detected_seizures,490752,490925,173
Jensen_Eisai_groupB,2,5,ts-global_detected_seizures,490926,491087,161
Jensen_Eisai_groupB,2,5,ts-global_detected_seizures,491088,492073,985
Jensen_Eisai_groupB,2,5,ts-global_detected_seizures,492365,492388,23
Jensen_Eisai_groupB,2,5,ts-global_detected_seizures,492529,492553,24
Jensen_Eisai_groupB,2,5,ts-global_detected_seizures,492765,492787,22
Jensen_Eisai_groupB,2,5,ts-global_detected_seizures,492788,492812,24
Jensen_Eisai_groupB,2,5,ts-global_detected_seizures,492814,492875,61
Jensen_Eisai_groupB,1,4,ts-global_detected_seizures,493052,493123,71
Jensen_Eisai_groupB,2,5,ts-global_detected_seizures,493107,493132,25
Jensen_Eisai_groupB,2,5,ts-global_detected_seizures,493192,493214,22
Jensen_Eisai_groupB,1,4,ts-global_detected_seizures,493215,494206,991
Jensen_Eisai_groupB,2,5,ts-global_detected_seizures,493507,493533,26
Jensen_Eisai_groupB,2,5,ts-global_detected_seizures,493575,493598,23
Jensen_Eisai_groupB,2,5,ts-global_detected_seizures,493824,494148,324
Jensen_Eisai_groupB,2,5,ts-global_detected_seizures,494173,494198,25
Jensen_Eisai_groupB,1,4,ts-global_detected_seizures,494207,496020,1813
Jensen_Eisai_groupB,2,5,ts-global_detected_seizures,494665,494688,23
Jensen_Eisai_groupB,2,5,ts-global_detected_seizures,494705,494736,31
Jensen_Eisai_groupB,2,5,ts-global_detected_seizures,494842,494880,38
Jensen_Eisai_groupB,2,5,ts-global_detected_seizures,494915,494950,35
Jensen_Eisai_groupB,2,5,ts-global_detected_seizures,494988,495585,597
Jensen_Eisai_groupB,2,5,ts-global_detected_seizures,495586,497146,1560
Jensen_Eisai_groupB,1,4,ts-global_detected_seizures,496021,496201,180
Jensen_Eisai_groupB,1,4,ts-global_detected_seizures,496202,496231,29
Jensen_Eisai_groupB,1,4,ts-global_detected_seizures,496232,496659,427
Jensen_Eisai_groupB,1,4,ts-global_detected_seizures,496660,497734,1074
Jensen_Eisai_groupB,2,5,ts-global_detected_seizures,497147,497202,55
Jensen_Eisai_groupB,2,5,ts-global_detected_seizures,497203,498016,813
Jensen_Eisai_groupB,1,4,ts-global_detected_seizures,497735,498349,614
Jensen_Eisai_groupB,2,5,ts-global_detected_seizures,498017,498533,516
Jensen_Eisai_groupB,1,4,ts-global_detected_seizures,498350,498972,622
Jensen_Eisai_groupB,2,5,ts-global_detected_seizures,498534,498676,142
Jensen_Eisai_groupB,2,5,ts-global_detected_seizures,498677,500044,1367
Jensen_Eisai_groupB,1,4,ts-global_detected_seizures,498973,499022,49
Jensen_Eisai_groupB,1,4,ts-global_detected_seizures,499023,499881,858
Jensen_Eisai_groupB,1,4,ts-global_detected_seizures,499882,500309,427
Jensen_Eisai_groupB,2,5,ts-global_detected_seizures,500045,500746,701
Jensen_Eisai_groupB,1,4,ts-global_detected_seizures,500310,501132,822
Jensen_Eisai_groupB,2,5,ts-global_detected_seizures,500747,500851,104
Jensen_Eisai_groupB,2,5,ts-global_detected_seizures,500853,502633,1780
Jensen_Eisai_groupB,1,4,ts-global_detected_seizures,501133,501226,93
Jensen_Eisai_groupB,1,4,ts-global_detected_seizures,501227,502039,812
Jensen_Eisai_groupB,1,4,ts-global_detected_seizures,502040,502825,785
Jensen_Eisai_groupB,2,5,ts-global_detected_seizures,502635,502664,29
Jensen_Eisai_groupB,2,5,ts-global_detected_seizures,502666,502688,22
Jensen_Eisai_groupB,2,5,ts-global_detected_seizures,502692,503081,389
Jensen_Eisai_groupB,1,4,ts-global_detected_seizures,502826,502931,105
Jensen_Eisai_groupB,1,4,ts-global_detected_seizures,502932,502963,31
Jensen_Eisai_groupB,1,4,ts-global_detected_seizures,502964,503415,451
Jensen_Eisai_groupB,2,5,ts-global_detected_seizures,503214,503236,22
Jensen_Eisai_groupB,2,5,ts-global_detected_seizures,503287,503324,37
Jensen_Eisai_groupB,2,5,ts-global_detected_seizures,503359,503397,38
Jensen_Eisai_groupB,1,4,ts-global_detected_seizures,503416,503794,378
Jensen_Eisai_groupB,2,5,ts-global_detected_seizures,503579,503609,30
Jensen_Eisai_groupB,2,5,ts-global_detected_seizures,503674,503777,103
Jensen_Eisai_groupB,1,4,ts-global_detected_seizures,503795,504066,271
Jensen_Eisai_groupB,2,5,ts-global_detected_seizures,503919,503947,28
Jensen_Eisai_groupB,1,4,ts-global_detected_seizures,504067,504883,816
Jensen_Eisai_groupB,2,5,ts-global_detected_seizures,504069,504092,23
Jensen_Eisai_groupB,2,5,ts-global_detected_seizures,504146,504170,24
Jensen_Eisai_groupB,2,5,ts-global_detected_seizures,504228,504263,35
Jensen_Eisai_groupB,2,5,ts-global_detected_seizures,504345,504401,56
Jensen_Eisai_groupB,2,5,ts-global_detected_seizures,504476,504498,22
Jensen_Eisai_groupB,2,5,ts-global_detected_seizures,504529,504559,30
Jensen_Eisai_groupB,2,5,ts-global_detected_seizures,504585,504608,23
Jensen_Eisai_groupB,2,5,ts-global_detected_seizures,504624,504661,37
Jensen_Eisai_groupB,2,5,ts-global_detected_seizures,504749,504778,29
Jensen_Eisai_groupB,1,4,ts-global_detected_seizures,504885,504910,25
Jensen_Eisai_groupB,2,5,ts-global_detected_seizures,504896,504920,24
Jensen_Eisai_groupB,1,4,ts-global_detected_seizures,504936,505012,76
Jensen_Eisai_groupB,2,5,ts-global_detected_seizures,505016,505039,23
Jensen_Eisai_groupB,2,5,ts-global_detected_seizures,505176,505211,35
Jensen_Eisai_groupB,2,5,ts-global_detected_seizures,505338,505436,98
Jensen_Eisai_groupB,2,5,ts-global_detected_seizures,505437,505509,72
Jensen_Eisai_groupB,2,5,ts-global_detected_seizures,505589,505618,29
Jensen_Eisai_groupB,2,5,ts-global_detected_seizures,505632,505688,56
Jensen_Eisai_groupB,1,4,ts-global_detected_seizures,505659,507130,1471
Jensen_Eisai_groupB,2,5,ts-global_detected_seizures,505762,505784,22
Jensen_Eisai_groupB,2,5,ts-global_detected_seizures,505821,505852,31
Jensen_Eisai_groupB,2,5,ts-global_detected_seizures,505881,505921,40
Jensen_Eisai_groupB,2,5,ts-global_detected_seizures,505989,506013,24
Jensen_Eisai_groupB,2,5,ts-global_detected_seizures,506058,506202,144
Jensen_Eisai_groupB,2,5,ts-global_detected_seizures,506218,506249,31
Jensen_Eisai_groupB,2,5,ts-global_detected_seizures,506285,506312,27
Jensen_Eisai_groupB,2,5,ts-global_detected_seizures,506386,506413,27
Jensen_Eisai_groupB,2,5,ts-global_detected_seizures,506521,506545,24
Jensen_Eisai_groupB,2,5,ts-global_detected_seizures,506619,506646,27
Jensen_Eisai_groupB,2,5,ts-global_detected_seizures,506697,506741,44
Jensen_Eisai_groupB,2,5,ts-global_detected_seizures,506752,506778,26
Jensen_Eisai_groupB,2,5,ts-global_detected_seizures,506823,506851,28
Jensen_Eisai_groupB,2,5,ts-global_detected_seizures,506880,506904,24
Jensen_Eisai_groupB,2,5,ts-global_detected_seizures,506938,506963,25
Jensen_Eisai_groupB,2,5,ts-global_detected_seizures,506975,507094,119
Jensen_Eisai_groupB,2,5,ts-global_detected_seizures,507097,507172,75
Jensen_Eisai_groupB,1,4,ts-global_detected_seizures,507131,507187,56
Jensen_Eisai_groupB,1,4,ts-global_detected_seizures,507254,507383,129
Jensen_Eisai_groupB,2,5,ts-global_detected_seizures,507354,507456,102
Jensen_Eisai_groupB,1,4,ts-global_detected_seizures,507567,507590,23
Jensen_Eisai_groupB,2,5,ts-global_detected_seizures,507583,507607,24
Jensen_Eisai_groupB,1,4,ts-global_detected_seizures,507618,507677,59
Jensen_Eisai_groupB,2,5,ts-global_detected_seizures,507659,507700,41
Jensen_Eisai_groupB,2,5,ts-global_detected_seizures,507753,507780,27
Jensen_Eisai_groupB,1,4,ts-global_detected_seizures,507860,507901,41
Jensen_Eisai_groupB,2,5,ts-global_detected_seizures,507862,507885,23
Jensen_Eisai_groupB,2,5,ts-global_detected_seizures,507889,507917,28
Jensen_Eisai_groupB,2,5,ts-global_detected_seizures,507932,507960,28
Jensen_Eisai_groupB,1,4,ts-global_detected_seizures,507940,507992,52
Jensen_Eisai_groupB,2,5,ts-global_detected_seizures,507992,508019,27
Jensen_Eisai_groupB,2,5,ts-global_detected_seizures,508069,508210,141
Jensen_Eisai_groupB,1,4,ts-global_detected_seizures,508127,508155,28
Jensen_Eisai_groupB,2,5,ts-global_detected_seizures,508241,508266,25
Jensen_Eisai_groupB,2,5,ts-global_detected_seizures,508273,508299,26
Jensen_Eisai_groupB,1,4,ts-global_detected_seizures,508346,508402,56
Jensen_Eisai_groupB,2,5,ts-global_detected_seizures,508514,508542,28
Jensen_Eisai_groupB,2,5,ts-global_detected_seizures,508598,509696,1098
Jensen_Eisai_groupB,1,4,ts-global_detected_seizures,508669,508705,36
Jensen_Eisai_groupB,1,4,ts-global_detected_seizures,508785,508866,81
Jensen_Eisai_groupB,1,4,ts-global_detected_seizures,508785,508866,81
Jensen_Eisai_groupB,1,4,ts-global_detected_seizures,508885,508917,32
Jensen_Eisai_groupB,1,4,ts-global_detected_seizures,509025,509049,24
Jensen_Eisai_groupB,1,4,ts-global_detected_seizures,509089,509131,42
Jensen_Eisai_groupB,1,4,ts-global_detected_seizures,509302,509325,23
Jensen_Eisai_groupB,1,4,ts-global_detected_seizures,509495,509549,54
Jensen_Eisai_groupB,1,4,ts-global_detected_seizures,509696,509724,28
Jensen_Eisai_groupB,2,5,ts-global_detected_seizures,509719,509742,23
Jensen_Eisai_groupB,1,4,ts-global_detected_seizures,509795,509849,54
Jensen_Eisai_groupB,2,5,ts-global_detected_seizures,509919,509955,36
Jensen_Eisai_groupB,2,5,ts-global_detected_seizures,510022,510048,26
Jensen_Eisai_groupB,1,4,ts-global_detected_seizures,510041,510078,37
Jensen_Eisai_groupB,1,4,ts-global_detected_seizures,510105,510153,48
Jensen_Eisai_groupB,2,5,ts-global_detected_seizures,510132,510170,38
Jensen_Eisai_groupB,2,5,ts-global_detected_seizures,510171,510296,125
Jensen_Eisai_groupB,1,4,ts-global_detected_seizures,510211,510234,23
Jensen_Eisai_groupB,1,4,ts-global_detected_seizures,510255,510277,22
Jensen_Eisai_groupB,1,4,ts-global_detected_seizures,510303,510344,41
Jensen_Eisai_groupB,2,5,ts-global_detected_seizures,510393,510416,23
Jensen_Eisai_groupB,1,4,ts-global_detected_seizures,510427,510464,37
Jensen_Eisai_groupB,2,5,ts-global_detected_seizures,510445,510473,28
Jensen_Eisai_groupB,1,4,ts-global_detected_seizures,510483,511760,1277
Jensen_Eisai_groupB,2,5,ts-global_detected_seizures,510577,510601,24
Jensen_Eisai_groupB,2,5,ts-global_detected_seizures,510726,510808,82
Jensen_Eisai_groupB,2,5,ts-global_detected_seizures,510809,510850,41
Jensen_Eisai_groupB,2,5,ts-global_detected_seizures,510965,510991,26
Jensen_Eisai_groupB,2,5,ts-global_detected_seizures,511099,511125,26
Jensen_Eisai_groupB,2,5,ts-global_detected_seizures,511250,511279,29
Jensen_Eisai_groupB,2,5,ts-global_detected_seizures,511345,511367,22
Jensen_Eisai_groupB,2,5,ts-global_detected_seizures,511407,511465,58
Jensen_Eisai_groupB,2,5,ts-global_detected_seizures,511521,511546,25
Jensen_Eisai_groupB,2,5,ts-global_detected_seizures,511565,511587,22
Jensen_Eisai_groupB,2,5,ts-global_detected_seizures,511618,511661,43
Jensen_Eisai_groupB,2,5,ts-global_detected_seizures,511741,511845,104
Jensen_Eisai_groupB,1,4,ts-global_detected_seizures,511761,513648,1887
Jensen_Eisai_groupB,2,5,ts-global_detected_seizures,511847,512038,191
Jensen_Eisai_groupB,2,5,ts-global_detected_seizures,512039,512062,23
Jensen_Eisai_groupB,2,5,ts-global_detected_seizures,512063,512086,23
Jensen_Eisai_groupB,2,5,ts-global_detected_seizures,512127,512152,25
Jensen_Eisai_groupB,2,5,ts-global_detected_seizures,512275,512298,23
Jensen_Eisai_groupB,2,5,ts-global_detected_seizures,512460,512489,29
Jensen_Eisai_groupB,2,5,ts-global_detected_seizures,512642,512666,24
Jensen_Eisai_groupB,2,5,ts-global_detected_seizures,512703,512729,26
Jensen_Eisai_groupB,2,5,ts-global_detected_seizures,512814,514296,1482
Jensen_Eisai_groupB,1,4,ts-global_detected_seizures,513663,513685,22
Jensen_Eisai_groupB,1,4,ts-global_detected_seizures,514037,514082,45
Jensen_Eisai_groupB,1,4,ts-global_detected_seizures,514278,517905,3627
Jensen_Eisai_groupB,2,5,ts-global_detected_seizures,514342,514364,22
Jensen_Eisai_groupB,2,5,ts-global_detected_seizures,514494,514521,27
Jensen_Eisai_groupB,2,5,ts-global_detected_seizures,514557,514584,27
Jensen_Eisai_groupB,2,5,ts-global_detected_seizures,514627,514651,24
Jensen_Eisai_groupB,2,5,ts-global_detected_seizures,514715,514748,33
Jensen_Eisai_groupB,2,5,ts-global_detected_seizures,514833,514867,34
Jensen_Eisai_groupB,2,5,ts-global_detected_seizures,514883,514916,33
Jensen_Eisai_groupB,2,5,ts-global_detected_seizures,515012,515045,33
Jensen_Eisai_groupB,2,5,ts-global_detected_seizures,515094,515119,25
Jensen_Eisai_groupB,2,5,ts-global_detected_seizures,515169,518476,3307
Jensen_Eisai_groupB,1,4,ts-global_detected_seizures,517906,517997,91
Jensen_Eisai_groupB,1,4,ts-global_detected_seizures,517998,518100,102
Jensen_Eisai_groupB,1,4,ts-global_detected_seizures,518101,518436,335
Jensen_Eisai_groupB,3,6,ts-global_detected_seizures,518244,518476,232
Jensen_Eisai_groupB,1,4,ts-global_detected_seizures,518450,518476,26
Jensen_Eisai_groupB,3,6,LL-indiv_detected_seizures,39017,39063,46
Jensen_Eisai_groupB,3,6,LL-indiv_detected_seizures,84979,85031,52
Jensen_Eisai_groupB,3,6,LL-indiv_detected_seizures,118555,118602,47
Jensen_Eisai_groupB,3,6,LL-indiv_detected_seizures,166332,166385,53
Jensen_Eisai_groupB,3,6,LL-indiv_detected_seizures,172810,172859,49
Jensen_Eisai_groupB,3,6,LL-indiv_detected_seizures,188180,188214,34
Jensen_Eisai_groupB,3,6,LL-indiv_detected_seizures,432016,432040,24
Jensen_Eisai_groupB,3,6,ts-indiv_detected_seizures,1,39024,39023
Jensen_Eisai_groupB,3,6,ts-indiv_detected_seizures,39062,41770,2708
Jensen_Eisai_groupB,3,6,ts-indiv_detected_seizures,41771,84999,43228
Jensen_Eisai_groupB,3,6,ts-indiv_detected_seizures,85029,86370,1341
Jensen_Eisai_groupB,3,6,ts-indiv_detected_seizures,86910,118569,31659
Jensen_Eisai_groupB,3,6,ts-indiv_detected_seizures,118598,128122,9524
Jensen_Eisai_groupB,3,6,ts-indiv_detected_seizures,128126,166347,38221
Jensen_Eisai_groupB,3,6,ts-indiv_detected_seizures,166380,172823,6443
Jensen_Eisai_groupB,3,6,ts-indiv_detected_seizures,172854,173358,504
Jensen_Eisai_groupB,3,6,ts-indiv_detected_seizures,173783,188188,14405
Jensen_Eisai_groupB,3,6,ts-indiv_detected_seizures,188213,214749,26536
Jensen_Eisai_groupB,3,6,ts-indiv_detected_seizures,214766,259039,44273
Jensen_Eisai_groupB,3,6,ts-indiv_detected_seizures,259508,301724,42216
Jensen_Eisai_groupB,3,6,ts-indiv_detected_seizures,301727,345586,43859
Jensen_Eisai_groupB,3,6,ts-indiv_detected_seizures,345968,387606,41638
Jensen_Eisai_groupB,3,6,ts-indiv_detected_seizures,387626,432082,44456
Jensen_Eisai_groupB,3,6,ts-indiv_detected_seizures,432506,464180,31674
Jensen_Eisai_groupB,3,6,ts-indiv_detected_seizures,464182,464454,272
Jensen_Eisai_groupB,3,6,ts-indiv_detected_seizures,464465,464662,197
Jensen_Eisai_groupB,3,6,ts-indiv_detected_seizures,464663,465094,431
Jensen_Eisai_groupB,3,6,ts-indiv_detected_seizures,465494,474064,8570
Jensen_Eisai_groupB,3,6,ts-indiv_detected_seizures,474087,474511,424
Jensen_Eisai_groupB,3,6,ts-indiv_detected_seizures,474512,518476,43964
Jensen_Eisai_groupB,3,6,LL-global_detected_seizures,39020,39062,42
Jensen_Eisai_groupB,3,6,LL-global_detected_seizures,84987,85011,24
Jensen_Eisai_groupB,3,6,LL-global_detected_seizures,118559,118585,26
Jensen_Eisai_groupB,3,6,LL-global_detected_seizures,166337,166380,43
Jensen_Eisai_groupB,3,6,LL-global_detected_seizures,172813,172855,42
Jensen_Eisai_groupB,3,6,LL-global_detected_seizures,188187,188214,27
Jensen_Eisai_groupB,1,4,LL-global_detected_seizures,405175,405209,34
Jensen_Eisai_groupB,1,4,LL-global_detected_seizures,472882,472919,37
Jensen_Eisai_groupB,1,4,LL-global_detected_seizures,474122,474150,28
Jensen_Eisai_groupB,3,6,Non_Seizures,22586.1,22602.608,16.5080000000016
Jensen_Eisai_groupB,3,6,Non_Seizures,66786.606,66820.68,34.0739999999932
Jensen_Eisai_groupB,3,6,Non_Seizures,275442.381,275464.497,22.11599999998
Jensen_Eisai_groupB,3,6,Non_Seizures,344671.819,344700.549,28.7299999999814
Jensen_Eisai_groupB,3,6,Non_Seizures,441432.492,441467.73,35.2379999999539
Jensen_Eisai_groupB,3,6,True_Seizures,39008.612,39063.663,55.0509999999995
Jensen_Eisai_groupB,3,6,True_Seizures,84978.779,85033.172,54.3930000000109
Jensen_Eisai_groupB,3,6,True_Seizures,118552.33,118601.983,49.6529999999912
Jensen_Eisai_groupB,3,6,True_Seizures,166329.1,166384.707,55.6069999999891
Jensen_Eisai_groupB,3,6,True_Seizures,188181.74,188215.153,33.4130000000005
Jensen_Eisai_groupB,1,4,True_Seizures,405173.419,405210.147,36.7280000000028
Jensen_Eisai_groupB,1,4,True_Seizures,472862.218,472931.458,69.2399999999907
Jensen_Eisai_groupB,1,4,True_Seizures,473102.212,473124.929,22.7170000000042
Jensen_Eisai_groupB,1,4,True_Seizures,474115.969,474154.177,38.2080000000424
Jensen_Eisai_groupC,2,6,ts-global_detected_seizures,1,316,315
Jensen_Eisai_groupC,1,5,ts-global_detected_seizures,93,1990,1897
Jensen_Eisai_groupC,2,6,ts-global_detected_seizures,317,481,164
Jensen_Eisai_groupC,2,6,ts-global_detected_seizures,482,540,58
Jensen_Eisai_groupC,2,6,ts-global_detected_seizures,548,581,33
Jensen_Eisai_groupC,2,6,ts-global_detected_seizures,619,656,37
Jensen_Eisai_groupC,2,6,ts-global_detected_seizures,660,700,40
Jensen_Eisai_groupC,2,6,ts-global_detected_seizures,732,800,68
Jensen_Eisai_groupC,2,6,ts-global_detected_seizures,814,837,23
Jensen_Eisai_groupC,2,6,ts-global_detected_seizures,874,903,29
Jensen_Eisai_groupC,2,6,ts-global_detected_seizures,940,967,27
Jensen_Eisai_groupC,2,6,ts-global_detected_seizures,1301,1325,24
Jensen_Eisai_groupC,2,6,ts-global_detected_seizures,1361,1506,145
Jensen_Eisai_groupC,2,6,ts-global_detected_seizures,1507,1604,97
Jensen_Eisai_groupC,2,6,ts-global_detected_seizures,1605,1634,29
Jensen_Eisai_groupC,2,6,ts-global_detected_seizures,1683,1707,24
Jensen_Eisai_groupC,2,6,ts-global_detected_seizures,1709,1734,25
Jensen_Eisai_groupC,2,6,ts-global_detected_seizures,1778,1800,22
Jensen_Eisai_groupC,2,6,ts-global_detected_seizures,1940,1972,32
Jensen_Eisai_groupC,1,5,ts-global_detected_seizures,1991,2325,334
Jensen_Eisai_groupC,2,6,ts-global_detected_seizures,2009,2082,73
Jensen_Eisai_groupC,2,6,ts-global_detected_seizures,2083,2148,65
Jensen_Eisai_groupC,2,6,ts-global_detected_seizures,2149,2202,53
Jensen_Eisai_groupC,1,5,ts-global_detected_seizures,2326,2499,173
Jensen_Eisai_groupC,2,6,ts-global_detected_seizures,2400,2435,35
Jensen_Eisai_groupC,1,5,ts-global_detected_seizures,2500,3954,1454
Jensen_Eisai_groupC,2,6,ts-global_detected_seizures,2524,2546,22
Jensen_Eisai_groupC,2,6,ts-global_detected_seizures,2573,2626,53
Jensen_Eisai_groupC,2,6,ts-global_detected_seizures,2649,2671,22
Jensen_Eisai_groupC,2,6,ts-global_detected_seizures,2722,2747,25
Jensen_Eisai_groupC,2,6,ts-global_detected_seizures,2877,2915,38
Jensen_Eisai_groupC,2,6,ts-global_detected_seizures,3001,3030,29
Jensen_Eisai_groupC,2,6,ts-global_detected_seizures,3746,3774,28
Jensen_Eisai_groupC,2,6,ts-global_detected_seizures,3775,3824,49
Jensen_Eisai_groupC,1,5,ts-global_detected_seizures,3955,3982,27
Jensen_Eisai_groupC,1,5,ts-global_detected_seizures,3983,4343,360
Jensen_Eisai_groupC,2,6,ts-global_detected_seizures,4155,4202,47
Jensen_Eisai_groupC,1,5,ts-global_detected_seizures,4344,5791,1447
Jensen_Eisai_groupC,2,6,ts-global_detected_seizures,4742,4768,26
Jensen_Eisai_groupC,2,6,ts-global_detected_seizures,4854,4881,27
Jensen_Eisai_groupC,2,6,ts-global_detected_seizures,5195,5219,24
Jensen_Eisai_groupC,2,6,ts-global_detected_seizures,5256,5285,29
Jensen_Eisai_groupC,2,6,ts-global_detected_seizures,5299,5322,23
Jensen_Eisai_groupC,2,6,ts-global_detected_seizures,5372,5395,23
Jensen_Eisai_groupC,2,6,ts-global_detected_seizures,5488,5530,42
Jensen_Eisai_groupC,2,6,ts-global_detected_seizures,5575,5625,50
Jensen_Eisai_groupC,2,6,ts-global_detected_seizures,5631,5670,39
Jensen_Eisai_groupC,2,6,ts-global_detected_seizures,5736,5759,23
Jensen_Eisai_groupC,1,5,ts-global_detected_seizures,5792,5853,61
Jensen_Eisai_groupC,2,6,ts-global_detected_seizures,5798,5869,71
Jensen_Eisai_groupC,1,5,ts-global_detected_seizures,5882,5906,24
Jensen_Eisai_groupC,2,6,ts-global_detected_seizures,5915,5970,55
Jensen_Eisai_groupC,1,5,ts-global_detected_seizures,5927,5951,24
Jensen_Eisai_groupC,1,5,ts-global_detected_seizures,6012,6044,32
Jensen_Eisai_groupC,1,5,ts-global_detected_seizures,6055,6080,25
Jensen_Eisai_groupC,2,6,ts-global_detected_seizures,6070,6093,23
Jensen_Eisai_groupC,2,6,ts-global_detected_seizures,6094,6119,25
Jensen_Eisai_groupC,1,5,ts-global_detected_seizures,6151,6181,30
Jensen_Eisai_groupC,1,5,ts-global_detected_seizures,6354,6463,109
Jensen_Eisai_groupC,1,5,ts-global_detected_seizures,6479,6521,42
Jensen_Eisai_groupC,2,6,ts-global_detected_seizures,6487,6516,29
Jensen_Eisai_groupC,1,5,ts-global_detected_seizures,6532,6664,132
Jensen_Eisai_groupC,2,6,ts-global_detected_seizures,6540,6569,29
Jensen_Eisai_groupC,2,6,ts-global_detected_seizures,6572,6620,48
Jensen_Eisai_groupC,2,6,ts-global_detected_seizures,6656,6694,38
Jensen_Eisai_groupC,1,5,ts-global_detected_seizures,6665,6689,24
Jensen_Eisai_groupC,2,6,ts-global_detected_seizures,6700,6737,37
Jensen_Eisai_groupC,1,5,ts-global_detected_seizures,6733,6764,31
Jensen_Eisai_groupC,1,5,ts-global_detected_seizures,6798,6844,46
Jensen_Eisai_groupC,2,6,ts-global_detected_seizures,6800,6824,24
Jensen_Eisai_groupC,1,5,ts-global_detected_seizures,6914,6941,27
Jensen_Eisai_groupC,2,6,ts-global_detected_seizures,6922,6953,31
Jensen_Eisai_groupC,1,5,ts-global_detected_seizures,6953,6994,41
Jensen_Eisai_groupC,1,5,ts-global_detected_seizures,6995,7033,38
Jensen_Eisai_groupC,2,6,ts-global_detected_seizures,7029,7053,24
Jensen_Eisai_groupC,1,5,ts-global_detected_seizures,7036,7097,61
Jensen_Eisai_groupC,2,6,ts-global_detected_seizures,7101,7124,23
Jensen_Eisai_groupC,1,5,ts-global_detected_seizures,7118,7152,34
Jensen_Eisai_groupC,2,6,ts-global_detected_seizures,7131,7185,54
Jensen_Eisai_groupC,1,5,ts-global_detected_seizures,7153,7206,53
Jensen_Eisai_groupC,2,6,ts-global_detected_seizures,7209,7290,81
Jensen_Eisai_groupC,1,5,ts-global_detected_seizures,7222,7251,29
Jensen_Eisai_groupC,1,5,ts-global_detected_seizures,7282,7452,170
Jensen_Eisai_groupC,2,6,ts-global_detected_seizures,7319,7345,26
Jensen_Eisai_groupC,2,6,ts-global_detected_seizures,7346,7396,50
Jensen_Eisai_groupC,1,5,ts-global_detected_seizures,7470,7507,37
Jensen_Eisai_groupC,1,5,ts-global_detected_seizures,7513,7565,52
Jensen_Eisai_groupC,1,5,ts-global_detected_seizures,7586,7654,68
Jensen_Eisai_groupC,1,5,ts-global_detected_seizures,7655,7688,33
Jensen_Eisai_groupC,2,6,ts-global_detected_seizures,7669,7738,69
Jensen_Eisai_groupC,1,5,ts-global_detected_seizures,7732,7758,26
Jensen_Eisai_groupC,2,6,ts-global_detected_seizures,7739,7771,32
Jensen_Eisai_groupC,2,6,ts-global_detected_seizures,7773,7810,37
Jensen_Eisai_groupC,1,5,ts-global_detected_seizures,7783,7805,22
Jensen_Eisai_groupC,1,5,ts-global_detected_seizures,7806,7829,23
Jensen_Eisai_groupC,1,5,ts-global_detected_seizures,7834,7875,41
Jensen_Eisai_groupC,1,5,ts-global_detected_seizures,7909,7953,44
Jensen_Eisai_groupC,2,6,ts-global_detected_seizures,7914,7951,37
Jensen_Eisai_groupC,1,5,ts-global_detected_seizures,7985,8150,165
Jensen_Eisai_groupC,2,6,ts-global_detected_seizures,7988,8041,53
Jensen_Eisai_groupC,2,6,ts-global_detected_seizures,8154,8365,211
Jensen_Eisai_groupC,1,5,ts-global_detected_seizures,8158,8333,175
Jensen_Eisai_groupC,1,5,ts-global_detected_seizures,8344,8369,25
Jensen_Eisai_groupC,2,6,ts-global_detected_seizures,8367,8397,30
Jensen_Eisai_groupC,1,5,ts-global_detected_seizures,8370,8505,135
Jensen_Eisai_groupC,2,6,ts-global_detected_seizures,8423,8508,85
Jensen_Eisai_groupC,1,5,ts-global_detected_seizures,8506,8574,68
Jensen_Eisai_groupC,2,6,ts-global_detected_seizures,8509,8581,72
Jensen_Eisai_groupC,1,5,ts-global_detected_seizures,8575,8639,64
Jensen_Eisai_groupC,1,5,ts-global_detected_seizures,8655,8723,68
Jensen_Eisai_groupC,2,6,ts-global_detected_seizures,8686,8865,179
Jensen_Eisai_groupC,1,5,ts-global_detected_seizures,8741,8810,69
Jensen_Eisai_groupC,1,5,ts-global_detected_seizures,8823,10192,1369
Jensen_Eisai_groupC,2,6,ts-global_detected_seizures,8866,8907,41
Jensen_Eisai_groupC,2,6,ts-global_detected_seizures,8908,8977,69
Jensen_Eisai_groupC,2,6,ts-global_detected_seizures,9021,9125,104
Jensen_Eisai_groupC,2,6,ts-global_detected_seizures,9143,9172,29
Jensen_Eisai_groupC,2,6,ts-global_detected_seizures,9173,9366,193
Jensen_Eisai_groupC,2,6,ts-global_detected_seizures,9367,9428,61
Jensen_Eisai_groupC,2,6,ts-global_detected_seizures,9429,9452,23
Jensen_Eisai_groupC,2,6,ts-global_detected_seizures,9463,9504,41
Jensen_Eisai_groupC,2,6,ts-global_detected_seizures,9521,9694,173
Jensen_Eisai_groupC,2,6,ts-global_detected_seizures,9695,9761,66
Jensen_Eisai_groupC,2,6,ts-global_detected_seizures,9762,9890,128
Jensen_Eisai_groupC,2,6,ts-global_detected_seizures,9891,9920,29
Jensen_Eisai_groupC,2,6,ts-global_detected_seizures,9978,10048,70
Jensen_Eisai_groupC,2,6,ts-global_detected_seizures,10049,10075,26
Jensen_Eisai_groupC,2,6,ts-global_detected_seizures,10076,10103,27
Jensen_Eisai_groupC,1,5,ts-global_detected_seizures,10193,10571,378
Jensen_Eisai_groupC,2,6,ts-global_detected_seizures,10399,10474,75
Jensen_Eisai_groupC,1,5,ts-global_detected_seizures,10572,10990,418
Jensen_Eisai_groupC,2,6,ts-global_detected_seizures,10581,10604,23
Jensen_Eisai_groupC,2,6,ts-global_detected_seizures,10923,10951,28
Jensen_Eisai_groupC,1,5,ts-global_detected_seizures,10991,11718,727
Jensen_Eisai_groupC,2,6,ts-global_detected_seizures,11129,11181,52
Jensen_Eisai_groupC,2,6,ts-global_detected_seizures,11329,11352,23
Jensen_Eisai_groupC,2,6,ts-global_detected_seizures,11425,11512,87
Jensen_Eisai_groupC,2,6,ts-global_detected_seizures,11539,11574,35
Jensen_Eisai_groupC,2,6,ts-global_detected_seizures,11641,11674,33
Jensen_Eisai_groupC,1,5,ts-global_detected_seizures,11719,11757,38
Jensen_Eisai_groupC,2,6,ts-global_detected_seizures,11738,11772,34
Jensen_Eisai_groupC,1,5,ts-global_detected_seizures,11776,11830,54
Jensen_Eisai_groupC,2,6,ts-global_detected_seizures,11821,11846,25
Jensen_Eisai_groupC,2,6,ts-global_detected_seizures,11927,11953,26
Jensen_Eisai_groupC,1,5,ts-global_detected_seizures,11928,11953,25
Jensen_Eisai_groupC,2,6,ts-global_detected_seizures,12008,12041,33
Jensen_Eisai_groupC,1,5,ts-global_detected_seizures,12105,12189,84
Jensen_Eisai_groupC,2,6,ts-global_detected_seizures,12117,12141,24
Jensen_Eisai_groupC,2,6,ts-global_detected_seizures,12142,12165,23
Jensen_Eisai_groupC,2,6,ts-global_detected_seizures,12188,12238,50
Jensen_Eisai_groupC,1,5,ts-global_detected_seizures,12212,12253,41
Jensen_Eisai_groupC,1,5,ts-global_detected_seizures,12286,12314,28
Jensen_Eisai_groupC,2,6,ts-global_detected_seizures,12297,12328,31
Jensen_Eisai_groupC,2,6,ts-global_detected_seizures,12381,12404,23
Jensen_Eisai_groupC,1,5,ts-global_detected_seizures,12410,12440,30
Jensen_Eisai_groupC,2,6,ts-global_detected_seizures,12427,12463,36
Jensen_Eisai_groupC,1,5,ts-global_detected_seizures,12460,12497,37
Jensen_Eisai_groupC,1,5,ts-global_detected_seizures,12518,12546,28
Jensen_Eisai_groupC,2,6,ts-global_detected_seizures,12519,12634,115
Jensen_Eisai_groupC,1,5,ts-global_detected_seizures,12584,12626,42
Jensen_Eisai_groupC,1,5,ts-global_detected_seizures,12636,12792,156
Jensen_Eisai_groupC,2,6,ts-global_detected_seizures,12637,12678,41
Jensen_Eisai_groupC,2,6,ts-global_detected_seizures,12695,12764,69
Jensen_Eisai_groupC,2,6,ts-global_detected_seizures,12765,12799,34
Jensen_Eisai_groupC,1,5,ts-global_detected_seizures,12793,12978,185
Jensen_Eisai_groupC,2,6,ts-global_detected_seizures,12807,12835,28
Jensen_Eisai_groupC,2,6,ts-global_detected_seizures,12884,12919,35
Jensen_Eisai_groupC,1,5,ts-global_detected_seizures,12999,13027,28
Jensen_Eisai_groupC,1,5,ts-global_detected_seizures,13035,13088,53
Jensen_Eisai_groupC,1,5,ts-global_detected_seizures,13130,13168,38
Jensen_Eisai_groupC,2,6,ts-global_detected_seizures,13139,13161,22
Jensen_Eisai_groupC,1,5,ts-global_detected_seizures,13169,13196,27
Jensen_Eisai_groupC,1,5,ts-global_detected_seizures,13253,13301,48
Jensen_Eisai_groupC,1,5,ts-global_detected_seizures,13330,13433,103
Jensen_Eisai_groupC,2,6,ts-global_detected_seizures,13339,13370,31
Jensen_Eisai_groupC,1,5,ts-global_detected_seizures,13495,13519,24
Jensen_Eisai_groupC,2,6,ts-global_detected_seizures,13496,13527,31
Jensen_Eisai_groupC,1,5,ts-global_detected_seizures,13527,13573,46
Jensen_Eisai_groupC,1,5,ts-global_detected_seizures,13588,13629,41
Jensen_Eisai_groupC,1,5,ts-global_detected_seizures,13701,13925,224
Jensen_Eisai_groupC,2,6,ts-global_detected_seizures,13774,13798,24
Jensen_Eisai_groupC,2,6,ts-global_detected_seizures,13852,13893,41
Jensen_Eisai_groupC,1,5,ts-global_detected_seizures,13926,14011,85
Jensen_Eisai_groupC,1,5,ts-global_detected_seizures,14039,14078,39
Jensen_Eisai_groupC,2,6,ts-global_detected_seizures,14040,14066,26
Jensen_Eisai_groupC,2,6,ts-global_detected_seizures,14128,14157,29
Jensen_Eisai_groupC,1,5,ts-global_detected_seizures,14136,14184,48
Jensen_Eisai_groupC,2,6,ts-global_detected_seizures,14186,14213,27
Jensen_Eisai_groupC,1,5,ts-global_detected_seizures,14237,14267,30
Jensen_Eisai_groupC,2,6,ts-global_detected_seizures,14257,14281,24
Jensen_Eisai_groupC,2,6,ts-global_detected_seizures,14287,14310,23
Jensen_Eisai_groupC,1,5,ts-global_detected_seizures,14370,14423,53
Jensen_Eisai_groupC,1,5,ts-global_detected_seizures,14457,14487,30
Jensen_Eisai_groupC,1,5,ts-global_detected_seizures,14542,14609,67
Jensen_Eisai_groupC,2,6,ts-global_detected_seizures,14554,14581,27
Jensen_Eisai_groupC,2,6,ts-global_detected_seizures,14610,14710,100
Jensen_Eisai_groupC,1,5,ts-global_detected_seizures,14616,14641,25
Jensen_Eisai_groupC,1,5,ts-global_detected_seizures,14702,14735,33
Jensen_Eisai_groupC,1,5,ts-global_detected_seizures,14743,14770,27
Jensen_Eisai_groupC,1,5,ts-global_detected_seizures,14810,14924,114
Jensen_Eisai_groupC,1,5,ts-global_detected_seizures,14939,14974,35
Jensen_Eisai_groupC,2,6,ts-global_detected_seizures,14982,15016,34
Jensen_Eisai_groupC,1,5,ts-global_detected_seizures,14987,15101,114
Jensen_Eisai_groupC,2,6,ts-global_detected_seizures,15081,15113,32
Jensen_Eisai_groupC,1,5,ts-global_detected_seizures,15139,15181,42
Jensen_Eisai_groupC,2,6,ts-global_detected_seizures,15155,15181,26
Jensen_Eisai_groupC,1,5,ts-global_detected_seizures,15183,15225,42
Jensen_Eisai_groupC,2,6,ts-global_detected_seizures,15198,15220,22
Jensen_Eisai_groupC,1,5,ts-global_detected_seizures,15226,15306,80
Jensen_Eisai_groupC,2,6,ts-global_detected_seizures,15289,15321,32
Jensen_Eisai_groupC,1,5,ts-global_detected_seizures,15320,15382,62
Jensen_Eisai_groupC,2,6,ts-global_detected_seizures,15405,15428,23
Jensen_Eisai_groupC,1,5,ts-global_detected_seizures,15411,15485,74
Jensen_Eisai_groupC,2,6,ts-global_detected_seizures,15459,15518,59
Jensen_Eisai_groupC,1,5,ts-global_detected_seizures,15498,15554,56
Jensen_Eisai_groupC,2,6,ts-global_detected_seizures,15552,15575,23
Jensen_Eisai_groupC,1,5,ts-global_detected_seizures,15561,15587,26
Jensen_Eisai_groupC,2,6,ts-global_detected_seizures,15576,15678,102
Jensen_Eisai_groupC,1,5,ts-global_detected_seizures,15608,15642,34
Jensen_Eisai_groupC,1,5,ts-global_detected_seizures,15648,15675,27
Jensen_Eisai_groupC,1,5,ts-global_detected_seizures,15684,15707,23
Jensen_Eisai_groupC,1,5,ts-global_detected_seizures,15728,15812,84
Jensen_Eisai_groupC,2,6,ts-global_detected_seizures,15791,15814,23
Jensen_Eisai_groupC,1,5,ts-global_detected_seizures,15813,15843,30
Jensen_Eisai_groupC,2,6,ts-global_detected_seizures,15838,15869,31
Jensen_Eisai_groupC,2,6,ts-global_detected_seizures,15838,15869,31
Jensen_Eisai_groupC,1,5,ts-global_detected_seizures,15861,15935,74
Jensen_Eisai_groupC,2,6,ts-global_detected_seizures,15874,15901,27
Jensen_Eisai_groupC,1,5,ts-global_detected_seizures,15936,16054,118
Jensen_Eisai_groupC,2,6,ts-global_detected_seizures,15981,16009,28
Jensen_Eisai_groupC,2,6,ts-global_detected_seizures,16044,16066,22
Jensen_Eisai_groupC,1,5,ts-global_detected_seizures,16072,16106,34
Jensen_Eisai_groupC,2,6,ts-global_detected_seizures,16138,16180,42
Jensen_Eisai_groupC,1,5,ts-global_detected_seizures,16144,16254,110
Jensen_Eisai_groupC,2,6,ts-global_detected_seizures,16257,16280,23
Jensen_Eisai_groupC,1,5,ts-global_detected_seizures,16266,16288,22
Jensen_Eisai_groupC,1,5,ts-global_detected_seizures,16294,16326,32
Jensen_Eisai_groupC,2,6,ts-global_detected_seizures,16321,16466,145
Jensen_Eisai_groupC,1,5,ts-global_detected_seizures,16334,16360,26
Jensen_Eisai_groupC,1,5,ts-global_detected_seizures,16361,16451,90
Jensen_Eisai_groupC,1,5,ts-global_detected_seizures,16452,16482,30
Jensen_Eisai_groupC,2,6,ts-global_detected_seizures,16467,16554,87
Jensen_Eisai_groupC,1,5,ts-global_detected_seizures,16483,16631,148
Jensen_Eisai_groupC,2,6,ts-global_detected_seizures,16571,16662,91
Jensen_Eisai_groupC,1,5,ts-global_detected_seizures,16632,16688,56
Jensen_Eisai_groupC,2,6,ts-global_detected_seizures,16663,16839,176
Jensen_Eisai_groupC,1,5,ts-global_detected_seizures,16701,16751,50
Jensen_Eisai_groupC,1,5,ts-global_detected_seizures,16775,16862,87
Jensen_Eisai_groupC,2,6,ts-global_detected_seizures,16840,16971,131
Jensen_Eisai_groupC,1,5,ts-global_detected_seizures,16902,17254,352
Jensen_Eisai_groupC,2,6,ts-global_detected_seizures,16972,17033,61
Jensen_Eisai_groupC,2,6,ts-global_detected_seizures,17051,17080,29
Jensen_Eisai_groupC,2,6,ts-global_detected_seizures,17106,17208,102
Jensen_Eisai_groupC,2,6,ts-global_detected_seizures,17209,17237,28
Jensen_Eisai_groupC,2,6,ts-global_detected_seizures,17238,17404,166
Jensen_Eisai_groupC,1,5,ts-global_detected_seizures,17262,17289,27
Jensen_Eisai_groupC,1,5,ts-global_detected_seizures,17339,17384,45
Jensen_Eisai_groupC,2,6,ts-global_detected_seizures,17405,17436,31
Jensen_Eisai_groupC,2,6,ts-global_detected_seizures,17437,17459,22
Jensen_Eisai_groupC,2,6,ts-global_detected_seizures,17460,17488,28
Jensen_Eisai_groupC,1,5,ts-global_detected_seizures,17504,17599,95
Jensen_Eisai_groupC,2,6,ts-global_detected_seizures,17509,17536,27
Jensen_Eisai_groupC,2,6,ts-global_detected_seizures,17560,17653,93
Jensen_Eisai_groupC,1,5,ts-global_detected_seizures,17625,17659,34
Jensen_Eisai_groupC,2,6,ts-global_detected_seizures,17654,17745,91
Jensen_Eisai_groupC,1,5,ts-global_detected_seizures,17672,17720,48
Jensen_Eisai_groupC,1,5,ts-global_detected_seizures,17731,17856,125
Jensen_Eisai_groupC,2,6,ts-global_detected_seizures,17747,17771,24
Jensen_Eisai_groupC,2,6,ts-global_detected_seizures,17772,18007,235
Jensen_Eisai_groupC,1,5,ts-global_detected_seizures,17857,17918,61
Jensen_Eisai_groupC,1,5,ts-global_detected_seizures,17926,18001,75
Jensen_Eisai_groupC,2,6,ts-global_detected_seizures,18008,18069,61
Jensen_Eisai_groupC,1,5,ts-global_detected_seizures,18026,18068,42
Jensen_Eisai_groupC,1,5,ts-global_detected_seizures,18069,18102,33
Jensen_Eisai_groupC,2,6,ts-global_detected_seizures,18071,18141,70
Jensen_Eisai_groupC,1,5,ts-global_detected_seizures,18106,18136,30
Jensen_Eisai_groupC,2,6,ts-global_detected_seizures,18142,18270,128
Jensen_Eisai_groupC,1,5,ts-global_detected_seizures,18160,18188,28
Jensen_Eisai_groupC,1,5,ts-global_detected_seizures,18232,18279,47
Jensen_Eisai_groupC,2,6,ts-global_detected_seizures,18271,18349,78
Jensen_Eisai_groupC,1,5,ts-global_detected_seizures,18306,18376,70
Jensen_Eisai_groupC,2,6,ts-global_detected_seizures,18350,18564,214
Jensen_Eisai_groupC,1,5,ts-global_detected_seizures,18377,18838,461
Jensen_Eisai_groupC,2,6,ts-global_detected_seizures,18565,18787,222
Jensen_Eisai_groupC,2,6,ts-global_detected_seizures,18805,18852,47
Jensen_Eisai_groupC,2,6,ts-global_detected_seizures,18853,19190,337
Jensen_Eisai_groupC,1,5,ts-global_detected_seizures,18864,18896,32
Jensen_Eisai_groupC,1,5,ts-global_detected_seizures,18926,18981,55
Jensen_Eisai_groupC,1,5,ts-global_detected_seizures,19012,19142,130
Jensen_Eisai_groupC,1,5,ts-global_detected_seizures,19150,19190,40
Jensen_Eisai_groupC,2,6,ts-global_detected_seizures,19193,19219,26
Jensen_Eisai_groupC,1,5,ts-global_detected_seizures,19199,19224,25
Jensen_Eisai_groupC,2,6,ts-global_detected_seizures,19221,19399,178
Jensen_Eisai_groupC,1,5,ts-global_detected_seizures,19232,19259,27
Jensen_Eisai_groupC,1,5,ts-global_detected_seizures,19297,19360,63
Jensen_Eisai_groupC,1,5,ts-global_detected_seizures,19370,19419,49
Jensen_Eisai_groupC,2,6,ts-global_detected_seizures,19400,19468,68
Jensen_Eisai_groupC,1,5,ts-global_detected_seizures,19420,19478,58
Jensen_Eisai_groupC,2,6,ts-global_detected_seizures,19469,19635,166
Jensen_Eisai_groupC,1,5,ts-global_detected_seizures,19492,19601,109
Jensen_Eisai_groupC,2,6,ts-global_detected_seizures,19641,19720,79
Jensen_Eisai_groupC,1,5,ts-global_detected_seizures,19657,19706,49
Jensen_Eisai_groupC,1,5,ts-global_detected_seizures,19724,19813,89
Jensen_Eisai_groupC,1,5,ts-global_detected_seizures,19828,19897,69
Jensen_Eisai_groupC,1,5,ts-global_detected_seizures,19903,19942,39
Jensen_Eisai_groupC,1,5,ts-global_detected_seizures,19960,20051,91
Jensen_Eisai_groupC,1,5,ts-global_detected_seizures,20052,20184,132
Jensen_Eisai_groupC,2,6,ts-global_detected_seizures,20078,20144,66
Jensen_Eisai_groupC,1,5,ts-global_detected_seizures,20189,20367,178
Jensen_Eisai_groupC,2,6,ts-global_detected_seizures,20324,20352,28
Jensen_Eisai_groupC,1,5,ts-global_detected_seizures,20368,20415,47
Jensen_Eisai_groupC,2,6,ts-global_detected_seizures,20420,20443,23
Jensen_Eisai_groupC,1,5,ts-global_detected_seizures,20425,20471,46
Jensen_Eisai_groupC,1,5,ts-global_detected_seizures,20474,20540,66
Jensen_Eisai_groupC,2,6,ts-global_detected_seizures,20500,20525,25
Jensen_Eisai_groupC,1,5,ts-global_detected_seizures,20578,20628,50
Jensen_Eisai_groupC,1,5,ts-global_detected_seizures,20636,20705,69
Jensen_Eisai_groupC,2,6,ts-global_detected_seizures,20670,20694,24
Jensen_Eisai_groupC,1,5,ts-global_detected_seizures,20720,20759,39
Jensen_Eisai_groupC,2,6,ts-global_detected_seizures,20743,20788,45
Jensen_Eisai_groupC,1,5,ts-global_detected_seizures,20788,20816,28
Jensen_Eisai_groupC,2,6,ts-global_detected_seizures,20813,20856,43
Jensen_Eisai_groupC,1,5,ts-global_detected_seizures,20835,20865,30
Jensen_Eisai_groupC,1,5,ts-global_detected_seizures,20878,20913,35
Jensen_Eisai_groupC,1,5,ts-global_detected_seizures,20915,20938,23
Jensen_Eisai_groupC,1,5,ts-global_detected_seizures,20946,20974,28
Jensen_Eisai_groupC,1,5,ts-global_detected_seizures,20994,21020,26
Jensen_Eisai_groupC,1,5,ts-global_detected_seizures,21033,21060,27
Jensen_Eisai_groupC,1,5,ts-global_detected_seizures,21072,21127,55
Jensen_Eisai_groupC,2,6,ts-global_detected_seizures,21093,21121,28
Jensen_Eisai_groupC,1,5,ts-global_detected_seizures,21132,21154,22
Jensen_Eisai_groupC,1,5,ts-global_detected_seizures,21155,21223,68
Jensen_Eisai_groupC,2,6,ts-global_detected_seizures,21192,21219,27
Jensen_Eisai_groupC,1,5,ts-global_detected_seizures,21224,21286,62
Jensen_Eisai_groupC,2,6,ts-global_detected_seizures,21281,21303,22
Jensen_Eisai_groupC,1,5,ts-global_detected_seizures,21292,21329,37
Jensen_Eisai_groupC,2,6,ts-global_detected_seizures,21306,21334,28
Jensen_Eisai_groupC,2,6,ts-global_detected_seizures,21361,21391,30
Jensen_Eisai_groupC,1,5,ts-global_detected_seizures,21362,21431,69
Jensen_Eisai_groupC,1,5,ts-global_detected_seizures,21432,21517,85
Jensen_Eisai_groupC,2,6,ts-global_detected_seizures,21449,21631,182
Jensen_Eisai_groupC,1,5,ts-global_detected_seizures,21545,21579,34
Jensen_Eisai_groupC,1,5,ts-global_detected_seizures,21605,22057,452
Jensen_Eisai_groupC,2,6,ts-global_detected_seizures,21685,21717,32
Jensen_Eisai_groupC,2,6,ts-global_detected_seizures,21766,21790,24
Jensen_Eisai_groupC,2,6,ts-global_detected_seizures,21901,21930,29
Jensen_Eisai_groupC,2,6,ts-global_detected_seizures,21939,21983,44
Jensen_Eisai_groupC,1,5,ts-global_detected_seizures,22066,22113,47
Jensen_Eisai_groupC,2,6,ts-global_detected_seizures,22093,22116,23
Jensen_Eisai_groupC,1,5,ts-global_detected_seizures,22114,22196,82
Jensen_Eisai_groupC,2,6,ts-global_detected_seizures,22126,22174,48
Jensen_Eisai_groupC,1,5,ts-global_detected_seizures,22218,22339,121
Jensen_Eisai_groupC,2,6,ts-global_detected_seizures,22233,22274,41
Jensen_Eisai_groupC,1,5,ts-global_detected_seizures,22349,22382,33
Jensen_Eisai_groupC,2,6,ts-global_detected_seizures,22357,22388,31
Jensen_Eisai_groupC,1,5,ts-global_detected_seizures,22394,22502,108
Jensen_Eisai_groupC,2,6,ts-global_detected_seizures,22402,22439,37
Jensen_Eisai_groupC,2,6,ts-global_detected_seizures,22494,22588,94
Jensen_Eisai_groupC,1,5,ts-global_detected_seizures,22505,22556,51
Jensen_Eisai_groupC,1,5,ts-global_detected_seizures,22591,22663,72
Jensen_Eisai_groupC,1,5,ts-global_detected_seizures,22677,22750,73
Jensen_Eisai_groupC,2,6,ts-global_detected_seizures,22698,22726,28
Jensen_Eisai_groupC,1,5,ts-global_detected_seizures,22767,22812,45
Jensen_Eisai_groupC,1,5,ts-global_detected_seizures,22832,22922,90
Jensen_Eisai_groupC,2,6,ts-global_detected_seizures,22869,22903,34
Jensen_Eisai_groupC,1,5,ts-global_detected_seizures,22928,23002,74
Jensen_Eisai_groupC,1,5,ts-global_detected_seizures,23003,23033,30
Jensen_Eisai_groupC,2,6,ts-global_detected_seizures,23004,23031,27
Jensen_Eisai_groupC,2,6,ts-global_detected_seizures,23041,23067,26
Jensen_Eisai_groupC,1,5,ts-global_detected_seizures,23060,23118,58
Jensen_Eisai_groupC,1,5,ts-global_detected_seizures,23121,23167,46
Jensen_Eisai_groupC,2,6,ts-global_detected_seizures,23176,23228,52
Jensen_Eisai_groupC,1,5,ts-global_detected_seizures,23196,23258,62
Jensen_Eisai_groupC,1,5,ts-global_detected_seizures,23279,23304,25
Jensen_Eisai_groupC,1,5,ts-global_detected_seizures,23321,23416,95
Jensen_Eisai_groupC,2,6,ts-global_detected_seizures,23384,23409,25
Jensen_Eisai_groupC,1,5,ts-global_detected_seizures,23418,23447,29
Jensen_Eisai_groupC,1,5,ts-global_detected_seizures,23448,23471,23
Jensen_Eisai_groupC,1,5,ts-global_detected_seizures,23474,23579,105
Jensen_Eisai_groupC,2,6,ts-global_detected_seizures,23497,23522,25
Jensen_Eisai_groupC,2,6,ts-global_detected_seizures,23555,23603,48
Jensen_Eisai_groupC,1,5,ts-global_detected_seizures,23580,23700,120
Jensen_Eisai_groupC,2,6,ts-global_detected_seizures,23665,23719,54
Jensen_Eisai_groupC,1,5,ts-global_detected_seizures,23727,25600,1873
Jensen_Eisai_groupC,2,6,ts-global_detected_seizures,23837,23974,137
Jensen_Eisai_groupC,2,6,ts-global_detected_seizures,24037,24065,28
Jensen_Eisai_groupC,2,6,ts-global_detected_seizures,24116,24139,23
Jensen_Eisai_groupC,2,6,ts-global_detected_seizures,24140,24169,29
Jensen_Eisai_groupC,2,6,ts-global_detected_seizures,24197,24222,25
Jensen_Eisai_groupC,2,6,ts-global_detected_seizures,24328,24376,48
Jensen_Eisai_groupC,2,6,ts-global_detected_seizures,24382,24409,27
Jensen_Eisai_groupC,2,6,ts-global_detected_seizures,24428,24463,35
Jensen_Eisai_groupC,2,6,ts-global_detected_seizures,24504,24545,41
Jensen_Eisai_groupC,2,6,ts-global_detected_seizures,24673,24772,99
Jensen_Eisai_groupC,2,6,ts-global_detected_seizures,24787,24876,89
Jensen_Eisai_groupC,2,6,ts-global_detected_seizures,24894,24917,23
Jensen_Eisai_groupC,2,6,ts-global_detected_seizures,25004,25031,27
Jensen_Eisai_groupC,2,6,ts-global_detected_seizures,25080,25106,26
Jensen_Eisai_groupC,2,6,ts-global_detected_seizures,25124,25146,22
Jensen_Eisai_groupC,2,6,ts-global_detected_seizures,25186,25254,68
Jensen_Eisai_groupC,2,6,ts-global_detected_seizures,25255,25290,35
Jensen_Eisai_groupC,2,6,ts-global_detected_seizures,25319,25365,46
Jensen_Eisai_groupC,2,6,ts-global_detected_seizures,25388,25417,29
Jensen_Eisai_groupC,2,6,ts-global_detected_seizures,25455,25485,30
Jensen_Eisai_groupC,2,6,ts-global_detected_seizures,25510,25546,36
Jensen_Eisai_groupC,2,6,ts-global_detected_seizures,25585,25627,42
Jensen_Eisai_groupC,1,5,ts-global_detected_seizures,25601,25705,104
Jensen_Eisai_groupC,2,6,ts-global_detected_seizures,25648,25679,31
Jensen_Eisai_groupC,2,6,ts-global_detected_seizures,25687,25712,25
Jensen_Eisai_groupC,1,5,ts-global_detected_seizures,25706,25760,54
Jensen_Eisai_groupC,2,6,ts-global_detected_seizures,25736,25774,38
Jensen_Eisai_groupC,2,6,ts-global_detected_seizures,25775,25799,24
Jensen_Eisai_groupC,1,5,ts-global_detected_seizures,25797,25821,24
Jensen_Eisai_groupC,2,6,ts-global_detected_seizures,25821,25889,68
Jensen_Eisai_groupC,1,5,ts-global_detected_seizures,25822,25845,23
Jensen_Eisai_groupC,1,5,ts-global_detected_seizures,25888,25931,43
Jensen_Eisai_groupC,2,6,ts-global_detected_seizures,25894,25946,52
Jensen_Eisai_groupC,1,5,ts-global_detected_seizures,25937,26005,68
Jensen_Eisai_groupC,2,6,ts-global_detected_seizures,25955,25981,26
Jensen_Eisai_groupC,2,6,ts-global_detected_seizures,25982,26043,61
Jensen_Eisai_groupC,1,5,ts-global_detected_seizures,26006,26076,70
Jensen_Eisai_groupC,1,5,ts-global_detected_seizures,26114,26413,299
Jensen_Eisai_groupC,2,6,ts-global_detected_seizures,26119,26145,26
Jensen_Eisai_groupC,2,6,ts-global_detected_seizures,26162,26185,23
Jensen_Eisai_groupC,2,6,ts-global_detected_seizures,26218,26271,53
Jensen_Eisai_groupC,2,6,ts-global_detected_seizures,26339,26362,23
Jensen_Eisai_groupC,2,6,ts-global_detected_seizures,26388,26504,116
Jensen_Eisai_groupC,1,5,ts-global_detected_seizures,26414,26522,108
Jensen_Eisai_groupC,1,5,ts-global_detected_seizures,26531,26555,24
Jensen_Eisai_groupC,2,6,ts-global_detected_seizures,26548,26578,30
Jensen_Eisai_groupC,1,5,ts-global_detected_seizures,26618,26657,39
Jensen_Eisai_groupC,2,6,ts-global_detected_seizures,26620,26647,27
Jensen_Eisai_groupC,2,6,ts-global_detected_seizures,26707,26732,25
Jensen_Eisai_groupC,1,5,ts-global_detected_seizures,26713,26771,58
Jensen_Eisai_groupC,1,5,ts-global_detected_seizures,26789,26811,22
Jensen_Eisai_groupC,2,6,ts-global_detected_seizures,26830,26853,23
Jensen_Eisai_groupC,1,5,ts-global_detected_seizures,26847,26877,30
Jensen_Eisai_groupC,1,5,ts-global_detected_seizures,26895,27012,117
Jensen_Eisai_groupC,2,6,ts-global_detected_seizures,26915,26956,41
Jensen_Eisai_groupC,2,6,ts-global_detected_seizures,26962,26984,22
Jensen_Eisai_groupC,1,5,ts-global_detected_seizures,27042,27111,69
Jensen_Eisai_groupC,2,6,ts-global_detected_seizures,27052,27084,32
Jensen_Eisai_groupC,1,5,ts-global_detected_seizures,27112,27157,45
Jensen_Eisai_groupC,2,6,ts-global_detected_seizures,27142,27170,28
Jensen_Eisai_groupC,2,6,ts-global_detected_seizures,27187,27255,68
Jensen_Eisai_groupC,1,5,ts-global_detected_seizures,27215,27374,159
Jensen_Eisai_groupC,2,6,ts-global_detected_seizures,27311,27464,153
Jensen_Eisai_groupC,1,5,ts-global_detected_seizures,27432,27468,36
Jensen_Eisai_groupC,1,5,ts-global_detected_seizures,27481,27507,26
Jensen_Eisai_groupC,2,6,ts-global_detected_seizures,27493,27520,27
Jensen_Eisai_groupC,1,5,ts-global_detected_seizures,27526,27555,29
Jensen_Eisai_groupC,1,5,ts-global_detected_seizures,27570,27669,99
Jensen_Eisai_groupC,2,6,ts-global_detected_seizures,27649,27673,24
Jensen_Eisai_groupC,1,5,ts-global_detected_seizures,27684,27720,36
Jensen_Eisai_groupC,1,5,ts-global_detected_seizures,27721,27759,38
Jensen_Eisai_groupC,2,6,ts-global_detected_seizures,27805,27830,25
Jensen_Eisai_groupC,1,5,ts-global_detected_seizures,27811,27963,152
Jensen_Eisai_groupC,2,6,ts-global_detected_seizures,27849,27873,24
Jensen_Eisai_groupC,2,6,ts-global_detected_seizures,27925,27961,36
Jensen_Eisai_groupC,2,6,ts-global_detected_seizures,27965,27989,24
Jensen_Eisai_groupC,1,5,ts-global_detected_seizures,28000,28065,65
Jensen_Eisai_groupC,2,6,ts-global_detected_seizures,28036,28081,45
Jensen_Eisai_groupC,1,5,ts-global_detected_seizures,28092,28173,81
Jensen_Eisai_groupC,2,6,ts-global_detected_seizures,28100,28127,27
Jensen_Eisai_groupC,2,6,ts-global_detected_seizures,28142,28208,66
Jensen_Eisai_groupC,1,5,ts-global_detected_seizures,28175,28271,96
Jensen_Eisai_groupC,2,6,ts-global_detected_seizures,28227,28255,28
Jensen_Eisai_groupC,1,5,ts-global_detected_seizures,28272,28337,65
Jensen_Eisai_groupC,2,6,ts-global_detected_seizures,28328,28369,41
Jensen_Eisai_groupC,1,5,ts-global_detected_seizures,28346,28415,69
Jensen_Eisai_groupC,1,5,ts-global_detected_seizures,28416,28455,39
Jensen_Eisai_groupC,2,6,ts-global_detected_seizures,28435,28472,37
Jensen_Eisai_groupC,1,5,ts-global_detected_seizures,28479,28654,175
Jensen_Eisai_groupC,2,6,ts-global_detected_seizures,28524,28558,34
Jensen_Eisai_groupC,2,6,ts-global_detected_seizures,28597,28650,53
Jensen_Eisai_groupC,1,5,ts-global_detected_seizures,28666,28702,36
Jensen_Eisai_groupC,2,6,ts-global_detected_seizures,28698,28973,275
Jensen_Eisai_groupC,1,5,ts-global_detected_seizures,28703,28737,34
Jensen_Eisai_groupC,1,5,ts-global_detected_seizures,28801,28896,95
Jensen_Eisai_groupC,1,5,ts-global_detected_seizures,28897,28937,40
Jensen_Eisai_groupC,2,6,ts-global_detected_seizures,28975,29002,27
Jensen_Eisai_groupC,1,5,ts-global_detected_seizures,28984,29029,45
Jensen_Eisai_groupC,2,6,ts-global_detected_seizures,29004,29046,42
Jensen_Eisai_groupC,2,6,ts-global_detected_seizures,29053,29079,26
Jensen_Eisai_groupC,2,6,ts-global_detected_seizures,29115,29150,35
Jensen_Eisai_groupC,1,5,ts-global_detected_seizures,29117,29178,61
Jensen_Eisai_groupC,1,5,ts-global_detected_seizures,29206,29269,63
Jensen_Eisai_groupC,2,6,ts-global_detected_seizures,29252,29303,51
Jensen_Eisai_groupC,1,5,ts-global_detected_seizures,29287,29789,502
Jensen_Eisai_groupC,2,6,ts-global_detected_seizures,29382,29592,210
Jensen_Eisai_groupC,2,6,ts-global_detected_seizures,29593,29690,97
Jensen_Eisai_groupC,2,6,ts-global_detected_seizures,29721,29748,27
Jensen_Eisai_groupC,1,5,ts-global_detected_seizures,29793,29831,38
Jensen_Eisai_groupC,1,5,ts-global_detected_seizures,29836,29867,31
Jensen_Eisai_groupC,2,6,ts-global_detected_seizures,29855,29886,31
Jensen_Eisai_groupC,1,5,ts-global_detected_seizures,29868,29891,23
Jensen_Eisai_groupC,1,5,ts-global_detected_seizures,29892,29917,25
Jensen_Eisai_groupC,2,6,ts-global_detected_seizures,29940,30738,798
Jensen_Eisai_groupC,1,5,ts-global_detected_seizures,29985,30048,63
Jensen_Eisai_groupC,1,5,ts-global_detected_seizures,30068,30192,124
Jensen_Eisai_groupC,1,5,ts-global_detected_seizures,30205,30233,28
Jensen_Eisai_groupC,1,5,ts-global_detected_seizures,30234,30268,34
Jensen_Eisai_groupC,1,5,ts-global_detected_seizures,30307,30355,48
Jensen_Eisai_groupC,1,5,ts-global_detected_seizures,30382,30409,27
Jensen_Eisai_groupC,1,5,ts-global_detected_seizures,30415,30455,40
Jensen_Eisai_groupC,1,5,ts-global_detected_seizures,30514,30596,82
Jensen_Eisai_groupC,1,5,ts-global_detected_seizures,30597,30619,22
Jensen_Eisai_groupC,1,5,ts-global_detected_seizures,30628,30765,137
Jensen_Eisai_groupC,1,5,ts-global_detected_seizures,30767,30839,72
Jensen_Eisai_groupC,2,6,ts-global_detected_seizures,30805,30839,34
Jensen_Eisai_groupC,1,5,ts-global_detected_seizures,30856,30880,24
Jensen_Eisai_groupC,1,5,ts-global_detected_seizures,30916,30949,33
Jensen_Eisai_groupC,2,6,ts-global_detected_seizures,30923,30945,22
Jensen_Eisai_groupC,1,5,ts-global_detected_seizures,30965,31066,101
Jensen_Eisai_groupC,2,6,ts-global_detected_seizures,30968,30995,27
Jensen_Eisai_groupC,2,6,ts-global_detected_seizures,31026,31059,33
Jensen_Eisai_groupC,1,5,ts-global_detected_seizures,31089,31197,108
Jensen_Eisai_groupC,2,6,ts-global_detected_seizures,31126,31161,35
Jensen_Eisai_groupC,1,5,ts-global_detected_seizures,31206,31239,33
Jensen_Eisai_groupC,1,5,ts-global_detected_seizures,31282,31320,38
Jensen_Eisai_groupC,2,6,ts-global_detected_seizures,31330,31354,24
Jensen_Eisai_groupC,1,5,ts-global_detected_seizures,31335,31481,146
Jensen_Eisai_groupC,2,6,ts-global_detected_seizures,31362,31409,47
Jensen_Eisai_groupC,1,5,ts-global_detected_seizures,31482,31553,71
Jensen_Eisai_groupC,1,5,ts-global_detected_seizures,31554,31656,102
Jensen_Eisai_groupC,1,5,ts-global_detected_seizures,31658,31716,58
Jensen_Eisai_groupC,2,6,ts-global_detected_seizures,31702,31730,28
Jensen_Eisai_groupC,1,5,ts-global_detected_seizures,31728,31761,33
Jensen_Eisai_groupC,1,5,ts-global_detected_seizures,31763,31785,22
Jensen_Eisai_groupC,1,5,ts-global_detected_seizures,31807,31881,74
Jensen_Eisai_groupC,2,6,ts-global_detected_seizures,31859,31893,34
Jensen_Eisai_groupC,1,5,ts-global_detected_seizures,31947,32088,141
Jensen_Eisai_groupC,2,6,ts-global_detected_seizures,31971,32009,38
Jensen_Eisai_groupC,2,6,ts-global_detected_seizures,32015,32037,22
Jensen_Eisai_groupC,1,5,ts-global_detected_seizures,32103,32130,27
Jensen_Eisai_groupC,1,5,ts-global_detected_seizures,32131,32174,43
Jensen_Eisai_groupC,2,6,ts-global_detected_seizures,32171,32211,40
Jensen_Eisai_groupC,1,5,ts-global_detected_seizures,32191,32262,71
Jensen_Eisai_groupC,2,6,ts-global_detected_seizures,32247,32289,42
Jensen_Eisai_groupC,1,5,ts-global_detected_seizures,32264,32334,70
Jensen_Eisai_groupC,2,6,ts-global_detected_seizures,32310,32408,98
Jensen_Eisai_groupC,1,5,ts-global_detected_seizures,32335,32364,29
Jensen_Eisai_groupC,1,5,ts-global_detected_seizures,32397,32430,33
Jensen_Eisai_groupC,1,5,ts-global_detected_seizures,32432,32558,126
Jensen_Eisai_groupC,2,6,ts-global_detected_seizures,32438,32490,52
Jensen_Eisai_groupC,2,6,ts-global_detected_seizures,32523,32552,29
Jensen_Eisai_groupC,1,5,ts-global_detected_seizures,32585,32608,23
Jensen_Eisai_groupC,2,6,ts-global_detected_seizures,32595,32618,23
Jensen_Eisai_groupC,1,5,ts-global_detected_seizures,32609,32663,54
Jensen_Eisai_groupC,1,5,ts-global_detected_seizures,32666,32732,66
Jensen_Eisai_groupC,2,6,ts-global_detected_seizures,32716,32738,22
Jensen_Eisai_groupC,1,5,ts-global_detected_seizures,32733,34224,1491
Jensen_Eisai_groupC,2,6,ts-global_detected_seizures,32762,32786,24
Jensen_Eisai_groupC,2,6,ts-global_detected_seizures,32860,32898,38
Jensen_Eisai_groupC,2,6,ts-global_detected_seizures,32947,32985,38
Jensen_Eisai_groupC,2,6,ts-global_detected_seizures,33007,33029,22
Jensen_Eisai_groupC,2,6,ts-global_detected_seizures,33068,33093,25
Jensen_Eisai_groupC,2,6,ts-global_detected_seizures,33230,33263,33
Jensen_Eisai_groupC,2,6,ts-global_detected_seizures,33366,33402,36
Jensen_Eisai_groupC,2,6,ts-global_detected_seizures,33433,33474,41
Jensen_Eisai_groupC,2,6,ts-global_detected_seizures,33475,33544,69
Jensen_Eisai_groupC,2,6,ts-global_detected_seizures,33555,33645,90
Jensen_Eisai_groupC,2,6,ts-global_detected_seizures,33761,33791,30
Jensen_Eisai_groupC,2,6,ts-global_detected_seizures,33814,33848,34
Jensen_Eisai_groupC,2,6,ts-global_detected_seizures,33917,33957,40
Jensen_Eisai_groupC,2,6,ts-global_detected_seizures,33983,34006,23
Jensen_Eisai_groupC,2,6,ts-global_detected_seizures,34017,34042,25
Jensen_Eisai_groupC,2,6,ts-global_detected_seizures,34127,34162,35
Jensen_Eisai_groupC,2,6,ts-global_detected_seizures,34189,34244,55
Jensen_Eisai_groupC,1,5,ts-global_detected_seizures,34238,34260,22
Jensen_Eisai_groupC,1,5,ts-global_detected_seizures,34261,34310,49
Jensen_Eisai_groupC,1,5,ts-global_detected_seizures,34392,34433,41
Jensen_Eisai_groupC,1,5,ts-global_detected_seizures,34455,34494,39
Jensen_Eisai_groupC,2,6,ts-global_detected_seizures,34457,34486,29
Jensen_Eisai_groupC,1,5,ts-global_detected_seizures,34509,34626,117
Jensen_Eisai_groupC,2,6,ts-global_detected_seizures,34531,34580,49
Jensen_Eisai_groupC,2,6,ts-global_detected_seizures,34601,34669,68
Jensen_Eisai_groupC,1,5,ts-global_detected_seizures,34673,34725,52
Jensen_Eisai_groupC,1,5,ts-global_detected_seizures,34824,34848,24
Jensen_Eisai_groupC,1,5,ts-global_detected_seizures,34875,34951,76
Jensen_Eisai_groupC,2,6,ts-global_detected_seizures,34954,34977,23
Jensen_Eisai_groupC,1,5,ts-global_detected_seizures,34974,35063,89
Jensen_Eisai_groupC,2,6,ts-global_detected_seizures,34992,35017,25
Jensen_Eisai_groupC,2,6,ts-global_detected_seizures,35028,35051,23
Jensen_Eisai_groupC,1,5,ts-global_detected_seizures,35092,35142,50
Jensen_Eisai_groupC,2,6,ts-global_detected_seizures,35101,35143,42
Jensen_Eisai_groupC,1,5,ts-global_detected_seizures,35164,35196,32
Jensen_Eisai_groupC,2,6,ts-global_detected_seizures,35179,35208,29
Jensen_Eisai_groupC,1,5,ts-global_detected_seizures,35197,35264,67
Jensen_Eisai_groupC,1,5,ts-global_detected_seizures,35307,35376,69
Jensen_Eisai_groupC,2,6,ts-global_detected_seizures,35315,35755,440
Jensen_Eisai_groupC,1,5,ts-global_detected_seizures,35410,35436,26
Jensen_Eisai_groupC,1,5,ts-global_detected_seizures,35437,35479,42
Jensen_Eisai_groupC,1,5,ts-global_detected_seizures,35496,35557,61
Jensen_Eisai_groupC,1,5,ts-global_detected_seizures,35572,35635,63
Jensen_Eisai_groupC,1,5,ts-global_detected_seizures,35646,35708,62
Jensen_Eisai_groupC,1,5,ts-global_detected_seizures,35711,35733,22
Jensen_Eisai_groupC,1,5,ts-global_detected_seizures,35754,35808,54
Jensen_Eisai_groupC,2,6,ts-global_detected_seizures,35757,35861,104
Jensen_Eisai_groupC,1,5,ts-global_detected_seizures,35812,35858,46
Jensen_Eisai_groupC,1,5,ts-global_detected_seizures,35860,35989,129
Jensen_Eisai_groupC,2,6,ts-global_detected_seizures,35862,35884,22
Jensen_Eisai_groupC,2,6,ts-global_detected_seizures,35917,36469,552
Jensen_Eisai_groupC,1,5,ts-global_detected_seizures,35993,36042,49
Jensen_Eisai_groupC,1,5,ts-global_detected_seizures,36045,36136,91
Jensen_Eisai_groupC,1,5,ts-global_detected_seizures,36176,36233,57
Jensen_Eisai_groupC,1,5,ts-global_detected_seizures,36268,36328,60
Jensen_Eisai_groupC,1,5,ts-global_detected_seizures,36341,36381,40
Jensen_Eisai_groupC,1,5,ts-global_detected_seizures,36408,36435,27
Jensen_Eisai_groupC,1,5,ts-global_detected_seizures,36439,36476,37
Jensen_Eisai_groupC,2,6,ts-global_detected_seizures,36507,36535,28
Jensen_Eisai_groupC,1,5,ts-global_detected_seizures,36512,36543,31
Jensen_Eisai_groupC,1,5,ts-global_detected_seizures,36564,36614,50
Jensen_Eisai_groupC,2,6,ts-global_detected_seizures,36615,36644,29
Jensen_Eisai_groupC,2,6,ts-global_detected_seizures,36659,36685,26
Jensen_Eisai_groupC,1,5,ts-global_detected_seizures,36662,36739,77
Jensen_Eisai_groupC,1,5,ts-global_detected_seizures,36742,36781,39
Jensen_Eisai_groupC,1,5,ts-global_detected_seizures,36791,36826,35
Jensen_Eisai_groupC,2,6,ts-global_detected_seizures,36793,36818,25
Jensen_Eisai_groupC,2,6,ts-global_detected_seizures,36854,36877,23
Jensen_Eisai_groupC,1,5,ts-global_detected_seizures,36864,36893,29
Jensen_Eisai_groupC,1,5,ts-global_detected_seizures,36895,36924,29
Jensen_Eisai_groupC,2,6,ts-global_detected_seizures,36939,36967,28
Jensen_Eisai_groupC,1,5,ts-global_detected_seizures,36994,37276,282
Jensen_Eisai_groupC,2,6,ts-global_detected_seizures,37009,37035,26
Jensen_Eisai_groupC,2,6,ts-global_detected_seizures,37069,37099,30
Jensen_Eisai_groupC,2,6,ts-global_detected_seizures,37186,37210,24
Jensen_Eisai_groupC,2,6,ts-global_detected_seizures,37250,37278,28
Jensen_Eisai_groupC,1,5,ts-global_detected_seizures,37282,37356,74
Jensen_Eisai_groupC,1,5,ts-global_detected_seizures,37382,37411,29
Jensen_Eisai_groupC,1,5,ts-global_detected_seizures,37412,37477,65
Jensen_Eisai_groupC,2,6,ts-global_detected_seizures,37475,37509,34
Jensen_Eisai_groupC,1,5,ts-global_detected_seizures,37579,37708,129
Jensen_Eisai_groupC,2,6,ts-global_detected_seizures,37617,37660,43
Jensen_Eisai_groupC,1,5,ts-global_detected_seizures,37709,37803,94
Jensen_Eisai_groupC,2,6,ts-global_detected_seizures,37716,37745,29
Jensen_Eisai_groupC,1,5,ts-global_detected_seizures,37816,37886,70
Jensen_Eisai_groupC,2,6,ts-global_detected_seizures,37828,37851,23
Jensen_Eisai_groupC,2,6,ts-global_detected_seizures,37867,38571,704
Jensen_Eisai_groupC,1,5,ts-global_detected_seizures,37887,37929,42
Jensen_Eisai_groupC,1,5,ts-global_detected_seizures,37933,38107,174
Jensen_Eisai_groupC,1,5,ts-global_detected_seizures,38108,38427,319
Jensen_Eisai_groupC,1,5,ts-global_detected_seizures,38428,38565,137
Jensen_Eisai_groupC,1,5,ts-global_detected_seizures,38569,38645,76
Jensen_Eisai_groupC,2,6,ts-global_detected_seizures,38628,38662,34
Jensen_Eisai_groupC,1,5,ts-global_detected_seizures,38665,38699,34
Jensen_Eisai_groupC,2,6,ts-global_detected_seizures,38683,38718,35
Jensen_Eisai_groupC,1,5,ts-global_detected_seizures,38750,38784,34
Jensen_Eisai_groupC,2,6,ts-global_detected_seizures,38754,38793,39
Jensen_Eisai_groupC,1,5,ts-global_detected_seizures,38800,38840,40
Jensen_Eisai_groupC,1,5,ts-global_detected_seizures,38841,38882,41
Jensen_Eisai_groupC,2,6,ts-global_detected_seizures,38876,38903,27
Jensen_Eisai_groupC,1,5,ts-global_detected_seizures,38904,38948,44
Jensen_Eisai_groupC,2,6,ts-global_detected_seizures,38942,38965,23
Jensen_Eisai_groupC,1,5,ts-global_detected_seizures,38995,39069,74
Jensen_Eisai_groupC,2,6,ts-global_detected_seizures,39001,39023,22
Jensen_Eisai_groupC,2,6,ts-global_detected_seizures,39039,39077,38
Jensen_Eisai_groupC,1,5,ts-global_detected_seizures,39100,39167,67
Jensen_Eisai_groupC,1,5,ts-global_detected_seizures,39212,39253,41
Jensen_Eisai_groupC,2,6,ts-global_detected_seizures,39220,39242,22
Jensen_Eisai_groupC,1,5,ts-global_detected_seizures,39255,39303,48
Jensen_Eisai_groupC,1,5,ts-global_detected_seizures,39304,39337,33
Jensen_Eisai_groupC,1,5,ts-global_detected_seizures,39357,39941,584
Jensen_Eisai_groupC,2,6,ts-global_detected_seizures,39362,39389,27
Jensen_Eisai_groupC,2,6,ts-global_detected_seizures,39419,39442,23
Jensen_Eisai_groupC,2,6,ts-global_detected_seizures,39531,39561,30
Jensen_Eisai_groupC,2,6,ts-global_detected_seizures,39562,39614,52
Jensen_Eisai_groupC,2,6,ts-global_detected_seizures,39615,39663,48
Jensen_Eisai_groupC,2,6,ts-global_detected_seizures,39746,39771,25
Jensen_Eisai_groupC,2,6,ts-global_detected_seizures,39875,39918,43
Jensen_Eisai_groupC,1,5,ts-global_detected_seizures,39942,40083,141
Jensen_Eisai_groupC,2,6,ts-global_detected_seizures,40031,40078,47
Jensen_Eisai_groupC,1,5,ts-global_detected_seizures,40084,40132,48
Jensen_Eisai_groupC,2,6,ts-global_detected_seizures,40100,40397,297
Jensen_Eisai_groupC,1,5,ts-global_detected_seizures,40172,40234,62
Jensen_Eisai_groupC,1,5,ts-global_detected_seizures,40235,40401,166
Jensen_Eisai_groupC,2,6,ts-global_detected_seizures,40413,40437,24
Jensen_Eisai_groupC,1,5,ts-global_detected_seizures,40425,40453,28
Jensen_Eisai_groupC,2,6,ts-global_detected_seizures,40443,40484,41
Jensen_Eisai_groupC,1,5,ts-global_detected_seizures,40493,40548,55
Jensen_Eisai_groupC,1,5,ts-global_detected_seizures,40549,40575,26
Jensen_Eisai_groupC,1,5,ts-global_detected_seizures,40581,40617,36
Jensen_Eisai_groupC,2,6,ts-global_detected_seizures,40588,40620,32
Jensen_Eisai_groupC,1,5,ts-global_detected_seizures,40619,40666,47
Jensen_Eisai_groupC,1,5,ts-global_detected_seizures,40686,40717,31
Jensen_Eisai_groupC,1,5,ts-global_detected_seizures,40735,40770,35
Jensen_Eisai_groupC,2,6,ts-global_detected_seizures,40767,40801,34
Jensen_Eisai_groupC,1,5,ts-global_detected_seizures,40799,40828,29
Jensen_Eisai_groupC,1,5,ts-global_detected_seizures,40831,40856,25
Jensen_Eisai_groupC,2,6,ts-global_detected_seizures,40853,40876,23
Jensen_Eisai_groupC,1,5,ts-global_detected_seizures,40873,40945,72
Jensen_Eisai_groupC,2,6,ts-global_detected_seizures,40916,41691,775
Jensen_Eisai_groupC,1,5,ts-global_detected_seizures,40989,41027,38
Jensen_Eisai_groupC,1,5,ts-global_detected_seizures,41028,41068,40
Jensen_Eisai_groupC,1,5,ts-global_detected_seizures,41076,41320,244
Jensen_Eisai_groupC,1,5,ts-global_detected_seizures,41335,41538,203
Jensen_Eisai_groupC,1,5,ts-global_detected_seizures,41539,41657,118
Jensen_Eisai_groupC,1,5,ts-global_detected_seizures,41658,41918,260
Jensen_Eisai_groupC,2,6,ts-global_detected_seizures,41716,42013,297
Jensen_Eisai_groupC,1,5,ts-global_detected_seizures,41919,44402,2483
Jensen_Eisai_groupC,2,6,ts-global_detected_seizures,42014,42149,135
Jensen_Eisai_groupC,2,6,ts-global_detected_seizures,42302,42325,23
Jensen_Eisai_groupC,2,6,ts-global_detected_seizures,43170,43193,23
Jensen_Eisai_groupC,2,6,ts-global_detected_seizures,43215,43263,48
Jensen_Eisai_groupC,2,6,ts-global_detected_seizures,43266,43303,37
Jensen_Eisai_groupC,2,6,ts-global_detected_seizures,43533,43691,158
Jensen_Eisai_groupC,2,6,ts-global_detected_seizures,43693,43717,24
Jensen_Eisai_groupC,2,6,ts-global_detected_seizures,44169,44225,56
Jensen_Eisai_groupC,1,5,ts-global_detected_seizures,44403,44505,102
Jensen_Eisai_groupC,2,6,ts-global_detected_seizures,44448,44493,45
Jensen_Eisai_groupC,1,5,ts-global_detected_seizures,44506,44812,306
Jensen_Eisai_groupC,2,6,ts-global_detected_seizures,44512,44610,98
Jensen_Eisai_groupC,1,5,ts-global_detected_seizures,44813,45543,730
Jensen_Eisai_groupC,2,6,ts-global_detected_seizures,44944,44966,22
Jensen_Eisai_groupC,2,6,ts-global_detected_seizures,45158,45183,25
Jensen_Eisai_groupC,2,6,ts-global_detected_seizures,45184,45214,30
Jensen_Eisai_groupC,1,5,ts-global_detected_seizures,45544,45749,205
Jensen_Eisai_groupC,2,6,ts-global_detected_seizures,45686,45708,22
Jensen_Eisai_groupC,1,5,ts-global_detected_seizures,45750,45995,245
Jensen_Eisai_groupC,1,5,ts-global_detected_seizures,45996,46019,23
Jensen_Eisai_groupC,1,5,ts-global_detected_seizures,46020,46806,786
Jensen_Eisai_groupC,1,5,ts-global_detected_seizures,46807,47496,689
Jensen_Eisai_groupC,1,5,ts-global_detected_seizures,47497,47564,67
Jensen_Eisai_groupC,1,5,ts-global_detected_seizures,47565,47774,209
Jensen_Eisai_groupC,2,6,ts-global_detected_seizures,47749,47791,42
Jensen_Eisai_groupC,1,5,ts-global_detected_seizures,47775,47873,98
Jensen_Eisai_groupC,1,5,ts-global_detected_seizures,47874,47932,58
Jensen_Eisai_groupC,1,5,ts-global_detected_seizures,47933,48725,792
Jensen_Eisai_groupC,1,5,ts-global_detected_seizures,48746,48876,130
Jensen_Eisai_groupC,2,6,ts-global_detected_seizures,48896,48919,23
Jensen_Eisai_groupC,1,5,ts-global_detected_seizures,48985,49019,34
Jensen_Eisai_groupC,2,6,ts-global_detected_seizures,48989,49024,35
Jensen_Eisai_groupC,1,5,ts-global_detected_seizures,49040,50018,978
Jensen_Eisai_groupC,2,6,ts-global_detected_seizures,49174,49202,28
Jensen_Eisai_groupC,2,6,ts-global_detected_seizures,49406,49429,23
Jensen_Eisai_groupC,2,6,ts-global_detected_seizures,49431,49460,29
Jensen_Eisai_groupC,2,6,ts-global_detected_seizures,49483,49526,43
Jensen_Eisai_groupC,2,6,ts-global_detected_seizures,49599,49623,24
Jensen_Eisai_groupC,2,6,ts-global_detected_seizures,49748,49772,24
Jensen_Eisai_groupC,2,6,ts-global_detected_seizures,49957,49990,33
Jensen_Eisai_groupC,1,5,ts-global_detected_seizures,50019,50700,681
Jensen_Eisai_groupC,2,6,ts-global_detected_seizures,50098,50124,26
Jensen_Eisai_groupC,2,6,ts-global_detected_seizures,50126,50160,34
Jensen_Eisai_groupC,2,6,ts-global_detected_seizures,50169,50227,58
Jensen_Eisai_groupC,2,6,ts-global_detected_seizures,50236,50296,60
Jensen_Eisai_groupC,2,6,ts-global_detected_seizures,50300,50333,33
Jensen_Eisai_groupC,2,6,ts-global_detected_seizures,50353,50391,38
Jensen_Eisai_groupC,2,6,ts-global_detected_seizures,50418,50442,24
Jensen_Eisai_groupC,2,6,ts-global_detected_seizures,50468,50504,36
Jensen_Eisai_groupC,2,6,ts-global_detected_seizures,50507,50554,47
Jensen_Eisai_groupC,2,6,ts-global_detected_seizures,50574,50619,45
Jensen_Eisai_groupC,2,6,ts-global_detected_seizures,50643,50718,75
Jensen_Eisai_groupC,1,5,ts-global_detected_seizures,50701,50773,72
Jensen_Eisai_groupC,2,6,ts-global_detected_seizures,50749,50791,42
Jensen_Eisai_groupC,1,5,ts-global_detected_seizures,50774,50862,88
Jensen_Eisai_groupC,1,5,ts-global_detected_seizures,50863,51665,802
Jensen_Eisai_groupC,2,6,ts-global_detected_seizures,50891,50953,62
Jensen_Eisai_groupC,2,6,ts-global_detected_seizures,50955,50989,34
Jensen_Eisai_groupC,2,6,ts-global_detected_seizures,51008,51046,38
Jensen_Eisai_groupC,2,6,ts-global_detected_seizures,51173,51215,42
Jensen_Eisai_groupC,2,6,ts-global_detected_seizures,51304,51339,35
Jensen_Eisai_groupC,2,6,ts-global_detected_seizures,51400,51439,39
Jensen_Eisai_groupC,2,6,ts-global_detected_seizures,51440,51472,32
Jensen_Eisai_groupC,2,6,ts-global_detected_seizures,51474,51566,92
Jensen_Eisai_groupC,2,6,ts-global_detected_seizures,51567,51591,24
Jensen_Eisai_groupC,2,6,ts-global_detected_seizures,51597,51679,82
Jensen_Eisai_groupC,1,5,ts-global_detected_seizures,51679,51956,277
Jensen_Eisai_groupC,2,6,ts-global_detected_seizures,51680,51718,38
Jensen_Eisai_groupC,1,5,ts-global_detected_seizures,52252,52278,26
Jensen_Eisai_groupC,1,5,ts-global_detected_seizures,52297,52324,27
Jensen_Eisai_groupC,1,5,ts-global_detected_seizures,52326,52745,419
Jensen_Eisai_groupC,2,6,ts-global_detected_seizures,52454,52477,23
Jensen_Eisai_groupC,1,5,ts-global_detected_seizures,52746,53055,309
Jensen_Eisai_groupC,2,6,ts-global_detected_seizures,52792,52815,23
Jensen_Eisai_groupC,2,6,ts-global_detected_seizures,52859,52884,25
Jensen_Eisai_groupC,2,6,ts-global_detected_seizures,53013,53038,25
Jensen_Eisai_groupC,1,5,ts-global_detected_seizures,53056,53125,69
Jensen_Eisai_groupC,1,5,ts-global_detected_seizures,53126,53230,104
Jensen_Eisai_groupC,2,6,ts-global_detected_seizures,53218,53249,31
Jensen_Eisai_groupC,1,5,ts-global_detected_seizures,53231,53351,120
Jensen_Eisai_groupC,2,6,ts-global_detected_seizures,53250,53387,137
Jensen_Eisai_groupC,1,5,ts-global_detected_seizures,53352,53733,381
Jensen_Eisai_groupC,2,6,ts-global_detected_seizures,53388,53490,102
Jensen_Eisai_groupC,2,6,ts-global_detected_seizures,53493,53521,28
Jensen_Eisai_groupC,2,6,ts-global_detected_seizures,53522,53627,105
Jensen_Eisai_groupC,2,6,ts-global_detected_seizures,53628,53710,82
Jensen_Eisai_groupC,2,6,ts-global_detected_seizures,53711,53795,84
Jensen_Eisai_groupC,1,5,ts-global_detected_seizures,53734,54369,635
Jensen_Eisai_groupC,2,6,ts-global_detected_seizures,53824,53866,42
Jensen_Eisai_groupC,2,6,ts-global_detected_seizures,53899,53946,47
Jensen_Eisai_groupC,2,6,ts-global_detected_seizures,53947,54104,157
Jensen_Eisai_groupC,2,6,ts-global_detected_seizures,54235,54264,29
Jensen_Eisai_groupC,1,5,ts-global_detected_seizures,54374,54434,60
Jensen_Eisai_groupC,2,6,ts-global_detected_seizures,54401,54424,23
Jensen_Eisai_groupC,1,5,ts-global_detected_seizures,54435,54536,101
Jensen_Eisai_groupC,2,6,ts-global_detected_seizures,54538,54564,26
Jensen_Eisai_groupC,1,5,ts-global_detected_seizures,54539,54565,26
Jensen_Eisai_groupC,1,5,ts-global_detected_seizures,54567,54692,125
Jensen_Eisai_groupC,2,6,ts-global_detected_seizures,54627,54653,26
Jensen_Eisai_groupC,2,6,ts-global_detected_seizures,54703,54733,30
Jensen_Eisai_groupC,1,5,ts-global_detected_seizures,54926,54966,40
Jensen_Eisai_groupC,1,5,ts-global_detected_seizures,54978,55009,31
Jensen_Eisai_groupC,2,6,ts-global_detected_seizures,54991,55018,27
Jensen_Eisai_groupC,2,6,ts-global_detected_seizures,55062,55084,22
Jensen_Eisai_groupC,2,6,ts-global_detected_seizures,55152,55176,24
Jensen_Eisai_groupC,2,6,ts-global_detected_seizures,55223,55347,124
Jensen_Eisai_groupC,2,6,ts-global_detected_seizures,55348,55512,164
Jensen_Eisai_groupC,1,5,ts-global_detected_seizures,55384,55416,32
Jensen_Eisai_groupC,1,5,ts-global_detected_seizures,55480,55502,22
Jensen_Eisai_groupC,2,6,ts-global_detected_seizures,55531,55773,242
Jensen_Eisai_groupC,1,5,ts-global_detected_seizures,55649,55671,22
Jensen_Eisai_groupC,1,5,ts-global_detected_seizures,55778,55857,79
Jensen_Eisai_groupC,2,6,ts-global_detected_seizures,55779,56050,271
Jensen_Eisai_groupC,1,5,ts-global_detected_seizures,55873,55907,34
Jensen_Eisai_groupC,1,5,ts-global_detected_seizures,56010,56032,22
Jensen_Eisai_groupC,2,6,ts-global_detected_seizures,56051,56080,29
Jensen_Eisai_groupC,2,6,ts-global_detected_seizures,56081,56106,25
Jensen_Eisai_groupC,1,5,ts-global_detected_seizures,56128,57147,1019
Jensen_Eisai_groupC,2,6,ts-global_detected_seizures,56131,56173,42
Jensen_Eisai_groupC,2,6,ts-global_detected_seizures,56174,56198,24
Jensen_Eisai_groupC,2,6,ts-global_detected_seizures,56512,56537,25
Jensen_Eisai_groupC,2,6,ts-global_detected_seizures,56663,56705,42
Jensen_Eisai_groupC,1,5,ts-global_detected_seizures,57148,57326,178
Jensen_Eisai_groupC,2,6,ts-global_detected_seizures,57217,57244,27
Jensen_Eisai_groupC,2,6,ts-global_detected_seizures,57259,57341,82
Jensen_Eisai_groupC,1,5,ts-global_detected_seizures,57327,58884,1557
Jensen_Eisai_groupC,2,6,ts-global_detected_seizures,57342,57640,298
Jensen_Eisai_groupC,2,6,ts-global_detected_seizures,57641,57701,60
Jensen_Eisai_groupC,2,6,ts-global_detected_seizures,57719,58028,309
Jensen_Eisai_groupC,2,6,ts-global_detected_seizures,58029,58283,254
Jensen_Eisai_groupC,2,6,ts-global_detected_seizures,58284,58443,159
Jensen_Eisai_groupC,2,6,ts-global_detected_seizures,58444,58525,81
Jensen_Eisai_groupC,2,6,ts-global_detected_seizures,58526,58674,148
Jensen_Eisai_groupC,2,6,ts-global_detected_seizures,58676,58795,119
Jensen_Eisai_groupC,1,5,ts-global_detected_seizures,58885,58970,85
Jensen_Eisai_groupC,1,5,ts-global_detected_seizures,58971,59560,589
Jensen_Eisai_groupC,2,6,ts-global_detected_seizures,59062,59102,40
Jensen_Eisai_groupC,2,6,ts-global_detected_seizures,59498,59521,23
Jensen_Eisai_groupC,1,5,ts-global_detected_seizures,59561,60191,630
Jensen_Eisai_groupC,2,6,ts-global_detected_seizures,59609,59632,23
Jensen_Eisai_groupC,2,6,ts-global_detected_seizures,59740,59780,40
Jensen_Eisai_groupC,2,6,ts-global_detected_seizures,59796,59884,88
Jensen_Eisai_groupC,1,5,ts-global_detected_seizures,60192,60285,93
Jensen_Eisai_groupC,1,5,ts-global_detected_seizures,60421,60470,49
Jensen_Eisai_groupC,2,6,ts-global_detected_seizures,60506,60528,22
Jensen_Eisai_groupC,2,6,ts-global_detected_seizures,60578,60604,26
Jensen_Eisai_groupC,2,6,ts-global_detected_seizures,60624,60651,27
Jensen_Eisai_groupC,2,6,ts-global_detected_seizures,60687,60815,128
Jensen_Eisai_groupC,1,5,ts-global_detected_seizures,60731,60763,32
Jensen_Eisai_groupC,2,6,ts-global_detected_seizures,60816,61331,515
Jensen_Eisai_groupC,1,5,ts-global_detected_seizures,60835,60895,60
Jensen_Eisai_groupC,1,5,ts-global_detected_seizures,61025,61064,39
Jensen_Eisai_groupC,2,6,ts-global_detected_seizures,61332,61842,510
Jensen_Eisai_groupC,1,5,ts-global_detected_seizures,61339,61490,151
Jensen_Eisai_groupC,1,5,ts-global_detected_seizures,61491,61520,29
Jensen_Eisai_groupC,1,5,ts-global_detected_seizures,61590,61612,22
Jensen_Eisai_groupC,2,6,ts-global_detected_seizures,61843,62143,300
Jensen_Eisai_groupC,1,5,ts-global_detected_seizures,61950,61975,25
Jensen_Eisai_groupC,1,5,ts-global_detected_seizures,61976,62049,73
Jensen_Eisai_groupC,1,5,ts-global_detected_seizures,62057,62080,23
Jensen_Eisai_groupC,2,6,ts-global_detected_seizures,62144,62328,184
Jensen_Eisai_groupC,2,6,ts-global_detected_seizures,62329,62463,134
Jensen_Eisai_groupC,1,5,ts-global_detected_seizures,62435,62514,79
Jensen_Eisai_groupC,1,5,ts-global_detected_seizures,62516,62540,24
Jensen_Eisai_groupC,1,5,ts-global_detected_seizures,62547,62593,46
Jensen_Eisai_groupC,1,5,ts-global_detected_seizures,62610,62634,24
Jensen_Eisai_groupC,1,5,ts-global_detected_seizures,62665,62707,42
Jensen_Eisai_groupC,2,6,ts-global_detected_seizures,62723,62747,24
Jensen_Eisai_groupC,2,6,ts-global_detected_seizures,62787,62809,22
Jensen_Eisai_groupC,1,5,ts-global_detected_seizures,62849,62876,27
Jensen_Eisai_groupC,2,6,ts-global_detected_seizures,62927,62963,36
Jensen_Eisai_groupC,1,5,ts-global_detected_seizures,62953,62980,27
Jensen_Eisai_groupC,1,5,ts-global_detected_seizures,63005,63607,602
Jensen_Eisai_groupC,2,6,ts-global_detected_seizures,63039,63065,26
Jensen_Eisai_groupC,2,6,ts-global_detected_seizures,63227,63253,26
Jensen_Eisai_groupC,2,6,ts-global_detected_seizures,63383,63410,27
Jensen_Eisai_groupC,2,6,ts-global_detected_seizures,63439,63466,27
Jensen_Eisai_groupC,1,5,ts-global_detected_seizures,63608,64281,673
Jensen_Eisai_groupC,2,6,ts-global_detected_seizures,63979,64009,30
Jensen_Eisai_groupC,2,6,ts-global_detected_seizures,64023,66184,2161
Jensen_Eisai_groupC,1,5,ts-global_detected_seizures,64282,65800,1518
Jensen_Eisai_groupC,1,5,ts-global_detected_seizures,65801,66026,225
Jensen_Eisai_groupC,1,5,ts-global_detected_seizures,66027,66675,648
Jensen_Eisai_groupC,2,6,ts-global_detected_seizures,66186,66287,101
Jensen_Eisai_groupC,2,6,ts-global_detected_seizures,66288,66988,700
Jensen_Eisai_groupC,1,5,ts-global_detected_seizures,66692,67673,981
Jensen_Eisai_groupC,2,6,ts-global_detected_seizures,66990,67061,71
Jensen_Eisai_groupC,2,6,ts-global_detected_seizures,67062,67223,161
Jensen_Eisai_groupC,2,6,ts-global_detected_seizures,67224,67584,360
Jensen_Eisai_groupC,2,6,ts-global_detected_seizures,67585,67732,147
Jensen_Eisai_groupC,1,5,ts-global_detected_seizures,67674,67749,75
Jensen_Eisai_groupC,1,5,ts-global_detected_seizures,67750,67948,198
Jensen_Eisai_groupC,2,6,ts-global_detected_seizures,67755,68466,711
Jensen_Eisai_groupC,1,5,ts-global_detected_seizures,67949,68179,230
Jensen_Eisai_groupC,1,5,ts-global_detected_seizures,68180,68639,459
Jensen_Eisai_groupC,2,6,ts-global_detected_seizures,68543,68566,23
Jensen_Eisai_groupC,2,6,ts-global_detected_seizures,68634,68665,31
Jensen_Eisai_groupC,1,5,ts-global_detected_seizures,68643,68677,34
Jensen_Eisai_groupC,1,5,ts-global_detected_seizures,68795,68854,59
Jensen_Eisai_groupC,2,6,ts-global_detected_seizures,68820,68846,26
Jensen_Eisai_groupC,2,6,ts-global_detected_seizures,68995,69077,82
Jensen_Eisai_groupC,1,5,ts-global_detected_seizures,69041,69084,43
Jensen_Eisai_groupC,2,6,ts-global_detected_seizures,69175,69246,71
Jensen_Eisai_groupC,1,5,ts-global_detected_seizures,69216,69253,37
Jensen_Eisai_groupC,2,6,ts-global_detected_seizures,69382,69411,29
Jensen_Eisai_groupC,2,6,ts-global_detected_seizures,69489,69513,24
Jensen_Eisai_groupC,2,6,ts-global_detected_seizures,69617,69650,33
Jensen_Eisai_groupC,2,6,ts-global_detected_seizures,69706,69748,42
Jensen_Eisai_groupC,2,6,ts-global_detected_seizures,69749,69797,48
Jensen_Eisai_groupC,1,5,ts-global_detected_seizures,69776,69802,26
Jensen_Eisai_groupC,2,6,ts-global_detected_seizures,69837,69859,22
Jensen_Eisai_groupC,1,5,ts-global_detected_seizures,69878,69911,33
Jensen_Eisai_groupC,2,6,ts-global_detected_seizures,69913,69946,33
Jensen_Eisai_groupC,1,5,ts-global_detected_seizures,69977,70127,150
Jensen_Eisai_groupC,2,6,ts-global_detected_seizures,70102,70142,40
Jensen_Eisai_groupC,1,5,ts-global_detected_seizures,70148,70203,55
Jensen_Eisai_groupC,1,5,ts-global_detected_seizures,70204,70239,35
Jensen_Eisai_groupC,2,6,ts-global_detected_seizures,70242,70288,46
Jensen_Eisai_groupC,1,5,ts-global_detected_seizures,70282,70308,26
Jensen_Eisai_groupC,1,5,ts-global_detected_seizures,70396,70471,75
Jensen_Eisai_groupC,2,6,ts-global_detected_seizures,70424,70447,23
Jensen_Eisai_groupC,2,6,ts-global_detected_seizures,70505,70560,55
Jensen_Eisai_groupC,1,5,ts-global_detected_seizures,70514,70552,38
Jensen_Eisai_groupC,1,5,ts-global_detected_seizures,70616,70702,86
Jensen_Eisai_groupC,1,5,ts-global_detected_seizures,70703,70727,24
Jensen_Eisai_groupC,2,6,ts-global_detected_seizures,70729,70751,22
Jensen_Eisai_groupC,1,5,ts-global_detected_seizures,70806,70847,41
Jensen_Eisai_groupC,1,5,ts-global_detected_seizures,70849,70890,41
Jensen_Eisai_groupC,1,5,ts-global_detected_seizures,70915,70945,30
Jensen_Eisai_groupC,1,5,ts-global_detected_seizures,70956,70980,24
Jensen_Eisai_groupC,1,5,ts-global_detected_seizures,70983,71007,24
Jensen_Eisai_groupC,2,6,ts-global_detected_seizures,71011,71048,37
Jensen_Eisai_groupC,2,6,ts-global_detected_seizures,71049,71098,49
Jensen_Eisai_groupC,1,5,ts-global_detected_seizures,71134,71236,102
Jensen_Eisai_groupC,2,6,ts-global_detected_seizures,71194,71222,28
Jensen_Eisai_groupC,1,5,ts-global_detected_seizures,71290,71370,80
Jensen_Eisai_groupC,1,5,ts-global_detected_seizures,71378,71412,34
Jensen_Eisai_groupC,1,5,ts-global_detected_seizures,71413,71509,96
Jensen_Eisai_groupC,2,6,ts-global_detected_seizures,71422,71446,24
Jensen_Eisai_groupC,1,5,ts-global_detected_seizures,71510,71533,23
Jensen_Eisai_groupC,2,6,ts-global_detected_seizures,71513,71550,37
Jensen_Eisai_groupC,2,6,ts-global_detected_seizures,71582,71604,22
Jensen_Eisai_groupC,1,5,ts-global_detected_seizures,71592,71620,28
Jensen_Eisai_groupC,1,5,ts-global_detected_seizures,71633,71666,33
Jensen_Eisai_groupC,1,5,ts-global_detected_seizures,71723,71801,78
Jensen_Eisai_groupC,2,6,ts-global_detected_seizures,71754,71807,53
Jensen_Eisai_groupC,1,5,ts-global_detected_seizures,71808,71843,35
Jensen_Eisai_groupC,2,6,ts-global_detected_seizures,71826,71851,25
Jensen_Eisai_groupC,1,5,ts-global_detected_seizures,71844,71868,24
Jensen_Eisai_groupC,1,5,ts-global_detected_seizures,71869,74027,2158
Jensen_Eisai_groupC,2,6,ts-global_detected_seizures,71926,72018,92
Jensen_Eisai_groupC,2,6,ts-global_detected_seizures,72152,72174,22
Jensen_Eisai_groupC,2,6,ts-global_detected_seizures,72345,72371,26
Jensen_Eisai_groupC,2,6,ts-global_detected_seizures,72520,72567,47
Jensen_Eisai_groupC,2,6,ts-global_detected_seizures,72607,72648,41
Jensen_Eisai_groupC,2,6,ts-global_detected_seizures,72664,72739,75
Jensen_Eisai_groupC,2,6,ts-global_detected_seizures,72773,72797,24
Jensen_Eisai_groupC,2,6,ts-global_detected_seizures,72966,72998,32
Jensen_Eisai_groupC,2,6,ts-global_detected_seizures,73052,73080,28
Jensen_Eisai_groupC,2,6,ts-global_detected_seizures,73121,73152,31
Jensen_Eisai_groupC,2,6,ts-global_detected_seizures,73179,73206,27
Jensen_Eisai_groupC,2,6,ts-global_detected_seizures,73295,73319,24
Jensen_Eisai_groupC,2,6,ts-global_detected_seizures,73320,73349,29
Jensen_Eisai_groupC,2,6,ts-global_detected_seizures,73407,73435,28
Jensen_Eisai_groupC,2,6,ts-global_detected_seizures,73527,73569,42
Jensen_Eisai_groupC,2,6,ts-global_detected_seizures,73707,73983,276
Jensen_Eisai_groupC,2,6,ts-global_detected_seizures,74022,74063,41
Jensen_Eisai_groupC,1,5,ts-global_detected_seizures,74028,74911,883
Jensen_Eisai_groupC,2,6,ts-global_detected_seizures,74152,74179,27
Jensen_Eisai_groupC,2,6,ts-global_detected_seizures,74228,74254,26
Jensen_Eisai_groupC,2,6,ts-global_detected_seizures,74402,74452,50
Jensen_Eisai_groupC,2,6,ts-global_detected_seizures,74542,74569,27
Jensen_Eisai_groupC,2,6,ts-global_detected_seizures,74646,74688,42
Jensen_Eisai_groupC,2,6,ts-global_detected_seizures,74713,74747,34
Jensen_Eisai_groupC,2,6,ts-global_detected_seizures,74821,74877,56
Jensen_Eisai_groupC,2,6,ts-global_detected_seizures,74878,74919,41
Jensen_Eisai_groupC,1,5,ts-global_detected_seizures,74925,74957,32
Jensen_Eisai_groupC,2,6,ts-global_detected_seizures,75021,75045,24
Jensen_Eisai_groupC,1,5,ts-global_detected_seizures,75040,75082,42
Jensen_Eisai_groupC,2,6,ts-global_detected_seizures,75073,75111,38
Jensen_Eisai_groupC,2,6,ts-global_detected_seizures,75133,75156,23
Jensen_Eisai_groupC,2,6,ts-global_detected_seizures,75180,75209,29
Jensen_Eisai_groupC,2,6,ts-global_detected_seizures,75287,75309,22
Jensen_Eisai_groupC,2,6,ts-global_detected_seizures,75347,75387,40
Jensen_Eisai_groupC,2,6,ts-global_detected_seizures,75388,75517,129
Jensen_Eisai_groupC,1,5,ts-global_detected_seizures,75432,75476,44
Jensen_Eisai_groupC,2,6,ts-global_detected_seizures,75518,75549,31
Jensen_Eisai_groupC,1,5,ts-global_detected_seizures,75583,75732,149
Jensen_Eisai_groupC,2,6,ts-global_detected_seizures,75725,75748,23
Jensen_Eisai_groupC,1,5,ts-global_detected_seizures,75733,75768,35
Jensen_Eisai_groupC,2,6,ts-global_detected_seizures,75874,75896,22
Jensen_Eisai_groupC,1,5,ts-global_detected_seizures,75901,75927,26
Jensen_Eisai_groupC,1,5,ts-global_detected_seizures,75980,76018,38
Jensen_Eisai_groupC,2,6,ts-global_detected_seizures,76058,76086,28
Jensen_Eisai_groupC,1,5,ts-global_detected_seizures,76082,76109,27
Jensen_Eisai_groupC,2,6,ts-global_detected_seizures,76121,76161,40
Jensen_Eisai_groupC,1,5,ts-global_detected_seizures,76151,76226,75
Jensen_Eisai_groupC,2,6,ts-global_detected_seizures,76162,76201,39
Jensen_Eisai_groupC,2,6,ts-global_detected_seizures,76212,76235,23
Jensen_Eisai_groupC,1,5,ts-global_detected_seizures,76232,76267,35
Jensen_Eisai_groupC,1,5,ts-global_detected_seizures,76268,76338,70
Jensen_Eisai_groupC,1,5,ts-global_detected_seizures,76416,76448,32
Jensen_Eisai_groupC,1,5,ts-global_detected_seizures,76513,76564,51
Jensen_Eisai_groupC,1,5,ts-global_detected_seizures,76582,76607,25
Jensen_Eisai_groupC,1,5,ts-global_detected_seizures,76625,76662,37
Jensen_Eisai_groupC,1,5,ts-global_detected_seizures,76683,76721,38
Jensen_Eisai_groupC,1,5,ts-global_detected_seizures,76732,76768,36
Jensen_Eisai_groupC,1,5,ts-global_detected_seizures,76812,76855,43
Jensen_Eisai_groupC,1,5,ts-global_detected_seizures,76882,76910,28
Jensen_Eisai_groupC,1,5,ts-global_detected_seizures,77030,77116,86
Jensen_Eisai_groupC,1,5,ts-global_detected_seizures,77158,77204,46
Jensen_Eisai_groupC,1,5,ts-global_detected_seizures,77234,77305,71
Jensen_Eisai_groupC,1,5,ts-global_detected_seizures,77328,77390,62
Jensen_Eisai_groupC,1,5,ts-global_detected_seizures,77454,77478,24
Jensen_Eisai_groupC,1,5,ts-global_detected_seizures,77494,77531,37
Jensen_Eisai_groupC,1,5,ts-global_detected_seizures,77561,77591,30
Jensen_Eisai_groupC,1,5,ts-global_detected_seizures,77633,77769,136
Jensen_Eisai_groupC,1,5,ts-global_detected_seizures,77771,77827,56
Jensen_Eisai_groupC,1,5,ts-global_detected_seizures,77830,77881,51
Jensen_Eisai_groupC,1,5,ts-global_detected_seizures,77895,77927,32
Jensen_Eisai_groupC,1,5,ts-global_detected_seizures,77929,77954,25
Jensen_Eisai_groupC,1,5,ts-global_detected_seizures,77985,78023,38
Jensen_Eisai_groupC,1,5,ts-global_detected_seizures,78046,78083,37
Jensen_Eisai_groupC,1,5,ts-global_detected_seizures,78101,78144,43
Jensen_Eisai_groupC,1,5,ts-global_detected_seizures,78154,78204,50
Jensen_Eisai_groupC,2,6,ts-global_detected_seizures,78250,78285,35
Jensen_Eisai_groupC,1,5,ts-global_detected_seizures,78254,78300,46
Jensen_Eisai_groupC,1,5,ts-global_detected_seizures,78332,78396,64
Jensen_Eisai_groupC,2,6,ts-global_detected_seizures,78343,78372,29
Jensen_Eisai_groupC,2,6,ts-global_detected_seizures,78396,78419,23
Jensen_Eisai_groupC,1,5,ts-global_detected_seizures,78411,78457,46
Jensen_Eisai_groupC,2,6,ts-global_detected_seizures,78482,78544,62
Jensen_Eisai_groupC,1,5,ts-global_detected_seizures,78485,78832,347
Jensen_Eisai_groupC,2,6,ts-global_detected_seizures,78625,78652,27
Jensen_Eisai_groupC,2,6,ts-global_detected_seizures,78708,78744,36
Jensen_Eisai_groupC,2,6,ts-global_detected_seizures,78798,78892,94
Jensen_Eisai_groupC,1,5,ts-global_detected_seizures,78841,78864,23
Jensen_Eisai_groupC,1,5,ts-global_detected_seizures,78892,78938,46
Jensen_Eisai_groupC,2,6,ts-global_detected_seizures,78907,78930,23
Jensen_Eisai_groupC,1,5,ts-global_detected_seizures,78990,79029,39
Jensen_Eisai_groupC,2,6,ts-global_detected_seizures,79097,79124,27
Jensen_Eisai_groupC,1,5,ts-global_detected_seizures,79127,79160,33
Jensen_Eisai_groupC,1,5,ts-global_detected_seizures,79185,79229,44
Jensen_Eisai_groupC,2,6,ts-global_detected_seizures,79194,79219,25
Jensen_Eisai_groupC,1,5,ts-global_detected_seizures,79230,79255,25
Jensen_Eisai_groupC,1,5,ts-global_detected_seizures,79258,79286,28
Jensen_Eisai_groupC,2,6,ts-global_detected_seizures,79259,79287,28
Jensen_Eisai_groupC,1,5,ts-global_detected_seizures,79287,79335,48
Jensen_Eisai_groupC,1,5,ts-global_detected_seizures,79336,79370,34
Jensen_Eisai_groupC,1,5,ts-global_detected_seizures,79384,79417,33
Jensen_Eisai_groupC,1,5,ts-global_detected_seizures,79384,79417,33
Jensen_Eisai_groupC,2,6,ts-global_detected_seizures,79409,79434,25
Jensen_Eisai_groupC,1,5,ts-global_detected_seizures,79444,79521,77
Jensen_Eisai_groupC,2,6,ts-global_detected_seizures,79512,79546,34
Jensen_Eisai_groupC,1,5,ts-global_detected_seizures,79540,79564,24
Jensen_Eisai_groupC,2,6,ts-global_detected_seizures,79556,79585,29
Jensen_Eisai_groupC,1,5,ts-global_detected_seizures,79570,79595,25
Jensen_Eisai_groupC,1,5,ts-global_detected_seizures,79596,79640,44
Jensen_Eisai_groupC,1,5,ts-global_detected_seizures,79641,79686,45
Jensen_Eisai_groupC,2,6,ts-global_detected_seizures,79658,79693,35
Jensen_Eisai_groupC,1,5,ts-global_detected_seizures,79719,79772,53
Jensen_Eisai_groupC,2,6,ts-global_detected_seizures,79746,79776,30
Jensen_Eisai_groupC,1,5,ts-global_detected_seizures,79773,79796,23
Jensen_Eisai_groupC,1,5,ts-global_detected_seizures,79818,79854,36
Jensen_Eisai_groupC,2,6,ts-global_detected_seizures,79873,79992,119
Jensen_Eisai_groupC,1,5,ts-global_detected_seizures,79885,79912,27
Jensen_Eisai_groupC,1,5,ts-global_detected_seizures,79926,79964,38
Jensen_Eisai_groupC,1,5,ts-global_detected_seizures,79965,80014,49
Jensen_Eisai_groupC,2,6,ts-global_detected_seizures,80009,80031,22
Jensen_Eisai_groupC,1,5,ts-global_detected_seizures,80041,80132,91
Jensen_Eisai_groupC,2,6,ts-global_detected_seizures,80060,80085,25
Jensen_Eisai_groupC,1,5,ts-global_detected_seizures,80134,80240,106
Jensen_Eisai_groupC,1,5,ts-global_detected_seizures,80276,80322,46
Jensen_Eisai_groupC,1,5,ts-global_detected_seizures,80323,80392,69
Jensen_Eisai_groupC,1,5,ts-global_detected_seizures,80405,80437,32
Jensen_Eisai_groupC,1,5,ts-global_detected_seizures,80459,80483,24
Jensen_Eisai_groupC,1,5,ts-global_detected_seizures,80492,80584,92
Jensen_Eisai_groupC,1,5,ts-global_detected_seizures,80585,80844,259
Jensen_Eisai_groupC,2,6,ts-global_detected_seizures,80727,80750,23
Jensen_Eisai_groupC,2,6,ts-global_detected_seizures,80788,80821,33
Jensen_Eisai_groupC,2,6,ts-global_detected_seizures,80842,80866,24
Jensen_Eisai_groupC,1,5,ts-global_detected_seizures,80845,80907,62
Jensen_Eisai_groupC,1,5,ts-global_detected_seizures,80916,81006,90
Jensen_Eisai_groupC,1,5,ts-global_detected_seizures,81008,81129,121
Jensen_Eisai_groupC,2,6,ts-global_detected_seizures,81070,81093,23
Jensen_Eisai_groupC,2,6,ts-global_detected_seizures,81108,82612,1504
Jensen_Eisai_groupC,1,5,ts-global_detected_seizures,81132,85793,4661
Jensen_Eisai_groupC,2,6,ts-global_detected_seizures,82613,83091,478
Jensen_Eisai_groupC,2,6,ts-global_detected_seizures,83092,83129,37
Jensen_Eisai_groupC,2,6,ts-global_detected_seizures,83131,85439,2308
Jensen_Eisai_groupC,2,6,ts-global_detected_seizures,85440,85891,451
Jensen_Eisai_groupC,1,5,ts-global_detected_seizures,85794,85902,108
Jensen_Eisai_groupC,2,6,ts-global_detected_seizures,85892,86182,290
Jensen_Eisai_groupC,1,5,ts-global_detected_seizures,85903,86143,240
Jensen_Eisai_groupC,1,5,ts-global_detected_seizures,86144,86480,336
Jensen_Eisai_groupC,2,6,ts-global_detected_seizures,86183,86232,49
Jensen_Eisai_groupC,2,6,ts-global_detected_seizures,86234,86480,246
Jensen_Eisai_groupC,2,6,ts-global_detected_seizures,87015,87128,113
Jensen_Eisai_groupC,1,5,ts-global_detected_seizures,87020,88307,1287
Jensen_Eisai_groupC,2,6,ts-global_detected_seizures,87130,87193,63
Jensen_Eisai_groupC,2,6,ts-global_detected_seizures,87196,87221,25
Jensen_Eisai_groupC,2,6,ts-global_detected_seizures,87222,87255,33
Jensen_Eisai_groupC,2,6,ts-global_detected_seizures,87392,87428,36
Jensen_Eisai_groupC,2,6,ts-global_detected_seizures,87470,87499,29
Jensen_Eisai_groupC,2,6,ts-global_detected_seizures,88237,88337,100
Jensen_Eisai_groupC,1,5,ts-global_detected_seizures,88308,88349,41
Jensen_Eisai_groupC,2,6,ts-global_detected_seizures,88338,88590,252
Jensen_Eisai_groupC,1,5,ts-global_detected_seizures,88361,88394,33
Jensen_Eisai_groupC,1,5,ts-global_detected_seizures,88404,88772,368
Jensen_Eisai_groupC,2,6,ts-global_detected_seizures,88731,88757,26
Jensen_Eisai_groupC,1,5,ts-global_detected_seizures,88773,88878,105
Jensen_Eisai_groupC,2,6,ts-global_detected_seizures,88837,88866,29
Jensen_Eisai_groupC,1,5,ts-global_detected_seizures,88879,89231,352
Jensen_Eisai_groupC,2,6,ts-global_detected_seizures,89138,89168,30
Jensen_Eisai_groupC,2,6,ts-global_detected_seizures,89169,89191,22
Jensen_Eisai_groupC,1,5,ts-global_detected_seizures,89232,89262,30
Jensen_Eisai_groupC,2,6,ts-global_detected_seizures,89262,89285,23
Jensen_Eisai_groupC,1,5,ts-global_detected_seizures,89263,89288,25
Jensen_Eisai_groupC,1,5,ts-global_detected_seizures,89289,89723,434
Jensen_Eisai_groupC,2,6,ts-global_detected_seizures,89342,89389,47
Jensen_Eisai_groupC,2,6,ts-global_detected_seizures,89390,89418,28
Jensen_Eisai_groupC,2,6,ts-global_detected_seizures,89486,89520,34
Jensen_Eisai_groupC,2,6,ts-global_detected_seizures,89573,89604,31
Jensen_Eisai_groupC,1,5,ts-global_detected_seizures,89741,90011,270
Jensen_Eisai_groupC,1,5,ts-global_detected_seizures,90012,90246,234
Jensen_Eisai_groupC,2,6,ts-global_detected_seizures,90182,90213,31
Jensen_Eisai_groupC,2,6,ts-global_detected_seizures,90225,90247,22
Jensen_Eisai_groupC,1,5,ts-global_detected_seizures,90266,90631,365
Jensen_Eisai_groupC,2,6,ts-global_detected_seizures,90514,90536,22
Jensen_Eisai_groupC,2,6,ts-global_detected_seizures,90539,90565,26
Jensen_Eisai_groupC,1,5,ts-global_detected_seizures,90632,90706,74
Jensen_Eisai_groupC,2,6,ts-global_detected_seizures,90644,90668,24
Jensen_Eisai_groupC,1,5,ts-global_detected_seizures,90709,91053,344
Jensen_Eisai_groupC,2,6,ts-global_detected_seizures,91007,91030,23
Jensen_Eisai_groupC,1,5,ts-global_detected_seizures,91054,91227,173
Jensen_Eisai_groupC,2,6,ts-global_detected_seizures,91056,91084,28
Jensen_Eisai_groupC,2,6,ts-global_detected_seizures,91100,91128,28
Jensen_Eisai_groupC,1,5,ts-global_detected_seizures,91228,91607,379
Jensen_Eisai_groupC,1,5,ts-global_detected_seizures,91608,91774,166
Jensen_Eisai_groupC,1,5,ts-global_detected_seizures,91775,91982,207
Jensen_Eisai_groupC,1,5,ts-global_detected_seizures,91983,92516,533
Jensen_Eisai_groupC,2,6,ts-global_detected_seizures,92404,92427,23
Jensen_Eisai_groupC,1,5,ts-global_detected_seizures,92517,93003,486
Jensen_Eisai_groupC,2,6,ts-global_detected_seizures,92572,92594,22
Jensen_Eisai_groupC,2,6,ts-global_detected_seizures,92624,92657,33
Jensen_Eisai_groupC,2,6,ts-global_detected_seizures,92713,92735,22
Jensen_Eisai_groupC,2,6,ts-global_detected_seizures,92736,92774,38
Jensen_Eisai_groupC,2,6,ts-global_detected_seizures,92873,92944,71
Jensen_Eisai_groupC,1,5,ts-global_detected_seizures,93004,93096,92
Jensen_Eisai_groupC,2,6,ts-global_detected_seizures,93047,93081,34
Jensen_Eisai_groupC,1,5,ts-global_detected_seizures,93097,93308,211
Jensen_Eisai_groupC,2,6,ts-global_detected_seizures,93301,93355,54
Jensen_Eisai_groupC,1,5,ts-global_detected_seizures,93309,93525,216
Jensen_Eisai_groupC,2,6,ts-global_detected_seizures,93381,93422,41
Jensen_Eisai_groupC,2,6,ts-global_detected_seizures,93506,93553,47
Jensen_Eisai_groupC,1,5,ts-global_detected_seizures,93537,93569,32
Jensen_Eisai_groupC,1,5,ts-global_detected_seizures,93570,94462,892
Jensen_Eisai_groupC,2,6,ts-global_detected_seizures,93573,93617,44
Jensen_Eisai_groupC,2,6,ts-global_detected_seizures,93619,93642,23
Jensen_Eisai_groupC,2,6,ts-global_detected_seizures,93689,93793,104
Jensen_Eisai_groupC,2,6,ts-global_detected_seizures,93813,93855,42
Jensen_Eisai_groupC,2,6,ts-global_detected_seizures,93856,93882,26
Jensen_Eisai_groupC,2,6,ts-global_detected_seizures,93904,93974,70
Jensen_Eisai_groupC,2,6,ts-global_detected_seizures,93976,94024,48
Jensen_Eisai_groupC,2,6,ts-global_detected_seizures,94025,94047,22
Jensen_Eisai_groupC,2,6,ts-global_detected_seizures,94051,94076,25
Jensen_Eisai_groupC,2,6,ts-global_detected_seizures,94079,94113,34
Jensen_Eisai_groupC,2,6,ts-global_detected_seizures,94128,94164,36
Jensen_Eisai_groupC,2,6,ts-global_detected_seizures,94165,94207,42
Jensen_Eisai_groupC,2,6,ts-global_detected_seizures,94294,94318,24
Jensen_Eisai_groupC,2,6,ts-global_detected_seizures,94319,94357,38
Jensen_Eisai_groupC,2,6,ts-global_detected_seizures,94358,94391,33
Jensen_Eisai_groupC,2,6,ts-global_detected_seizures,94393,94417,24
Jensen_Eisai_groupC,1,5,ts-global_detected_seizures,94480,94779,299
Jensen_Eisai_groupC,2,6,ts-global_detected_seizures,94740,94798,58
Jensen_Eisai_groupC,1,5,ts-global_detected_seizures,94781,95093,312
Jensen_Eisai_groupC,2,6,ts-global_detected_seizures,94799,94922,123
Jensen_Eisai_groupC,2,6,ts-global_detected_seizures,94923,94961,38
Jensen_Eisai_groupC,2,6,ts-global_detected_seizures,94985,95034,49
Jensen_Eisai_groupC,2,6,ts-global_detected_seizures,95035,95065,30
Jensen_Eisai_groupC,2,6,ts-global_detected_seizures,95067,95125,58
Jensen_Eisai_groupC,1,5,ts-global_detected_seizures,95094,95127,33
Jensen_Eisai_groupC,1,5,ts-global_detected_seizures,95128,95228,100
Jensen_Eisai_groupC,2,6,ts-global_detected_seizures,95143,95265,122
Jensen_Eisai_groupC,1,5,ts-global_detected_seizures,95229,95272,43
Jensen_Eisai_groupC,1,5,ts-global_detected_seizures,95273,95438,165
Jensen_Eisai_groupC,1,5,ts-global_detected_seizures,95439,95683,244
Jensen_Eisai_groupC,2,6,ts-global_detected_seizures,95585,95626,41
Jensen_Eisai_groupC,1,5,ts-global_detected_seizures,95684,95925,241
Jensen_Eisai_groupC,2,6,ts-global_detected_seizures,95687,95715,28
Jensen_Eisai_groupC,2,6,ts-global_detected_seizures,95858,95883,25
Jensen_Eisai_groupC,2,6,ts-global_detected_seizures,95858,95883,25
Jensen_Eisai_groupC,1,5,ts-global_detected_seizures,95926,96020,94
Jensen_Eisai_groupC,1,5,ts-global_detected_seizures,96021,96148,127
Jensen_Eisai_groupC,2,6,ts-global_detected_seizures,96033,96058,25
Jensen_Eisai_groupC,1,5,ts-global_detected_seizures,96149,96223,74
Jensen_Eisai_groupC,1,5,ts-global_detected_seizures,96224,96432,208
Jensen_Eisai_groupC,2,6,ts-global_detected_seizures,96319,96376,57
Jensen_Eisai_groupC,2,6,ts-global_detected_seizures,96390,96449,59
Jensen_Eisai_groupC,1,5,ts-global_detected_seizures,96433,96714,281
Jensen_Eisai_groupC,2,6,ts-global_detected_seizures,96450,96478,28
Jensen_Eisai_groupC,2,6,ts-global_detected_seizures,96479,96534,55
Jensen_Eisai_groupC,2,6,ts-global_detected_seizures,96624,96682,58
Jensen_Eisai_groupC,1,5,ts-global_detected_seizures,96715,96821,106
Jensen_Eisai_groupC,2,6,ts-global_detected_seizures,96841,96879,38
Jensen_Eisai_groupC,1,5,ts-global_detected_seizures,96948,97000,52
Jensen_Eisai_groupC,2,6,ts-global_detected_seizures,97005,97041,36
Jensen_Eisai_groupC,1,5,ts-global_detected_seizures,97100,97128,28
Jensen_Eisai_groupC,1,5,ts-global_detected_seizures,97129,97307,178
Jensen_Eisai_groupC,2,6,ts-global_detected_seizures,97143,97170,27
Jensen_Eisai_groupC,2,6,ts-global_detected_seizures,97361,97391,30
Jensen_Eisai_groupC,2,6,ts-global_detected_seizures,97439,97537,98
Jensen_Eisai_groupC,1,5,ts-global_detected_seizures,97476,97499,23
Jensen_Eisai_groupC,1,5,ts-global_detected_seizures,97563,97587,24
Jensen_Eisai_groupC,2,6,ts-global_detected_seizures,97641,97690,49
Jensen_Eisai_groupC,2,6,ts-global_detected_seizures,97770,97809,39
Jensen_Eisai_groupC,1,5,ts-global_detected_seizures,97813,97836,23
Jensen_Eisai_groupC,2,6,ts-global_detected_seizures,97834,97867,33
Jensen_Eisai_groupC,1,5,ts-global_detected_seizures,97888,98013,125
Jensen_Eisai_groupC,2,6,ts-global_detected_seizures,97925,97948,23
Jensen_Eisai_groupC,2,6,ts-global_detected_seizures,97998,98037,39
Jensen_Eisai_groupC,1,5,ts-global_detected_seizures,98149,98238,89
Jensen_Eisai_groupC,2,6,ts-global_detected_seizures,98222,98277,55
Jensen_Eisai_groupC,1,5,ts-global_detected_seizures,98301,98418,117
Jensen_Eisai_groupC,2,6,ts-global_detected_seizures,98305,98425,120
Jensen_Eisai_groupC,1,5,ts-global_detected_seizures,98451,98493,42
Jensen_Eisai_groupC,2,6,ts-global_detected_seizures,98525,98549,24
Jensen_Eisai_groupC,1,5,ts-global_detected_seizures,98547,98588,41
Jensen_Eisai_groupC,1,5,ts-global_detected_seizures,98608,98630,22
Jensen_Eisai_groupC,2,6,ts-global_detected_seizures,98630,98654,24
Jensen_Eisai_groupC,1,5,ts-global_detected_seizures,98639,98664,25
Jensen_Eisai_groupC,1,5,ts-global_detected_seizures,98669,98702,33
Jensen_Eisai_groupC,1,5,ts-global_detected_seizures,98741,98794,53
Jensen_Eisai_groupC,2,6,ts-global_detected_seizures,98757,98825,68
Jensen_Eisai_groupC,1,5,ts-global_detected_seizures,98837,98859,22
Jensen_Eisai_groupC,1,5,ts-global_detected_seizures,98888,98924,36
Jensen_Eisai_groupC,2,6,ts-global_detected_seizures,98946,98981,35
Jensen_Eisai_groupC,1,5,ts-global_detected_seizures,98979,99028,49
Jensen_Eisai_groupC,1,5,ts-global_detected_seizures,99034,99153,119
Jensen_Eisai_groupC,2,6,ts-global_detected_seizures,99039,99062,23
Jensen_Eisai_groupC,1,5,ts-global_detected_seizures,99154,99182,28
Jensen_Eisai_groupC,1,5,ts-global_detected_seizures,99205,99227,22
Jensen_Eisai_groupC,2,6,ts-global_detected_seizures,99249,99280,31
Jensen_Eisai_groupC,1,5,ts-global_detected_seizures,99309,99386,77
Jensen_Eisai_groupC,2,6,ts-global_detected_seizures,99371,99402,31
Jensen_Eisai_groupC,1,5,ts-global_detected_seizures,99410,99451,41
Jensen_Eisai_groupC,2,6,ts-global_detected_seizures,99449,99474,25
Jensen_Eisai_groupC,1,5,ts-global_detected_seizures,99482,99516,34
Jensen_Eisai_groupC,2,6,ts-global_detected_seizures,99505,99564,59
Jensen_Eisai_groupC,1,5,ts-global_detected_seizures,99584,99655,71
Jensen_Eisai_groupC,1,5,ts-global_detected_seizures,99660,99860,200
Jensen_Eisai_groupC,2,6,ts-global_detected_seizures,99755,99778,23
Jensen_Eisai_groupC,2,6,ts-global_detected_seizures,99854,99962,108
Jensen_Eisai_groupC,1,5,ts-global_detected_seizures,99861,99885,24
Jensen_Eisai_groupC,1,5,ts-global_detected_seizures,99886,99920,34
Jensen_Eisai_groupC,1,5,ts-global_detected_seizures,99930,100036,106
Jensen_Eisai_groupC,2,6,ts-global_detected_seizures,99963,100018,55
Jensen_Eisai_groupC,1,5,ts-global_detected_seizures,100081,100114,33
Jensen_Eisai_groupC,1,5,ts-global_detected_seizures,100162,100225,63
Jensen_Eisai_groupC,1,5,ts-global_detected_seizures,100226,100274,48
Jensen_Eisai_groupC,2,6,ts-global_detected_seizures,100371,100396,25
Jensen_Eisai_groupC,1,5,ts-global_detected_seizures,100391,100416,25
Jensen_Eisai_groupC,2,6,ts-global_detected_seizures,100407,100444,37
Jensen_Eisai_groupC,1,5,ts-global_detected_seizures,100417,100527,110
Jensen_Eisai_groupC,2,6,ts-global_detected_seizures,100466,100492,26
Jensen_Eisai_groupC,2,6,ts-global_detected_seizures,100493,100589,96
Jensen_Eisai_groupC,1,5,ts-global_detected_seizures,100531,101152,621
Jensen_Eisai_groupC,2,6,ts-global_detected_seizures,100627,100650,23
Jensen_Eisai_groupC,2,6,ts-global_detected_seizures,100651,100673,22
Jensen_Eisai_groupC,2,6,ts-global_detected_seizures,100771,100810,39
Jensen_Eisai_groupC,2,6,ts-global_detected_seizures,100904,100927,23
Jensen_Eisai_groupC,2,6,ts-global_detected_seizures,101009,101057,48
Jensen_Eisai_groupC,1,5,ts-global_detected_seizures,101206,101246,40
Jensen_Eisai_groupC,2,6,ts-global_detected_seizures,101207,101241,34
Jensen_Eisai_groupC,1,5,ts-global_detected_seizures,101247,101284,37
Jensen_Eisai_groupC,2,6,ts-global_detected_seizures,101312,101335,23
Jensen_Eisai_groupC,1,5,ts-global_detected_seizures,101338,101383,45
Jensen_Eisai_groupC,2,6,ts-global_detected_seizures,101354,101378,24
Jensen_Eisai_groupC,2,6,ts-global_detected_seizures,101392,101432,40
Jensen_Eisai_groupC,1,5,ts-global_detected_seizures,101485,101644,159
Jensen_Eisai_groupC,2,6,ts-global_detected_seizures,101496,101527,31
Jensen_Eisai_groupC,2,6,ts-global_detected_seizures,101603,101631,28
Jensen_Eisai_groupC,1,5,ts-global_detected_seizures,101665,101704,39
Jensen_Eisai_groupC,2,6,ts-global_detected_seizures,101670,101981,311
Jensen_Eisai_groupC,1,5,ts-global_detected_seizures,101719,101747,28
Jensen_Eisai_groupC,1,5,ts-global_detected_seizures,101757,101781,24
Jensen_Eisai_groupC,1,5,ts-global_detected_seizures,101819,101855,36
Jensen_Eisai_groupC,1,5,ts-global_detected_seizures,101861,101896,35
Jensen_Eisai_groupC,1,5,ts-global_detected_seizures,101957,101994,37
Jensen_Eisai_groupC,2,6,ts-global_detected_seizures,101982,102136,154
Jensen_Eisai_groupC,1,5,ts-global_detected_seizures,102090,102132,42
Jensen_Eisai_groupC,2,6,ts-global_detected_seizures,102137,102381,244
Jensen_Eisai_groupC,1,5,ts-global_detected_seizures,102156,102193,37
Jensen_Eisai_groupC,1,5,ts-global_detected_seizures,102194,102232,38
Jensen_Eisai_groupC,1,5,ts-global_detected_seizures,102236,102283,47
Jensen_Eisai_groupC,1,5,ts-global_detected_seizures,102305,102340,35
Jensen_Eisai_groupC,1,5,ts-global_detected_seizures,102361,102409,48
Jensen_Eisai_groupC,2,6,ts-global_detected_seizures,102382,102447,65
Jensen_Eisai_groupC,1,5,ts-global_detected_seizures,102429,102513,84
Jensen_Eisai_groupC,2,6,ts-global_detected_seizures,102448,102556,108
Jensen_Eisai_groupC,1,5,ts-global_detected_seizures,102534,102595,61
Jensen_Eisai_groupC,2,6,ts-global_detected_seizures,102557,102582,25
Jensen_Eisai_groupC,2,6,ts-global_detected_seizures,102589,102896,307
Jensen_Eisai_groupC,1,5,ts-global_detected_seizures,102711,102747,36
Jensen_Eisai_groupC,1,5,ts-global_detected_seizures,102793,102836,43
Jensen_Eisai_groupC,1,5,ts-global_detected_seizures,102837,102906,69
Jensen_Eisai_groupC,2,6,ts-global_detected_seizures,102897,102988,91
Jensen_Eisai_groupC,1,5,ts-global_detected_seizures,102911,102949,38
Jensen_Eisai_groupC,2,6,ts-global_detected_seizures,102989,103020,31
Jensen_Eisai_groupC,2,6,ts-global_detected_seizures,103021,103055,34
Jensen_Eisai_groupC,1,5,ts-global_detected_seizures,103045,103069,24
Jensen_Eisai_groupC,2,6,ts-global_detected_seizures,103056,103121,65
Jensen_Eisai_groupC,1,5,ts-global_detected_seizures,103117,104228,1111
Jensen_Eisai_groupC,2,6,ts-global_detected_seizures,103129,103201,72
Jensen_Eisai_groupC,2,6,ts-global_detected_seizures,103221,103491,270
Jensen_Eisai_groupC,2,6,ts-global_detected_seizures,103492,103691,199
Jensen_Eisai_groupC,2,6,ts-global_detected_seizures,103704,103916,212
Jensen_Eisai_groupC,2,6,ts-global_detected_seizures,103917,104029,112
Jensen_Eisai_groupC,2,6,ts-global_detected_seizures,104030,104130,100
Jensen_Eisai_groupC,2,6,ts-global_detected_seizures,104131,104568,437
Jensen_Eisai_groupC,1,5,ts-global_detected_seizures,104229,105037,808
Jensen_Eisai_groupC,2,6,ts-global_detected_seizures,104586,104726,140
Jensen_Eisai_groupC,2,6,ts-global_detected_seizures,104727,104765,38
Jensen_Eisai_groupC,2,6,ts-global_detected_seizures,104793,104823,30
Jensen_Eisai_groupC,2,6,ts-global_detected_seizures,104825,104993,168
Jensen_Eisai_groupC,2,6,ts-global_detected_seizures,104994,105052,58
Jensen_Eisai_groupC,1,5,ts-global_detected_seizures,105050,105189,139
Jensen_Eisai_groupC,2,6,ts-global_detected_seizures,105062,105109,47
Jensen_Eisai_groupC,1,5,ts-global_detected_seizures,105190,105298,108
Jensen_Eisai_groupC,1,5,ts-global_detected_seizures,105299,105754,455
Jensen_Eisai_groupC,2,6,ts-global_detected_seizures,105306,105338,32
Jensen_Eisai_groupC,2,6,ts-global_detected_seizures,105361,105384,23
Jensen_Eisai_groupC,2,6,ts-global_detected_seizures,105516,105549,33
Jensen_Eisai_groupC,2,6,ts-global_detected_seizures,105575,105599,24
Jensen_Eisai_groupC,1,5,ts-global_detected_seizures,105755,105914,159
Jensen_Eisai_groupC,2,6,ts-global_detected_seizures,105775,105810,35
Jensen_Eisai_groupC,1,5,ts-global_detected_seizures,105919,105949,30
Jensen_Eisai_groupC,2,6,ts-global_detected_seizures,105924,105946,22
Jensen_Eisai_groupC,1,5,ts-global_detected_seizures,105998,106066,68
Jensen_Eisai_groupC,2,6,ts-global_detected_seizures,106028,106058,30
Jensen_Eisai_groupC,1,5,ts-global_detected_seizures,106080,106105,25
Jensen_Eisai_groupC,1,5,ts-global_detected_seizures,106159,106185,26
Jensen_Eisai_groupC,1,5,ts-global_detected_seizures,106247,106273,26
Jensen_Eisai_groupC,2,6,ts-global_detected_seizures,106267,106306,39
Jensen_Eisai_groupC,2,6,ts-global_detected_seizures,106342,106372,30
Jensen_Eisai_groupC,2,6,ts-global_detected_seizures,106416,106441,25
Jensen_Eisai_groupC,1,5,ts-global_detected_seizures,106458,106520,62
Jensen_Eisai_groupC,2,6,ts-global_detected_seizures,106461,106494,33
Jensen_Eisai_groupC,2,6,ts-global_detected_seizures,106520,106557,37
Jensen_Eisai_groupC,1,5,ts-global_detected_seizures,106545,106578,33
Jensen_Eisai_groupC,2,6,ts-global_detected_seizures,106598,106646,48
Jensen_Eisai_groupC,1,5,ts-global_detected_seizures,106633,106663,30
Jensen_Eisai_groupC,1,5,ts-global_detected_seizures,106713,106758,45
Jensen_Eisai_groupC,2,6,ts-global_detected_seizures,106776,106827,51
Jensen_Eisai_groupC,1,5,ts-global_detected_seizures,106785,106815,30
Jensen_Eisai_groupC,1,5,ts-global_detected_seizures,106844,106874,30
Jensen_Eisai_groupC,2,6,ts-global_detected_seizures,106890,106913,23
Jensen_Eisai_groupC,1,5,ts-global_detected_seizures,106910,106971,61
Jensen_Eisai_groupC,2,6,ts-global_detected_seizures,106942,107060,118
Jensen_Eisai_groupC,1,5,ts-global_detected_seizures,106991,107015,24
Jensen_Eisai_groupC,1,5,ts-global_detected_seizures,107038,107064,26
Jensen_Eisai_groupC,1,5,ts-global_detected_seizures,107065,107088,23
Jensen_Eisai_groupC,2,6,ts-global_detected_seizures,107146,107176,30
Jensen_Eisai_groupC,1,5,ts-global_detected_seizures,107155,107179,24
Jensen_Eisai_groupC,1,5,ts-global_detected_seizures,107183,107259,76
Jensen_Eisai_groupC,2,6,ts-global_detected_seizures,107246,107282,36
Jensen_Eisai_groupC,1,5,ts-global_detected_seizures,107262,107314,52
Jensen_Eisai_groupC,1,5,ts-global_detected_seizures,107381,107410,29
Jensen_Eisai_groupC,1,5,ts-global_detected_seizures,107411,107504,93
Jensen_Eisai_groupC,2,6,ts-global_detected_seizures,107436,107463,27
Jensen_Eisai_groupC,2,6,ts-global_detected_seizures,107507,107534,27
Jensen_Eisai_groupC,2,6,ts-global_detected_seizures,107566,107596,30
Jensen_Eisai_groupC,1,5,ts-global_detected_seizures,107590,107625,35
Jensen_Eisai_groupC,2,6,ts-global_detected_seizures,107622,107651,29
Jensen_Eisai_groupC,1,5,ts-global_detected_seizures,107638,107663,25
Jensen_Eisai_groupC,2,6,ts-global_detected_seizures,107689,107717,28
Jensen_Eisai_groupC,1,5,ts-global_detected_seizures,107722,107943,221
Jensen_Eisai_groupC,2,6,ts-global_detected_seizures,107753,107829,76
Jensen_Eisai_groupC,2,6,ts-global_detected_seizures,107840,108030,190
Jensen_Eisai_groupC,1,5,ts-global_detected_seizures,107944,107987,43
Jensen_Eisai_groupC,1,5,ts-global_detected_seizures,108005,108045,40
Jensen_Eisai_groupC,2,6,ts-global_detected_seizures,108032,108072,40
Jensen_Eisai_groupC,1,5,ts-global_detected_seizures,108097,108151,54
Jensen_Eisai_groupC,2,6,ts-global_detected_seizures,108105,108132,27
Jensen_Eisai_groupC,2,6,ts-global_detected_seizures,108157,108187,30
Jensen_Eisai_groupC,1,5,ts-global_detected_seizures,108175,108201,26
Jensen_Eisai_groupC,2,6,ts-global_detected_seizures,108361,108393,32
Jensen_Eisai_groupC,1,5,ts-global_detected_seizures,108362,108385,23
Jensen_Eisai_groupC,1,5,ts-global_detected_seizures,108403,108428,25
Jensen_Eisai_groupC,1,5,ts-global_detected_seizures,108434,108508,74
Jensen_Eisai_groupC,2,6,ts-global_detected_seizures,108454,108476,22
Jensen_Eisai_groupC,1,5,ts-global_detected_seizures,108535,108563,28
Jensen_Eisai_groupC,2,6,ts-global_detected_seizures,108559,108698,139
Jensen_Eisai_groupC,1,5,ts-global_detected_seizures,108600,108629,29
Jensen_Eisai_groupC,1,5,ts-global_detected_seizures,108665,108698,33
Jensen_Eisai_groupC,1,5,ts-global_detected_seizures,108710,108738,28
Jensen_Eisai_groupC,1,5,ts-global_detected_seizures,108739,108798,59
Jensen_Eisai_groupC,2,6,ts-global_detected_seizures,108786,108824,38
Jensen_Eisai_groupC,1,5,ts-global_detected_seizures,108852,108877,25
Jensen_Eisai_groupC,1,5,ts-global_detected_seizures,108897,108941,44
Jensen_Eisai_groupC,2,6,ts-global_detected_seizures,108928,108954,26
Jensen_Eisai_groupC,1,5,ts-global_detected_seizures,108957,108980,23
Jensen_Eisai_groupC,1,5,ts-global_detected_seizures,109034,109110,76
Jensen_Eisai_groupC,2,6,ts-global_detected_seizures,109054,109076,22
Jensen_Eisai_groupC,1,5,ts-global_detected_seizures,109111,109169,58
Jensen_Eisai_groupC,2,6,ts-global_detected_seizures,109126,109150,24
Jensen_Eisai_groupC,1,5,ts-global_detected_seizures,109188,109856,668
Jensen_Eisai_groupC,2,6,ts-global_detected_seizures,109264,109295,31
Jensen_Eisai_groupC,2,6,ts-global_detected_seizures,109368,109420,52
Jensen_Eisai_groupC,2,6,ts-global_detected_seizures,109496,109519,23
Jensen_Eisai_groupC,2,6,ts-global_detected_seizures,109536,109592,56
Jensen_Eisai_groupC,2,6,ts-global_detected_seizures,109714,109787,73
Jensen_Eisai_groupC,2,6,ts-global_detected_seizures,109857,109950,93
Jensen_Eisai_groupC,1,5,ts-global_detected_seizures,109881,109916,35
Jensen_Eisai_groupC,1,5,ts-global_detected_seizures,109918,109956,38
Jensen_Eisai_groupC,1,5,ts-global_detected_seizures,109972,109997,25
Jensen_Eisai_groupC,1,5,ts-global_detected_seizures,110007,110044,37
Jensen_Eisai_groupC,2,6,ts-global_detected_seizures,110031,110067,36
Jensen_Eisai_groupC,1,5,ts-global_detected_seizures,110045,110078,33
Jensen_Eisai_groupC,2,6,ts-global_detected_seizures,110100,110130,30
Jensen_Eisai_groupC,1,5,ts-global_detected_seizures,110102,110138,36
Jensen_Eisai_groupC,1,5,ts-global_detected_seizures,110194,110224,30
Jensen_Eisai_groupC,2,6,ts-global_detected_seizures,110198,110223,25
Jensen_Eisai_groupC,1,5,ts-global_detected_seizures,110232,110261,29
Jensen_Eisai_groupC,1,5,ts-global_detected_seizures,110278,110331,53
Jensen_Eisai_groupC,2,6,ts-global_detected_seizures,110295,110319,24
Jensen_Eisai_groupC,1,5,ts-global_detected_seizures,110347,110415,68
Jensen_Eisai_groupC,2,6,ts-global_detected_seizures,110371,110422,51
Jensen_Eisai_groupC,1,5,ts-global_detected_seizures,110431,110472,41
Jensen_Eisai_groupC,2,6,ts-global_detected_seizures,110470,110496,26
Jensen_Eisai_groupC,1,5,ts-global_detected_seizures,110481,110525,44
Jensen_Eisai_groupC,2,6,ts-global_detected_seizures,110514,110536,22
Jensen_Eisai_groupC,2,6,ts-global_detected_seizures,110558,110595,37
Jensen_Eisai_groupC,1,5,ts-global_detected_seizures,110582,110650,68
Jensen_Eisai_groupC,2,6,ts-global_detected_seizures,110629,110697,68
Jensen_Eisai_groupC,1,5,ts-global_detected_seizures,110689,110729,40
Jensen_Eisai_groupC,2,6,ts-global_detected_seizures,110735,110769,34
Jensen_Eisai_groupC,2,6,ts-global_detected_seizures,110770,110800,30
Jensen_Eisai_groupC,1,5,ts-global_detected_seizures,110789,110824,35
Jensen_Eisai_groupC,1,5,ts-global_detected_seizures,110825,110980,155
Jensen_Eisai_groupC,2,6,ts-global_detected_seizures,110869,110906,37
Jensen_Eisai_groupC,2,6,ts-global_detected_seizures,110933,110963,30
Jensen_Eisai_groupC,2,6,ts-global_detected_seizures,110984,111011,27
Jensen_Eisai_groupC,2,6,ts-global_detected_seizures,111031,111058,27
Jensen_Eisai_groupC,2,6,ts-global_detected_seizures,111068,111090,22
Jensen_Eisai_groupC,1,5,ts-global_detected_seizures,111069,111198,129
Jensen_Eisai_groupC,2,6,ts-global_detected_seizures,111122,111148,26
Jensen_Eisai_groupC,2,6,ts-global_detected_seizures,111169,111207,38
Jensen_Eisai_groupC,1,5,ts-global_detected_seizures,111199,111330,131
Jensen_Eisai_groupC,2,6,ts-global_detected_seizures,111208,111458,250
Jensen_Eisai_groupC,1,5,ts-global_detected_seizures,111352,111398,46
Jensen_Eisai_groupC,2,6,ts-global_detected_seizures,111478,111544,66
Jensen_Eisai_groupC,2,6,ts-global_detected_seizures,111559,111590,31
Jensen_Eisai_groupC,2,6,ts-global_detected_seizures,111598,111629,31
Jensen_Eisai_groupC,1,5,ts-global_detected_seizures,111605,111628,23
Jensen_Eisai_groupC,1,5,ts-global_detected_seizures,111651,111684,33
Jensen_Eisai_groupC,2,6,ts-global_detected_seizures,111659,111682,23
Jensen_Eisai_groupC,1,5,ts-global_detected_seizures,111702,111732,30
Jensen_Eisai_groupC,1,5,ts-global_detected_seizures,111733,111760,27
Jensen_Eisai_groupC,1,5,ts-global_detected_seizures,111774,111816,42
Jensen_Eisai_groupC,2,6,ts-global_detected_seizures,111789,111817,28
Jensen_Eisai_groupC,1,5,ts-global_detected_seizures,111836,111893,57
Jensen_Eisai_groupC,2,6,ts-global_detected_seizures,111851,111891,40
Jensen_Eisai_groupC,1,5,ts-global_detected_seizures,111901,111936,35
Jensen_Eisai_groupC,2,6,ts-global_detected_seizures,111959,112000,41
Jensen_Eisai_groupC,1,5,ts-global_detected_seizures,112012,112060,48
Jensen_Eisai_groupC,2,6,ts-global_detected_seizures,112046,112080,34
Jensen_Eisai_groupC,1,5,ts-global_detected_seizures,112085,112116,31
Jensen_Eisai_groupC,2,6,ts-global_detected_seizures,112129,112168,39
Jensen_Eisai_groupC,1,5,ts-global_detected_seizures,112148,112211,63
Jensen_Eisai_groupC,1,5,ts-global_detected_seizures,112214,112403,189
Jensen_Eisai_groupC,2,6,ts-global_detected_seizures,112239,112271,32
Jensen_Eisai_groupC,1,5,ts-global_detected_seizures,112404,112481,77
Jensen_Eisai_groupC,2,6,ts-global_detected_seizures,112413,112466,53
Jensen_Eisai_groupC,1,5,ts-global_detected_seizures,112490,112530,40
Jensen_Eisai_groupC,2,6,ts-global_detected_seizures,112525,112556,31
Jensen_Eisai_groupC,1,5,ts-global_detected_seizures,112534,112662,128
Jensen_Eisai_groupC,1,5,ts-global_detected_seizures,112664,112701,37
Jensen_Eisai_groupC,1,5,ts-global_detected_seizures,112711,112845,134
Jensen_Eisai_groupC,2,6,ts-global_detected_seizures,112774,112806,32
Jensen_Eisai_groupC,2,6,ts-global_detected_seizures,112809,112847,38
Jensen_Eisai_groupC,1,5,ts-global_detected_seizures,112846,113044,198
Jensen_Eisai_groupC,2,6,ts-global_detected_seizures,112904,112956,52
Jensen_Eisai_groupC,2,6,ts-global_detected_seizures,112958,113103,145
Jensen_Eisai_groupC,1,5,ts-global_detected_seizures,113045,113116,71
Jensen_Eisai_groupC,2,6,ts-global_detected_seizures,113127,113159,32
Jensen_Eisai_groupC,1,5,ts-global_detected_seizures,113146,113220,74
Jensen_Eisai_groupC,2,6,ts-global_detected_seizures,113201,113231,30
Jensen_Eisai_groupC,1,5,ts-global_detected_seizures,113237,113283,46
Jensen_Eisai_groupC,2,6,ts-global_detected_seizures,113248,113274,26
Jensen_Eisai_groupC,1,5,ts-global_detected_seizures,113300,113334,34
Jensen_Eisai_groupC,2,6,ts-global_detected_seizures,113302,113329,27
Jensen_Eisai_groupC,2,6,ts-global_detected_seizures,113354,113383,29
Jensen_Eisai_groupC,1,5,ts-global_detected_seizures,113361,113422,61
Jensen_Eisai_groupC,2,6,ts-global_detected_seizures,113438,113461,23
Jensen_Eisai_groupC,1,5,ts-global_detected_seizures,113440,113474,34
Jensen_Eisai_groupC,1,5,ts-global_detected_seizures,113517,113551,34
Jensen_Eisai_groupC,2,6,ts-global_detected_seizures,113524,113547,23
Jensen_Eisai_groupC,2,6,ts-global_detected_seizures,113571,113596,25
Jensen_Eisai_groupC,1,5,ts-global_detected_seizures,113580,113687,107
Jensen_Eisai_groupC,2,6,ts-global_detected_seizures,113666,113698,32
Jensen_Eisai_groupC,1,5,ts-global_detected_seizures,113688,113778,90
Jensen_Eisai_groupC,2,6,ts-global_detected_seizures,113763,113788,25
Jensen_Eisai_groupC,2,6,ts-global_detected_seizures,113789,113819,30
Jensen_Eisai_groupC,1,5,ts-global_detected_seizures,113795,113873,78
Jensen_Eisai_groupC,2,6,ts-global_detected_seizures,113845,113885,40
Jensen_Eisai_groupC,1,5,ts-global_detected_seizures,113901,113934,33
Jensen_Eisai_groupC,2,6,ts-global_detected_seizures,113958,114046,88
Jensen_Eisai_groupC,1,5,ts-global_detected_seizures,114027,114095,68
Jensen_Eisai_groupC,2,6,ts-global_detected_seizures,114053,114077,24
Jensen_Eisai_groupC,2,6,ts-global_detected_seizures,114081,114113,32
Jensen_Eisai_groupC,1,5,ts-global_detected_seizures,114106,114130,24
Jensen_Eisai_groupC,2,6,ts-global_detected_seizures,114118,114164,46
Jensen_Eisai_groupC,1,5,ts-global_detected_seizures,114166,114207,41
Jensen_Eisai_groupC,2,6,ts-global_detected_seizures,114170,114226,56
Jensen_Eisai_groupC,2,6,ts-global_detected_seizures,114247,114269,22
Jensen_Eisai_groupC,2,6,ts-global_detected_seizures,114278,115227,949
Jensen_Eisai_groupC,1,5,ts-global_detected_seizures,114296,114343,47
Jensen_Eisai_groupC,1,5,ts-global_detected_seizures,114381,114404,23
Jensen_Eisai_groupC,1,5,ts-global_detected_seizures,114412,114438,26
Jensen_Eisai_groupC,1,5,ts-global_detected_seizures,114448,114482,34
Jensen_Eisai_groupC,1,5,ts-global_detected_seizures,114510,114580,70
Jensen_Eisai_groupC,1,5,ts-global_detected_seizures,114596,114639,43
Jensen_Eisai_groupC,1,5,ts-global_detected_seizures,114682,114728,46
Jensen_Eisai_groupC,1,5,ts-global_detected_seizures,114837,114932,95
Jensen_Eisai_groupC,1,5,ts-global_detected_seizures,114935,114989,54
Jensen_Eisai_groupC,1,5,ts-global_detected_seizures,115003,115028,25
Jensen_Eisai_groupC,1,5,ts-global_detected_seizures,115029,115297,268
Jensen_Eisai_groupC,2,6,ts-global_detected_seizures,115258,115285,27
Jensen_Eisai_groupC,2,6,ts-global_detected_seizures,115293,115610,317
Jensen_Eisai_groupC,1,5,ts-global_detected_seizures,115302,115338,36
Jensen_Eisai_groupC,1,5,ts-global_detected_seizures,115359,115395,36
Jensen_Eisai_groupC,1,5,ts-global_detected_seizures,115432,115475,43
Jensen_Eisai_groupC,1,5,ts-global_detected_seizures,115530,115574,44
Jensen_Eisai_groupC,1,5,ts-global_detected_seizures,115575,115620,45
Jensen_Eisai_groupC,1,5,ts-global_detected_seizures,115621,115692,71
Jensen_Eisai_groupC,2,6,ts-global_detected_seizures,115655,115694,39
Jensen_Eisai_groupC,1,5,ts-global_detected_seizures,115693,115718,25
Jensen_Eisai_groupC,1,5,ts-global_detected_seizures,115719,115775,56
Jensen_Eisai_groupC,2,6,ts-global_detected_seizures,115727,115756,29
Jensen_Eisai_groupC,2,6,ts-global_detected_seizures,115807,115835,28
Jensen_Eisai_groupC,1,5,ts-global_detected_seizures,115834,115875,41
Jensen_Eisai_groupC,2,6,ts-global_detected_seizures,115847,115870,23
Jensen_Eisai_groupC,1,5,ts-global_detected_seizures,115910,116926,1016
Jensen_Eisai_groupC,2,6,ts-global_detected_seizures,115921,116001,80
Jensen_Eisai_groupC,2,6,ts-global_detected_seizures,116013,116037,24
Jensen_Eisai_groupC,2,6,ts-global_detected_seizures,116171,116198,27
Jensen_Eisai_groupC,2,6,ts-global_detected_seizures,116294,116346,52
Jensen_Eisai_groupC,2,6,ts-global_detected_seizures,116447,116480,33
Jensen_Eisai_groupC,2,6,ts-global_detected_seizures,116510,116533,23
Jensen_Eisai_groupC,2,6,ts-global_detected_seizures,116828,116864,36
Jensen_Eisai_groupC,2,6,ts-global_detected_seizures,116865,116891,26
Jensen_Eisai_groupC,1,5,ts-global_detected_seizures,116927,117986,1059
Jensen_Eisai_groupC,2,6,ts-global_detected_seizures,116984,117017,33
Jensen_Eisai_groupC,2,6,ts-global_detected_seizures,117021,117062,41
Jensen_Eisai_groupC,2,6,ts-global_detected_seizures,117100,117158,58
Jensen_Eisai_groupC,2,6,ts-global_detected_seizures,117159,117182,23
Jensen_Eisai_groupC,2,6,ts-global_detected_seizures,117587,117618,31
Jensen_Eisai_groupC,2,6,ts-global_detected_seizures,117641,117672,31
Jensen_Eisai_groupC,2,6,ts-global_detected_seizures,117750,117774,24
Jensen_Eisai_groupC,2,6,ts-global_detected_seizures,117775,117804,29
Jensen_Eisai_groupC,2,6,ts-global_detected_seizures,117893,117921,28
Jensen_Eisai_groupC,1,5,ts-global_detected_seizures,118000,118094,94
Jensen_Eisai_groupC,2,6,ts-global_detected_seizures,118049,118075,26
Jensen_Eisai_groupC,1,5,ts-global_detected_seizures,118095,118161,66
Jensen_Eisai_groupC,2,6,ts-global_detected_seizures,118154,118181,27
Jensen_Eisai_groupC,1,5,ts-global_detected_seizures,118163,118196,33
Jensen_Eisai_groupC,2,6,ts-global_detected_seizures,118241,118274,33
Jensen_Eisai_groupC,1,5,ts-global_detected_seizures,118279,118318,39
Jensen_Eisai_groupC,2,6,ts-global_detected_seizures,118364,118392,28
Jensen_Eisai_groupC,2,6,ts-global_detected_seizures,118393,118512,119
Jensen_Eisai_groupC,1,5,ts-global_detected_seizures,118412,118435,23
Jensen_Eisai_groupC,1,5,ts-global_detected_seizures,118436,118507,71
Jensen_Eisai_groupC,1,5,ts-global_detected_seizures,118508,118554,46
Jensen_Eisai_groupC,1,5,ts-global_detected_seizures,118556,118595,39
Jensen_Eisai_groupC,1,5,ts-global_detected_seizures,118682,118710,28
Jensen_Eisai_groupC,2,6,ts-global_detected_seizures,118707,118731,24
Jensen_Eisai_groupC,1,5,ts-global_detected_seizures,118754,118788,34
Jensen_Eisai_groupC,2,6,ts-global_detected_seizures,118793,118819,26
Jensen_Eisai_groupC,1,5,ts-global_detected_seizures,118795,118820,25
Jensen_Eisai_groupC,1,5,ts-global_detected_seizures,118824,118851,27
Jensen_Eisai_groupC,2,6,ts-global_detected_seizures,118862,118885,23
Jensen_Eisai_groupC,1,5,ts-global_detected_seizures,118900,118948,48
Jensen_Eisai_groupC,2,6,ts-global_detected_seizures,118931,118958,27
Jensen_Eisai_groupC,2,6,ts-global_detected_seizures,118973,119005,32
Jensen_Eisai_groupC,1,5,ts-global_detected_seizures,119034,119074,40
Jensen_Eisai_groupC,2,6,ts-global_detected_seizures,119055,119079,24
Jensen_Eisai_groupC,1,5,ts-global_detected_seizures,119101,119141,40
Jensen_Eisai_groupC,1,5,ts-global_detected_seizures,119182,119224,42
Jensen_Eisai_groupC,2,6,ts-global_detected_seizures,119219,119257,38
Jensen_Eisai_groupC,1,5,ts-global_detected_seizures,119225,119264,39
Jensen_Eisai_groupC,1,5,ts-global_detected_seizures,119286,119358,72
Jensen_Eisai_groupC,2,6,ts-global_detected_seizures,119290,119350,60
Jensen_Eisai_groupC,1,5,ts-global_detected_seizures,119361,119385,24
Jensen_Eisai_groupC,2,6,ts-global_detected_seizures,119362,119448,86
Jensen_Eisai_groupC,1,5,ts-global_detected_seizures,119390,119413,23
Jensen_Eisai_groupC,1,5,ts-global_detected_seizures,119443,119482,39
Jensen_Eisai_groupC,2,6,ts-global_detected_seizures,119476,119518,42
Jensen_Eisai_groupC,1,5,ts-global_detected_seizures,119509,119581,72
Jensen_Eisai_groupC,1,5,ts-global_detected_seizures,119619,119678,59
Jensen_Eisai_groupC,1,5,ts-global_detected_seizures,119719,119771,52
Jensen_Eisai_groupC,2,6,ts-global_detected_seizures,119728,119776,48
Jensen_Eisai_groupC,1,5,ts-global_detected_seizures,119783,119842,59
Jensen_Eisai_groupC,2,6,ts-global_detected_seizures,119805,119846,41
Jensen_Eisai_groupC,2,6,ts-global_detected_seizures,119856,119893,37
Jensen_Eisai_groupC,1,5,ts-global_detected_seizures,119868,119893,25
Jensen_Eisai_groupC,2,6,ts-global_detected_seizures,119963,119990,27
Jensen_Eisai_groupC,1,5,ts-global_detected_seizures,119980,120067,87
Jensen_Eisai_groupC,2,6,ts-global_detected_seizures,120011,120040,29
Jensen_Eisai_groupC,1,5,ts-global_detected_seizures,120069,120267,198
Jensen_Eisai_groupC,2,6,ts-global_detected_seizures,120080,120104,24
Jensen_Eisai_groupC,2,6,ts-global_detected_seizures,120129,120156,27
Jensen_Eisai_groupC,2,6,ts-global_detected_seizures,120157,120214,57
Jensen_Eisai_groupC,2,6,ts-global_detected_seizures,120215,120245,30
Jensen_Eisai_groupC,1,5,ts-global_detected_seizures,120268,120304,36
Jensen_Eisai_groupC,2,6,ts-global_detected_seizures,120293,120342,49
Jensen_Eisai_groupC,1,5,ts-global_detected_seizures,120310,120339,29
Jensen_Eisai_groupC,1,5,ts-global_detected_seizures,120340,120478,138
Jensen_Eisai_groupC,2,6,ts-global_detected_seizures,120351,120373,22
Jensen_Eisai_groupC,2,6,ts-global_detected_seizures,120412,120439,27
Jensen_Eisai_groupC,1,5,ts-global_detected_seizures,120480,120517,37
Jensen_Eisai_groupC,2,6,ts-global_detected_seizures,120510,120544,34
Jensen_Eisai_groupC,1,5,ts-global_detected_seizures,120540,120581,41
Jensen_Eisai_groupC,1,5,ts-global_detected_seizures,120588,120718,130
Jensen_Eisai_groupC,2,6,ts-global_detected_seizures,120598,120637,39
Jensen_Eisai_groupC,2,6,ts-global_detected_seizures,120692,120714,22
Jensen_Eisai_groupC,1,5,ts-global_detected_seizures,120719,120768,49
Jensen_Eisai_groupC,2,6,ts-global_detected_seizures,120730,120763,33
Jensen_Eisai_groupC,2,6,ts-global_detected_seizures,120764,120817,53
Jensen_Eisai_groupC,1,5,ts-global_detected_seizures,120769,120814,45
Jensen_Eisai_groupC,1,5,ts-global_detected_seizures,120815,120851,36
Jensen_Eisai_groupC,2,6,ts-global_detected_seizures,120820,121717,897
Jensen_Eisai_groupC,1,5,ts-global_detected_seizures,120873,120920,47
Jensen_Eisai_groupC,1,5,ts-global_detected_seizures,120978,121002,24
Jensen_Eisai_groupC,1,5,ts-global_detected_seizures,121003,121087,84
Jensen_Eisai_groupC,1,5,ts-global_detected_seizures,121091,121121,30
Jensen_Eisai_groupC,1,5,ts-global_detected_seizures,121158,121199,41
Jensen_Eisai_groupC,1,5,ts-global_detected_seizures,121264,121330,66
Jensen_Eisai_groupC,1,5,ts-global_detected_seizures,121331,121391,60
Jensen_Eisai_groupC,1,5,ts-global_detected_seizures,121426,121493,67
Jensen_Eisai_groupC,1,5,ts-global_detected_seizures,121545,121567,22
Jensen_Eisai_groupC,1,5,ts-global_detected_seizures,121615,121686,71
Jensen_Eisai_groupC,1,5,ts-global_detected_seizures,121719,121767,48
Jensen_Eisai_groupC,2,6,ts-global_detected_seizures,121732,121765,33
Jensen_Eisai_groupC,2,6,ts-global_detected_seizures,121770,121794,24
Jensen_Eisai_groupC,1,5,ts-global_detected_seizures,121779,121817,38
Jensen_Eisai_groupC,2,6,ts-global_detected_seizures,121821,121843,22
Jensen_Eisai_groupC,1,5,ts-global_detected_seizures,121859,121912,53
Jensen_Eisai_groupC,2,6,ts-global_detected_seizures,121861,121887,26
Jensen_Eisai_groupC,2,6,ts-global_detected_seizures,121907,121942,35
Jensen_Eisai_groupC,1,5,ts-global_detected_seizures,121923,121957,34
Jensen_Eisai_groupC,2,6,ts-global_detected_seizures,121959,121989,30
Jensen_Eisai_groupC,2,6,ts-global_detected_seizures,122034,122059,25
Jensen_Eisai_groupC,1,5,ts-global_detected_seizures,122085,122165,80
Jensen_Eisai_groupC,2,6,ts-global_detected_seizures,122124,122149,25
Jensen_Eisai_groupC,1,5,ts-global_detected_seizures,122169,122203,34
Jensen_Eisai_groupC,1,5,ts-global_detected_seizures,122221,122256,35
Jensen_Eisai_groupC,2,6,ts-global_detected_seizures,122225,122263,38
Jensen_Eisai_groupC,1,5,ts-global_detected_seizures,122257,122288,31
Jensen_Eisai_groupC,1,5,ts-global_detected_seizures,122300,122388,88
Jensen_Eisai_groupC,2,6,ts-global_detected_seizures,122325,122347,22
Jensen_Eisai_groupC,2,6,ts-global_detected_seizures,122371,122395,24
Jensen_Eisai_groupC,1,5,ts-global_detected_seizures,122397,122427,30
Jensen_Eisai_groupC,2,6,ts-global_detected_seizures,122427,122466,39
Jensen_Eisai_groupC,1,5,ts-global_detected_seizures,122429,122472,43
Jensen_Eisai_groupC,1,5,ts-global_detected_seizures,122503,122554,51
Jensen_Eisai_groupC,1,5,ts-global_detected_seizures,122590,122646,56
Jensen_Eisai_groupC,2,6,ts-global_detected_seizures,122682,122706,24
Jensen_Eisai_groupC,1,5,ts-global_detected_seizures,122684,122715,31
Jensen_Eisai_groupC,1,5,ts-global_detected_seizures,122769,122887,118
Jensen_Eisai_groupC,2,6,ts-global_detected_seizures,122804,122826,22
Jensen_Eisai_groupC,1,5,ts-global_detected_seizures,122898,122987,89
Jensen_Eisai_groupC,2,6,ts-global_detected_seizures,122925,122957,32
Jensen_Eisai_groupC,1,5,ts-global_detected_seizures,122992,123018,26
Jensen_Eisai_groupC,1,5,ts-global_detected_seizures,123020,123057,37
Jensen_Eisai_groupC,2,6,ts-global_detected_seizures,123058,123082,24
Jensen_Eisai_groupC,1,5,ts-global_detected_seizures,123067,123110,43
Jensen_Eisai_groupC,1,5,ts-global_detected_seizures,123113,123137,24
Jensen_Eisai_groupC,1,5,ts-global_detected_seizures,123150,123193,43
Jensen_Eisai_groupC,1,5,ts-global_detected_seizures,123215,123272,57
Jensen_Eisai_groupC,2,6,ts-global_detected_seizures,123264,123310,46
Jensen_Eisai_groupC,1,5,ts-global_detected_seizures,123299,123348,49
Jensen_Eisai_groupC,2,6,ts-global_detected_seizures,123313,123355,42
Jensen_Eisai_groupC,1,5,ts-global_detected_seizures,123364,123397,33
Jensen_Eisai_groupC,2,6,ts-global_detected_seizures,123386,123412,26
Jensen_Eisai_groupC,1,5,ts-global_detected_seizures,123417,123448,31
Jensen_Eisai_groupC,1,5,ts-global_detected_seizures,123462,123570,108
Jensen_Eisai_groupC,2,6,ts-global_detected_seizures,123491,123547,56
Jensen_Eisai_groupC,1,5,ts-global_detected_seizures,123573,123711,138
Jensen_Eisai_groupC,2,6,ts-global_detected_seizures,123593,123617,24
Jensen_Eisai_groupC,1,5,ts-global_detected_seizures,123739,123794,55
Jensen_Eisai_groupC,2,6,ts-global_detected_seizures,123749,123777,28
Jensen_Eisai_groupC,2,6,ts-global_detected_seizures,123786,123826,40
Jensen_Eisai_groupC,1,5,ts-global_detected_seizures,123803,123853,50
Jensen_Eisai_groupC,1,5,ts-global_detected_seizures,123904,123958,54
Jensen_Eisai_groupC,2,6,ts-global_detected_seizures,123910,123933,23
Jensen_Eisai_groupC,1,5,ts-global_detected_seizures,123959,124011,52
Jensen_Eisai_groupC,2,6,ts-global_detected_seizures,123993,124029,36
Jensen_Eisai_groupC,1,5,ts-global_detected_seizures,124012,124094,82
Jensen_Eisai_groupC,1,5,ts-global_detected_seizures,124106,124138,32
Jensen_Eisai_groupC,2,6,ts-global_detected_seizures,124114,124144,30
Jensen_Eisai_groupC,2,6,ts-global_detected_seizures,124161,124183,22
Jensen_Eisai_groupC,2,6,ts-global_detected_seizures,124195,124219,24
Jensen_Eisai_groupC,1,5,ts-global_detected_seizures,124199,124266,67
Jensen_Eisai_groupC,2,6,ts-global_detected_seizures,124247,124276,29
Jensen_Eisai_groupC,1,5,ts-global_detected_seizures,124268,124806,538
Jensen_Eisai_groupC,2,6,ts-global_detected_seizures,124349,124375,26
Jensen_Eisai_groupC,2,6,ts-global_detected_seizures,124712,124738,26
Jensen_Eisai_groupC,2,6,ts-global_detected_seizures,124777,124802,25
Jensen_Eisai_groupC,2,6,ts-global_detected_seizures,124818,124858,40
Jensen_Eisai_groupC,2,6,ts-global_detected_seizures,124882,124910,28
Jensen_Eisai_groupC,1,5,ts-global_detected_seizures,124886,124919,33
Jensen_Eisai_groupC,1,5,ts-global_detected_seizures,124937,125734,797
Jensen_Eisai_groupC,2,6,ts-global_detected_seizures,124946,124981,35
Jensen_Eisai_groupC,2,6,ts-global_detected_seizures,124994,125018,24
Jensen_Eisai_groupC,2,6,ts-global_detected_seizures,125021,125047,26
Jensen_Eisai_groupC,2,6,ts-global_detected_seizures,125050,125088,38
Jensen_Eisai_groupC,2,6,ts-global_detected_seizures,125095,125147,52
Jensen_Eisai_groupC,2,6,ts-global_detected_seizures,125151,125201,50
Jensen_Eisai_groupC,2,6,ts-global_detected_seizures,125202,125631,429
Jensen_Eisai_groupC,2,6,ts-global_detected_seizures,125632,125722,90
Jensen_Eisai_groupC,1,5,ts-global_detected_seizures,125745,125813,68
Jensen_Eisai_groupC,2,6,ts-global_detected_seizures,125748,125779,31
Jensen_Eisai_groupC,1,5,ts-global_detected_seizures,125863,125893,30
Jensen_Eisai_groupC,1,5,ts-global_detected_seizures,125899,125943,44
Jensen_Eisai_groupC,2,6,ts-global_detected_seizures,125918,125952,34
Jensen_Eisai_groupC,1,5,ts-global_detected_seizures,125962,126046,84
Jensen_Eisai_groupC,2,6,ts-global_detected_seizures,126008,126036,28
Jensen_Eisai_groupC,1,5,ts-global_detected_seizures,126048,126219,171
Jensen_Eisai_groupC,2,6,ts-global_detected_seizures,126093,126120,27
Jensen_Eisai_groupC,2,6,ts-global_detected_seizures,126139,126162,23
Jensen_Eisai_groupC,1,5,ts-global_detected_seizures,126220,126246,26
Jensen_Eisai_groupC,1,5,ts-global_detected_seizures,126247,126310,63
Jensen_Eisai_groupC,2,6,ts-global_detected_seizures,126265,126292,27
Jensen_Eisai_groupC,2,6,ts-global_detected_seizures,126327,126350,23
Jensen_Eisai_groupC,1,5,ts-global_detected_seizures,126342,126367,25
Jensen_Eisai_groupC,2,6,ts-global_detected_seizures,126365,126453,88
Jensen_Eisai_groupC,1,5,ts-global_detected_seizures,126371,126403,32
Jensen_Eisai_groupC,1,5,ts-global_detected_seizures,126438,126502,64
Jensen_Eisai_groupC,1,5,ts-global_detected_seizures,126504,126532,28
Jensen_Eisai_groupC,2,6,ts-global_detected_seizures,126532,126558,26
Jensen_Eisai_groupC,1,5,ts-global_detected_seizures,126609,126659,50
Jensen_Eisai_groupC,2,6,ts-global_detected_seizures,126653,126676,23
Jensen_Eisai_groupC,1,5,ts-global_detected_seizures,126660,126692,32
Jensen_Eisai_groupC,1,5,ts-global_detected_seizures,126700,126789,89
Jensen_Eisai_groupC,2,6,ts-global_detected_seizures,126703,127287,584
Jensen_Eisai_groupC,1,5,ts-global_detected_seizures,126830,126860,30
Jensen_Eisai_groupC,1,5,ts-global_detected_seizures,126861,126901,40
Jensen_Eisai_groupC,1,5,ts-global_detected_seizures,126906,126961,55
Jensen_Eisai_groupC,1,5,ts-global_detected_seizures,126975,127007,32
Jensen_Eisai_groupC,1,5,ts-global_detected_seizures,127038,127070,32
Jensen_Eisai_groupC,1,5,ts-global_detected_seizures,127086,127173,87
Jensen_Eisai_groupC,1,5,ts-global_detected_seizures,127174,127231,57
Jensen_Eisai_groupC,1,5,ts-global_detected_seizures,127232,127326,94
Jensen_Eisai_groupC,2,6,ts-global_detected_seizures,127288,127339,51
Jensen_Eisai_groupC,1,5,ts-global_detected_seizures,127345,127374,29
Jensen_Eisai_groupC,2,6,ts-global_detected_seizures,127352,127378,26
Jensen_Eisai_groupC,2,6,ts-global_detected_seizures,127385,127408,23
Jensen_Eisai_groupC,1,5,ts-global_detected_seizures,127395,127489,94
Jensen_Eisai_groupC,2,6,ts-global_detected_seizures,127409,127497,88
Jensen_Eisai_groupC,1,5,ts-global_detected_seizures,127494,127647,153
Jensen_Eisai_groupC,2,6,ts-global_detected_seizures,127583,127605,22
Jensen_Eisai_groupC,1,5,ts-global_detected_seizures,127648,127744,96
Jensen_Eisai_groupC,2,6,ts-global_detected_seizures,127649,127677,28
Jensen_Eisai_groupC,2,6,ts-global_detected_seizures,127699,127748,49
Jensen_Eisai_groupC,1,5,ts-global_detected_seizures,127767,127805,38
Jensen_Eisai_groupC,2,6,ts-global_detected_seizures,127820,127850,30
Jensen_Eisai_groupC,1,5,ts-global_detected_seizures,127825,127848,23
Jensen_Eisai_groupC,2,6,ts-global_detected_seizures,127880,127904,24
Jensen_Eisai_groupC,2,6,ts-global_detected_seizures,127929,127952,23
Jensen_Eisai_groupC,2,6,ts-global_detected_seizures,128014,128045,31
Jensen_Eisai_groupC,2,6,ts-global_detected_seizures,128097,128275,178
Jensen_Eisai_groupC,2,6,ts-global_detected_seizures,128291,128326,35
Jensen_Eisai_groupC,1,5,ts-global_detected_seizures,128297,128496,199
Jensen_Eisai_groupC,2,6,ts-global_detected_seizures,128327,128696,369
Jensen_Eisai_groupC,1,5,ts-global_detected_seizures,128497,128642,145
Jensen_Eisai_groupC,1,5,ts-global_detected_seizures,128643,128840,197
Jensen_Eisai_groupC,2,6,ts-global_detected_seizures,128697,128931,234
Jensen_Eisai_groupC,1,5,ts-global_detected_seizures,128841,129692,851
Jensen_Eisai_groupC,2,6,ts-global_detected_seizures,128949,129358,409
Jensen_Eisai_groupC,2,6,ts-global_detected_seizures,129377,129410,33
Jensen_Eisai_groupC,2,6,ts-global_detected_seizures,129411,129446,35
Jensen_Eisai_groupC,1,5,ts-global_detected_seizures,129693,130096,403
Jensen_Eisai_groupC,1,5,ts-global_detected_seizures,130107,130453,346
Jensen_Eisai_groupC,2,6,ts-global_detected_seizures,130388,130417,29
Jensen_Eisai_groupC,1,5,ts-global_detected_seizures,130454,130613,159
Jensen_Eisai_groupC,1,5,ts-global_detected_seizures,130614,130645,31
Jensen_Eisai_groupC,1,5,ts-global_detected_seizures,130646,130873,227
Jensen_Eisai_groupC,2,6,ts-global_detected_seizures,130807,130831,24
Jensen_Eisai_groupC,1,5,ts-global_detected_seizures,130903,131099,196
Jensen_Eisai_groupC,1,5,ts-global_detected_seizures,131100,131395,295
Jensen_Eisai_groupC,1,5,ts-global_detected_seizures,131397,131447,50
Jensen_Eisai_groupC,1,5,ts-global_detected_seizures,131448,131527,79
Jensen_Eisai_groupC,1,5,ts-global_detected_seizures,131528,131741,213
Jensen_Eisai_groupC,2,6,ts-global_detected_seizures,131634,131656,22
Jensen_Eisai_groupC,1,5,ts-global_detected_seizures,131750,131992,242
Jensen_Eisai_groupC,1,5,ts-global_detected_seizures,131993,132122,129
Jensen_Eisai_groupC,2,6,ts-global_detected_seizures,132012,132036,24
Jensen_Eisai_groupC,1,5,ts-global_detected_seizures,132142,132346,204
Jensen_Eisai_groupC,1,5,ts-global_detected_seizures,132348,132515,167
Jensen_Eisai_groupC,1,5,ts-global_detected_seizures,132516,132626,110
Jensen_Eisai_groupC,1,5,ts-global_detected_seizures,132627,132735,108
Jensen_Eisai_groupC,1,5,ts-global_detected_seizures,132736,132992,256
Jensen_Eisai_groupC,1,5,ts-global_detected_seizures,132993,133107,114
Jensen_Eisai_groupC,1,5,ts-global_detected_seizures,133109,133358,249
Jensen_Eisai_groupC,2,6,ts-global_detected_seizures,133326,133348,22
Jensen_Eisai_groupC,2,6,ts-global_detected_seizures,133370,133395,25
Jensen_Eisai_groupC,1,5,ts-global_detected_seizures,133382,133436,54
Jensen_Eisai_groupC,2,6,ts-global_detected_seizures,133396,133420,24
Jensen_Eisai_groupC,2,6,ts-global_detected_seizures,133430,133470,40
Jensen_Eisai_groupC,1,5,ts-global_detected_seizures,133445,133515,70
Jensen_Eisai_groupC,2,6,ts-global_detected_seizures,133503,133562,59
Jensen_Eisai_groupC,1,5,ts-global_detected_seizures,133516,133563,47
Jensen_Eisai_groupC,2,6,ts-global_detected_seizures,133564,133589,25
Jensen_Eisai_groupC,1,5,ts-global_detected_seizures,133631,133653,22
Jensen_Eisai_groupC,2,6,ts-global_detected_seizures,133633,133660,27
Jensen_Eisai_groupC,1,5,ts-global_detected_seizures,133661,133693,32
Jensen_Eisai_groupC,2,6,ts-global_detected_seizures,133677,133699,22
Jensen_Eisai_groupC,1,5,ts-global_detected_seizures,133694,133922,228
Jensen_Eisai_groupC,2,6,ts-global_detected_seizures,133732,133762,30
Jensen_Eisai_groupC,2,6,ts-global_detected_seizures,133810,133881,71
Jensen_Eisai_groupC,2,6,ts-global_detected_seizures,133922,133944,22
Jensen_Eisai_groupC,1,5,ts-global_detected_seizures,133944,133966,22
Jensen_Eisai_groupC,1,5,ts-global_detected_seizures,133967,133993,26
Jensen_Eisai_groupC,1,5,ts-global_detected_seizures,133994,134143,149
Jensen_Eisai_groupC,2,6,ts-global_detected_seizures,134058,134110,52
Jensen_Eisai_groupC,1,5,ts-global_detected_seizures,134144,134277,133
Jensen_Eisai_groupC,2,6,ts-global_detected_seizures,134167,134199,32
Jensen_Eisai_groupC,2,6,ts-global_detected_seizures,134202,134234,32
Jensen_Eisai_groupC,2,6,ts-global_detected_seizures,134235,134259,24
Jensen_Eisai_groupC,1,5,ts-global_detected_seizures,134278,134325,47
Jensen_Eisai_groupC,2,6,ts-global_detected_seizures,134281,134311,30
Jensen_Eisai_groupC,2,6,ts-global_detected_seizures,134312,134359,47
Jensen_Eisai_groupC,1,5,ts-global_detected_seizures,134326,134605,279
Jensen_Eisai_groupC,2,6,ts-global_detected_seizures,134363,134390,27
Jensen_Eisai_groupC,2,6,ts-global_detected_seizures,134392,134465,73
Jensen_Eisai_groupC,2,6,ts-global_detected_seizures,134490,134514,24
Jensen_Eisai_groupC,2,6,ts-global_detected_seizures,134515,134545,30
Jensen_Eisai_groupC,2,6,ts-global_detected_seizures,134567,134660,93
Jensen_Eisai_groupC,1,5,ts-global_detected_seizures,134606,134822,216
Jensen_Eisai_groupC,2,6,ts-global_detected_seizures,134661,134686,25
Jensen_Eisai_groupC,2,6,ts-global_detected_seizures,134688,134758,70
Jensen_Eisai_groupC,2,6,ts-global_detected_seizures,134816,134842,26
Jensen_Eisai_groupC,1,5,ts-global_detected_seizures,134823,134969,146
Jensen_Eisai_groupC,2,6,ts-global_detected_seizures,134914,134941,27
Jensen_Eisai_groupC,2,6,ts-global_detected_seizures,134964,134987,23
Jensen_Eisai_groupC,1,5,ts-global_detected_seizures,134970,135414,444
Jensen_Eisai_groupC,2,6,ts-global_detected_seizures,135019,135045,26
Jensen_Eisai_groupC,2,6,ts-global_detected_seizures,135063,135120,57
Jensen_Eisai_groupC,2,6,ts-global_detected_seizures,135131,135158,27
Jensen_Eisai_groupC,2,6,ts-global_detected_seizures,135159,135193,34
Jensen_Eisai_groupC,2,6,ts-global_detected_seizures,135194,135229,35
Jensen_Eisai_groupC,1,5,ts-global_detected_seizures,135416,135443,27
Jensen_Eisai_groupC,1,5,ts-global_detected_seizures,135444,135579,135
Jensen_Eisai_groupC,2,6,ts-global_detected_seizures,135511,135612,101
Jensen_Eisai_groupC,1,5,ts-global_detected_seizures,135580,135904,324
Jensen_Eisai_groupC,2,6,ts-global_detected_seizures,135614,135647,33
Jensen_Eisai_groupC,2,6,ts-global_detected_seizures,135648,135724,76
Jensen_Eisai_groupC,2,6,ts-global_detected_seizures,135726,135781,55
Jensen_Eisai_groupC,2,6,ts-global_detected_seizures,135833,135880,47
Jensen_Eisai_groupC,1,5,ts-global_detected_seizures,135906,136172,266
Jensen_Eisai_groupC,2,6,ts-global_detected_seizures,136141,136326,185
Jensen_Eisai_groupC,1,5,ts-global_detected_seizures,136176,136290,114
Jensen_Eisai_groupC,1,5,ts-global_detected_seizures,136291,136757,466
Jensen_Eisai_groupC,2,6,ts-global_detected_seizures,136347,136406,59
Jensen_Eisai_groupC,2,6,ts-global_detected_seizures,136441,136560,119
Jensen_Eisai_groupC,2,6,ts-global_detected_seizures,136562,136595,33
Jensen_Eisai_groupC,2,6,ts-global_detected_seizures,136596,136626,30
Jensen_Eisai_groupC,2,6,ts-global_detected_seizures,136627,136654,27
Jensen_Eisai_groupC,2,6,ts-global_detected_seizures,136656,136739,83
Jensen_Eisai_groupC,2,6,ts-global_detected_seizures,136741,136772,31
Jensen_Eisai_groupC,1,5,ts-global_detected_seizures,136758,136858,100
Jensen_Eisai_groupC,1,5,ts-global_detected_seizures,136883,137224,341
Jensen_Eisai_groupC,2,6,ts-global_detected_seizures,137072,137188,116
Jensen_Eisai_groupC,2,6,ts-global_detected_seizures,137189,137260,71
Jensen_Eisai_groupC,1,5,ts-global_detected_seizures,137226,137322,96
Jensen_Eisai_groupC,2,6,ts-global_detected_seizures,137262,137291,29
Jensen_Eisai_groupC,2,6,ts-global_detected_seizures,137293,137360,67
Jensen_Eisai_groupC,1,5,ts-global_detected_seizures,137360,137473,113
Jensen_Eisai_groupC,1,5,ts-global_detected_seizures,137474,137666,192
Jensen_Eisai_groupC,1,5,ts-global_detected_seizures,137667,137746,79
Jensen_Eisai_groupC,1,5,ts-global_detected_seizures,137747,137917,170
Jensen_Eisai_groupC,1,5,ts-global_detected_seizures,137918,138039,121
Jensen_Eisai_groupC,2,6,ts-global_detected_seizures,137978,138001,23
Jensen_Eisai_groupC,1,5,ts-global_detected_seizures,138040,138140,100
Jensen_Eisai_groupC,1,5,ts-global_detected_seizures,138141,138250,109
Jensen_Eisai_groupC,1,5,ts-global_detected_seizures,138251,138303,52
Jensen_Eisai_groupC,1,5,ts-global_detected_seizures,138304,138329,25
Jensen_Eisai_groupC,1,5,ts-global_detected_seizures,138330,138413,83
Jensen_Eisai_groupC,1,5,ts-global_detected_seizures,138414,138598,184
Jensen_Eisai_groupC,2,6,ts-global_detected_seizures,138451,139143,692
Jensen_Eisai_groupC,1,5,ts-global_detected_seizures,138599,138674,75
Jensen_Eisai_groupC,1,5,ts-global_detected_seizures,138704,138922,218
Jensen_Eisai_groupC,1,5,ts-global_detected_seizures,138923,138980,57
Jensen_Eisai_groupC,1,5,ts-global_detected_seizures,138981,139083,102
Jensen_Eisai_groupC,1,5,ts-global_detected_seizures,139084,139124,40
Jensen_Eisai_groupC,1,5,ts-global_detected_seizures,139125,139270,145
Jensen_Eisai_groupC,2,6,ts-global_detected_seizures,139144,139601,457
Jensen_Eisai_groupC,1,5,ts-global_detected_seizures,139271,139373,102
Jensen_Eisai_groupC,1,5,ts-global_detected_seizures,139374,139396,22
Jensen_Eisai_groupC,1,5,ts-global_detected_seizures,139406,139566,160
Jensen_Eisai_groupC,1,5,ts-global_detected_seizures,139567,139603,36
Jensen_Eisai_groupC,1,5,ts-global_detected_seizures,139604,139651,47
Jensen_Eisai_groupC,1,5,ts-global_detected_seizures,139658,139777,119
Jensen_Eisai_groupC,1,5,ts-global_detected_seizures,139781,140217,436
Jensen_Eisai_groupC,2,6,ts-global_detected_seizures,139895,139918,23
Jensen_Eisai_groupC,2,6,ts-global_detected_seizures,140175,140212,37
Jensen_Eisai_groupC,1,5,ts-global_detected_seizures,140218,140258,40
Jensen_Eisai_groupC,1,5,ts-global_detected_seizures,140259,140408,149
Jensen_Eisai_groupC,1,5,ts-global_detected_seizures,140409,140452,43
Jensen_Eisai_groupC,2,6,ts-global_detected_seizures,140418,140458,40
Jensen_Eisai_groupC,1,5,ts-global_detected_seizures,140453,140569,116
Jensen_Eisai_groupC,1,5,ts-global_detected_seizures,140586,140708,122
Jensen_Eisai_groupC,1,5,ts-global_detected_seizures,140710,140770,60
Jensen_Eisai_groupC,1,5,ts-global_detected_seizures,140771,140810,39
Jensen_Eisai_groupC,2,6,ts-global_detected_seizures,140806,140836,30
Jensen_Eisai_groupC,1,5,ts-global_detected_seizures,140890,140933,43
Jensen_Eisai_groupC,2,6,ts-global_detected_seizures,140926,140948,22
Jensen_Eisai_groupC,2,6,ts-global_detected_seizures,140964,141045,81
Jensen_Eisai_groupC,1,5,ts-global_detected_seizures,140986,141086,100
Jensen_Eisai_groupC,2,6,ts-global_detected_seizures,141058,141098,40
Jensen_Eisai_groupC,1,5,ts-global_detected_seizures,141088,141168,80
Jensen_Eisai_groupC,2,6,ts-global_detected_seizures,141119,141173,54
Jensen_Eisai_groupC,1,5,ts-global_detected_seizures,141169,141426,257
Jensen_Eisai_groupC,2,6,ts-global_detected_seizures,141187,141211,24
Jensen_Eisai_groupC,1,5,ts-global_detected_seizures,141435,141465,30
Jensen_Eisai_groupC,1,5,ts-global_detected_seizures,141466,141748,282
Jensen_Eisai_groupC,1,5,ts-global_detected_seizures,141749,141792,43
Jensen_Eisai_groupC,2,6,ts-global_detected_seizures,141779,141810,31
Jensen_Eisai_groupC,1,5,ts-global_detected_seizures,141807,141873,66
Jensen_Eisai_groupC,2,6,ts-global_detected_seizures,141875,141898,23
Jensen_Eisai_groupC,1,5,ts-global_detected_seizures,141912,141945,33
Jensen_Eisai_groupC,2,6,ts-global_detected_seizures,142057,142570,513
Jensen_Eisai_groupC,1,5,ts-global_detected_seizures,142063,142147,84
Jensen_Eisai_groupC,1,5,ts-global_detected_seizures,142148,142237,89
Jensen_Eisai_groupC,1,5,ts-global_detected_seizures,142252,142307,55
Jensen_Eisai_groupC,1,5,ts-global_detected_seizures,142309,142400,91
Jensen_Eisai_groupC,1,5,ts-global_detected_seizures,142401,142700,299
Jensen_Eisai_groupC,2,6,ts-global_detected_seizures,142588,142873,285
Jensen_Eisai_groupC,1,5,ts-global_detected_seizures,142722,142780,58
Jensen_Eisai_groupC,1,5,ts-global_detected_seizures,142781,142950,169
Jensen_Eisai_groupC,2,6,ts-global_detected_seizures,142895,143245,350
Jensen_Eisai_groupC,1,5,ts-global_detected_seizures,142951,143065,114
Jensen_Eisai_groupC,1,5,ts-global_detected_seizures,143073,143100,27
Jensen_Eisai_groupC,1,5,ts-global_detected_seizures,143215,143247,32
Jensen_Eisai_groupC,2,6,ts-global_detected_seizures,143285,143533,248
Jensen_Eisai_groupC,1,5,ts-global_detected_seizures,143474,143504,30
Jensen_Eisai_groupC,2,6,ts-global_detected_seizures,143580,143606,26
Jensen_Eisai_groupC,2,6,ts-global_detected_seizures,143620,143658,38
Jensen_Eisai_groupC,2,6,ts-global_detected_seizures,143663,143689,26
Jensen_Eisai_groupC,1,5,ts-global_detected_seizures,143679,143712,33
Jensen_Eisai_groupC,2,6,ts-global_detected_seizures,143704,143747,43
Jensen_Eisai_groupC,2,6,ts-global_detected_seizures,143876,143899,23
Jensen_Eisai_groupC,2,6,ts-global_detected_seizures,143945,143997,52
Jensen_Eisai_groupC,1,5,ts-global_detected_seizures,144121,144156,35
Jensen_Eisai_groupC,1,5,ts-global_detected_seizures,144325,144368,43
Jensen_Eisai_groupC,2,6,ts-global_detected_seizures,144380,144420,40
Jensen_Eisai_groupC,2,6,ts-global_detected_seizures,144606,144629,23
Jensen_Eisai_groupC,2,6,ts-global_detected_seizures,144640,144719,79
Jensen_Eisai_groupC,2,6,ts-global_detected_seizures,144751,144797,46
Jensen_Eisai_groupC,2,6,ts-global_detected_seizures,144804,145288,484
Jensen_Eisai_groupC,1,5,ts-global_detected_seizures,144941,144967,26
Jensen_Eisai_groupC,1,5,ts-global_detected_seizures,145102,145135,33
Jensen_Eisai_groupC,1,5,ts-global_detected_seizures,145273,145308,35
Jensen_Eisai_groupC,2,6,ts-global_detected_seizures,145289,145347,58
Jensen_Eisai_groupC,2,6,ts-global_detected_seizures,145348,145552,204
Jensen_Eisai_groupC,1,5,ts-global_detected_seizures,145377,145399,22
Jensen_Eisai_groupC,1,5,ts-global_detected_seizures,145624,145647,23
Jensen_Eisai_groupC,1,5,ts-global_detected_seizures,145664,145693,29
Jensen_Eisai_groupC,1,5,ts-global_detected_seizures,145743,145765,22
Jensen_Eisai_groupC,1,5,ts-global_detected_seizures,145790,147161,1371
Jensen_Eisai_groupC,2,6,ts-global_detected_seizures,146249,146271,22
Jensen_Eisai_groupC,2,6,ts-global_detected_seizures,146591,147329,738
Jensen_Eisai_groupC,1,5,ts-global_detected_seizures,147176,148194,1018
Jensen_Eisai_groupC,2,6,ts-global_detected_seizures,147343,147368,25
Jensen_Eisai_groupC,2,6,ts-global_detected_seizures,147400,147433,33
Jensen_Eisai_groupC,2,6,ts-global_detected_seizures,147553,147583,30
Jensen_Eisai_groupC,2,6,ts-global_detected_seizures,147598,147637,39
Jensen_Eisai_groupC,2,6,ts-global_detected_seizures,147702,147729,27
Jensen_Eisai_groupC,2,6,ts-global_detected_seizures,147763,147792,29
Jensen_Eisai_groupC,1,5,ts-global_detected_seizures,148195,148406,211
Jensen_Eisai_groupC,2,6,ts-global_detected_seizures,148212,148234,22
Jensen_Eisai_groupC,2,6,ts-global_detected_seizures,148303,148728,425
Jensen_Eisai_groupC,1,5,ts-global_detected_seizures,148407,149196,789
Jensen_Eisai_groupC,2,6,ts-global_detected_seizures,148729,149371,642
Jensen_Eisai_groupC,1,5,ts-global_detected_seizures,149197,149487,290
Jensen_Eisai_groupC,2,6,ts-global_detected_seizures,149372,150134,762
Jensen_Eisai_groupC,1,5,ts-global_detected_seizures,149492,149908,416
Jensen_Eisai_groupC,1,5,ts-global_detected_seizures,149909,150085,176
Jensen_Eisai_groupC,1,5,ts-global_detected_seizures,150086,150208,122
Jensen_Eisai_groupC,2,6,ts-global_detected_seizures,150135,151054,919
Jensen_Eisai_groupC,1,5,ts-global_detected_seizures,150209,150356,147
Jensen_Eisai_groupC,1,5,ts-global_detected_seizures,150357,150423,66
Jensen_Eisai_groupC,1,5,ts-global_detected_seizures,150536,150563,27
Jensen_Eisai_groupC,1,5,ts-global_detected_seizures,150568,150691,123
Jensen_Eisai_groupC,1,5,ts-global_detected_seizures,150705,151065,360
Jensen_Eisai_groupC,1,5,ts-global_detected_seizures,151066,151239,173
Jensen_Eisai_groupC,2,6,ts-global_detected_seizures,151070,151115,45
Jensen_Eisai_groupC,2,6,ts-global_detected_seizures,151142,151397,255
Jensen_Eisai_groupC,1,5,ts-global_detected_seizures,151240,151587,347
Jensen_Eisai_groupC,1,5,ts-global_detected_seizures,151608,151779,171
Jensen_Eisai_groupC,1,5,ts-global_detected_seizures,151780,151863,83
Jensen_Eisai_groupC,1,5,ts-global_detected_seizures,151864,152410,546
Jensen_Eisai_groupC,2,6,ts-global_detected_seizures,151894,151926,32
Jensen_Eisai_groupC,2,6,ts-global_detected_seizures,152055,152129,74
Jensen_Eisai_groupC,2,6,ts-global_detected_seizures,152303,152335,32
Jensen_Eisai_groupC,1,5,ts-global_detected_seizures,152411,152848,437
Jensen_Eisai_groupC,2,6,ts-global_detected_seizures,152442,152473,31
Jensen_Eisai_groupC,2,6,ts-global_detected_seizures,152562,152655,93
Jensen_Eisai_groupC,2,6,ts-global_detected_seizures,152656,152850,194
Jensen_Eisai_groupC,1,5,ts-global_detected_seizures,152849,153023,174
Jensen_Eisai_groupC,1,5,ts-global_detected_seizures,153024,153049,25
Jensen_Eisai_groupC,1,5,ts-global_detected_seizures,153050,153522,472
Jensen_Eisai_groupC,2,6,ts-global_detected_seizures,153109,153137,28
Jensen_Eisai_groupC,2,6,ts-global_detected_seizures,153180,153213,33
Jensen_Eisai_groupC,2,6,ts-global_detected_seizures,153399,153430,31
Jensen_Eisai_groupC,2,6,ts-global_detected_seizures,153456,153513,57
Jensen_Eisai_groupC,1,5,ts-global_detected_seizures,153523,153639,116
Jensen_Eisai_groupC,2,6,ts-global_detected_seizures,153658,153681,23
Jensen_Eisai_groupC,1,5,ts-global_detected_seizures,153726,153773,47
Jensen_Eisai_groupC,2,6,ts-global_detected_seizures,153771,153809,38
Jensen_Eisai_groupC,1,5,ts-global_detected_seizures,153774,154045,271
Jensen_Eisai_groupC,2,6,ts-global_detected_seizures,153820,153844,24
Jensen_Eisai_groupC,2,6,ts-global_detected_seizures,153973,154018,45
Jensen_Eisai_groupC,1,5,ts-global_detected_seizures,154046,154411,365
Jensen_Eisai_groupC,2,6,ts-global_detected_seizures,154117,154185,68
Jensen_Eisai_groupC,2,6,ts-global_detected_seizures,154209,154231,22
Jensen_Eisai_groupC,2,6,ts-global_detected_seizures,154334,154358,24
Jensen_Eisai_groupC,1,5,ts-global_detected_seizures,154412,154475,63
Jensen_Eisai_groupC,2,6,ts-global_detected_seizures,154535,154574,39
Jensen_Eisai_groupC,1,5,ts-global_detected_seizures,154617,154641,24
Jensen_Eisai_groupC,1,5,ts-global_detected_seizures,154668,154987,319
Jensen_Eisai_groupC,2,6,ts-global_detected_seizures,154686,154722,36
Jensen_Eisai_groupC,2,6,ts-global_detected_seizures,154726,154791,65
Jensen_Eisai_groupC,2,6,ts-global_detected_seizures,154890,154937,47
Jensen_Eisai_groupC,1,5,ts-global_detected_seizures,154988,155088,100
Jensen_Eisai_groupC,2,6,ts-global_detected_seizures,155138,155179,41
Jensen_Eisai_groupC,1,5,ts-global_detected_seizures,155142,155217,75
Jensen_Eisai_groupC,2,6,ts-global_detected_seizures,155306,155330,24
Jensen_Eisai_groupC,2,6,ts-global_detected_seizures,155433,155636,203
Jensen_Eisai_groupC,2,6,ts-global_detected_seizures,155638,155661,23
Jensen_Eisai_groupC,2,6,ts-global_detected_seizures,155689,155715,26
Jensen_Eisai_groupC,1,5,ts-global_detected_seizures,155709,155733,24
Jensen_Eisai_groupC,1,5,ts-global_detected_seizures,155905,156214,309
Jensen_Eisai_groupC,2,6,ts-global_detected_seizures,155971,155995,24
Jensen_Eisai_groupC,2,6,ts-global_detected_seizures,156206,156268,62
Jensen_Eisai_groupC,1,5,ts-global_detected_seizures,156215,156381,166
Jensen_Eisai_groupC,1,5,ts-global_detected_seizures,156382,156492,110
Jensen_Eisai_groupC,1,5,ts-global_detected_seizures,156516,156644,128
Jensen_Eisai_groupC,2,6,ts-global_detected_seizures,156601,156803,202
Jensen_Eisai_groupC,1,5,ts-global_detected_seizures,156645,156674,29
Jensen_Eisai_groupC,2,6,ts-global_detected_seizures,156811,156839,28
Jensen_Eisai_groupC,1,5,ts-global_detected_seizures,156829,156856,27
Jensen_Eisai_groupC,1,5,ts-global_detected_seizures,156829,156856,27
Jensen_Eisai_groupC,1,5,ts-global_detected_seizures,157045,157176,131
Jensen_Eisai_groupC,2,6,ts-global_detected_seizures,157059,157085,26
Jensen_Eisai_groupC,2,6,ts-global_detected_seizures,157132,157159,27
Jensen_Eisai_groupC,1,5,ts-global_detected_seizures,157177,157203,26
Jensen_Eisai_groupC,2,6,ts-global_detected_seizures,157179,157204,25
Jensen_Eisai_groupC,2,6,ts-global_detected_seizures,157279,157307,28
Jensen_Eisai_groupC,1,5,ts-global_detected_seizures,157314,157340,26
Jensen_Eisai_groupC,2,6,ts-global_detected_seizures,157334,157362,28
Jensen_Eisai_groupC,2,6,ts-global_detected_seizures,157426,160267,2841
Jensen_Eisai_groupC,1,5,ts-global_detected_seizures,157613,157654,41
Jensen_Eisai_groupC,1,5,ts-global_detected_seizures,157691,157715,24
Jensen_Eisai_groupC,1,5,ts-global_detected_seizures,157816,157944,128
Jensen_Eisai_groupC,1,5,ts-global_detected_seizures,158056,158081,25
Jensen_Eisai_groupC,1,5,ts-global_detected_seizures,158123,158149,26
Jensen_Eisai_groupC,1,5,ts-global_detected_seizures,158306,158353,47
Jensen_Eisai_groupC,1,5,ts-global_detected_seizures,158451,158473,22
Jensen_Eisai_groupC,1,5,ts-global_detected_seizures,158528,158559,31
Jensen_Eisai_groupC,1,5,ts-global_detected_seizures,158594,158625,31
Jensen_Eisai_groupC,1,5,ts-global_detected_seizures,158812,158843,31
Jensen_Eisai_groupC,1,5,ts-global_detected_seizures,158920,158946,26
Jensen_Eisai_groupC,1,5,ts-global_detected_seizures,159001,159036,35
Jensen_Eisai_groupC,1,5,ts-global_detected_seizures,159184,159282,98
Jensen_Eisai_groupC,1,5,ts-global_detected_seizures,159305,159328,23
Jensen_Eisai_groupC,1,5,ts-global_detected_seizures,159329,159351,22
Jensen_Eisai_groupC,1,5,ts-global_detected_seizures,159356,159388,32
Jensen_Eisai_groupC,1,5,ts-global_detected_seizures,159526,159553,27
Jensen_Eisai_groupC,1,5,ts-global_detected_seizures,159574,159604,30
Jensen_Eisai_groupC,1,5,ts-global_detected_seizures,159718,159876,158
Jensen_Eisai_groupC,1,5,ts-global_detected_seizures,159878,159908,30
Jensen_Eisai_groupC,1,5,ts-global_detected_seizures,159955,160017,62
Jensen_Eisai_groupC,1,5,ts-global_detected_seizures,160019,160044,25
Jensen_Eisai_groupC,1,5,ts-global_detected_seizures,160066,160090,24
Jensen_Eisai_groupC,1,5,ts-global_detected_seizures,160094,160118,24
Jensen_Eisai_groupC,1,5,ts-global_detected_seizures,160148,160174,26
Jensen_Eisai_groupC,1,5,ts-global_detected_seizures,160212,160235,23
Jensen_Eisai_groupC,2,6,ts-global_detected_seizures,160268,160458,190
Jensen_Eisai_groupC,1,5,ts-global_detected_seizures,160334,160373,39
Jensen_Eisai_groupC,1,5,ts-global_detected_seizures,160408,160437,29
Jensen_Eisai_groupC,1,5,ts-global_detected_seizures,160461,160484,23
Jensen_Eisai_groupC,2,6,ts-global_detected_seizures,160462,160484,22
Jensen_Eisai_groupC,1,5,ts-global_detected_seizures,160523,160557,34
Jensen_Eisai_groupC,2,6,ts-global_detected_seizures,160529,160551,22
Jensen_Eisai_groupC,2,6,ts-global_detected_seizures,160569,160591,22
Jensen_Eisai_groupC,1,5,ts-global_detected_seizures,160694,160723,29
Jensen_Eisai_groupC,1,5,ts-global_detected_seizures,160757,160812,55
Jensen_Eisai_groupC,2,6,ts-global_detected_seizures,160807,160833,26
Jensen_Eisai_groupC,1,5,ts-global_detected_seizures,160861,160889,28
Jensen_Eisai_groupC,2,6,ts-global_detected_seizures,160932,160978,46
Jensen_Eisai_groupC,1,5,ts-global_detected_seizures,160944,160991,47
Jensen_Eisai_groupC,1,5,ts-global_detected_seizures,161010,161034,24
Jensen_Eisai_groupC,2,6,ts-global_detected_seizures,161032,161058,26
Jensen_Eisai_groupC,1,5,ts-global_detected_seizures,161092,161131,39
Jensen_Eisai_groupC,2,6,ts-global_detected_seizures,161150,161172,22
Jensen_Eisai_groupC,2,6,ts-global_detected_seizures,161173,161198,25
Jensen_Eisai_groupC,1,5,ts-global_detected_seizures,161175,161202,27
Jensen_Eisai_groupC,1,5,ts-global_detected_seizures,161287,161316,29
Jensen_Eisai_groupC,1,5,ts-global_detected_seizures,161409,161555,146
Jensen_Eisai_groupC,2,6,ts-global_detected_seizures,161420,161451,31
Jensen_Eisai_groupC,2,6,ts-global_detected_seizures,161535,161564,29
Jensen_Eisai_groupC,1,5,ts-global_detected_seizures,161559,161586,27
Jensen_Eisai_groupC,2,6,ts-global_detected_seizures,161625,161654,29
Jensen_Eisai_groupC,1,5,ts-global_detected_seizures,161696,161738,42
Jensen_Eisai_groupC,2,6,ts-global_detected_seizures,161727,161753,26
Jensen_Eisai_groupC,1,5,ts-global_detected_seizures,161761,161809,48
Jensen_Eisai_groupC,1,5,ts-global_detected_seizures,161828,161908,80
Jensen_Eisai_groupC,2,6,ts-global_detected_seizures,161856,161977,121
Jensen_Eisai_groupC,1,5,ts-global_detected_seizures,161909,163514,1605
Jensen_Eisai_groupC,2,6,ts-global_detected_seizures,162220,162246,26
Jensen_Eisai_groupC,2,6,ts-global_detected_seizures,162484,162507,23
Jensen_Eisai_groupC,2,6,ts-global_detected_seizures,162625,162653,28
Jensen_Eisai_groupC,2,6,ts-global_detected_seizures,162741,162779,38
Jensen_Eisai_groupC,2,6,ts-global_detected_seizures,162799,162840,41
Jensen_Eisai_groupC,2,6,ts-global_detected_seizures,162847,162922,75
Jensen_Eisai_groupC,2,6,ts-global_detected_seizures,163003,163028,25
Jensen_Eisai_groupC,2,6,ts-global_detected_seizures,163151,163177,26
Jensen_Eisai_groupC,2,6,ts-global_detected_seizures,163186,163212,26
Jensen_Eisai_groupC,2,6,ts-global_detected_seizures,163275,163300,25
Jensen_Eisai_groupC,2,6,ts-global_detected_seizures,163360,163386,26
Jensen_Eisai_groupC,2,6,ts-global_detected_seizures,163404,163431,27
Jensen_Eisai_groupC,2,6,ts-global_detected_seizures,163444,163470,26
Jensen_Eisai_groupC,1,5,ts-global_detected_seizures,163515,163537,22
Jensen_Eisai_groupC,2,6,ts-global_detected_seizures,163541,163575,34
Jensen_Eisai_groupC,2,6,ts-global_detected_seizures,163582,163628,46
Jensen_Eisai_groupC,1,5,ts-global_detected_seizures,163586,163662,76
Jensen_Eisai_groupC,2,6,ts-global_detected_seizures,163638,163745,107
Jensen_Eisai_groupC,1,5,ts-global_detected_seizures,163677,163702,25
Jensen_Eisai_groupC,2,6,ts-global_detected_seizures,163839,163863,24
Jensen_Eisai_groupC,1,5,ts-global_detected_seizures,163856,163897,41
Jensen_Eisai_groupC,2,6,ts-global_detected_seizures,164103,164126,23
Jensen_Eisai_groupC,1,5,ts-global_detected_seizures,164193,164271,78
Jensen_Eisai_groupC,2,6,ts-global_detected_seizures,164248,164273,25
Jensen_Eisai_groupC,2,6,ts-global_detected_seizures,164283,164310,27
Jensen_Eisai_groupC,2,6,ts-global_detected_seizures,164340,164363,23
Jensen_Eisai_groupC,2,6,ts-global_detected_seizures,164427,164451,24
Jensen_Eisai_groupC,2,6,ts-global_detected_seizures,164490,164601,111
Jensen_Eisai_groupC,1,5,ts-global_detected_seizures,164544,164600,56
Jensen_Eisai_groupC,1,5,ts-global_detected_seizures,164684,164727,43
Jensen_Eisai_groupC,1,5,ts-global_detected_seizures,164735,164760,25
Jensen_Eisai_groupC,2,6,ts-global_detected_seizures,164755,164782,27
Jensen_Eisai_groupC,1,5,ts-global_detected_seizures,164796,164820,24
Jensen_Eisai_groupC,2,6,ts-global_detected_seizures,164818,164851,33
Jensen_Eisai_groupC,1,5,ts-global_detected_seizures,164825,164897,72
Jensen_Eisai_groupC,2,6,ts-global_detected_seizures,164879,164910,31
Jensen_Eisai_groupC,1,5,ts-global_detected_seizures,164905,164928,23
Jensen_Eisai_groupC,2,6,ts-global_detected_seizures,164998,165026,28
Jensen_Eisai_groupC,1,5,ts-global_detected_seizures,165012,165049,37
Jensen_Eisai_groupC,2,6,ts-global_detected_seizures,165076,165108,32
Jensen_Eisai_groupC,1,5,ts-global_detected_seizures,165099,165167,68
Jensen_Eisai_groupC,2,6,ts-global_detected_seizures,165153,165188,35
Jensen_Eisai_groupC,1,5,ts-global_detected_seizures,165189,165216,27
Jensen_Eisai_groupC,1,5,ts-global_detected_seizures,165230,165268,38
Jensen_Eisai_groupC,2,6,ts-global_detected_seizures,165257,165288,31
Jensen_Eisai_groupC,1,5,ts-global_detected_seizures,165271,165301,30
Jensen_Eisai_groupC,2,6,ts-global_detected_seizures,165289,165315,26
Jensen_Eisai_groupC,1,5,ts-global_detected_seizures,165380,165404,24
Jensen_Eisai_groupC,2,6,ts-global_detected_seizures,165386,165412,26
Jensen_Eisai_groupC,2,6,ts-global_detected_seizures,165413,165436,23
Jensen_Eisai_groupC,2,6,ts-global_detected_seizures,165447,165610,163
Jensen_Eisai_groupC,1,5,ts-global_detected_seizures,165471,165553,82
Jensen_Eisai_groupC,1,5,ts-global_detected_seizures,165578,165616,38
Jensen_Eisai_groupC,2,6,ts-global_detected_seizures,165622,165654,32
Jensen_Eisai_groupC,2,6,ts-global_detected_seizures,165655,165679,24
Jensen_Eisai_groupC,2,6,ts-global_detected_seizures,165697,165734,37
Jensen_Eisai_groupC,1,5,ts-global_detected_seizures,165699,165725,26
Jensen_Eisai_groupC,2,6,ts-global_detected_seizures,165790,165816,26
Jensen_Eisai_groupC,1,5,ts-global_detected_seizures,165799,165838,39
Jensen_Eisai_groupC,1,5,ts-global_detected_seizures,165844,165892,48
Jensen_Eisai_groupC,2,6,ts-global_detected_seizures,165865,165970,105
Jensen_Eisai_groupC,1,5,ts-global_detected_seizures,165921,165971,50
Jensen_Eisai_groupC,2,6,ts-global_detected_seizures,165971,166005,34
Jensen_Eisai_groupC,1,5,ts-global_detected_seizures,166032,166054,22
Jensen_Eisai_groupC,1,5,ts-global_detected_seizures,166092,166132,40
Jensen_Eisai_groupC,2,6,ts-global_detected_seizures,166153,166176,23
Jensen_Eisai_groupC,1,5,ts-global_detected_seizures,166163,166214,51
Jensen_Eisai_groupC,1,5,ts-global_detected_seizures,166261,166300,39
Jensen_Eisai_groupC,2,6,ts-global_detected_seizures,166265,166287,22
Jensen_Eisai_groupC,1,5,ts-global_detected_seizures,166310,166358,48
Jensen_Eisai_groupC,2,6,ts-global_detected_seizures,166328,166351,23
Jensen_Eisai_groupC,1,5,ts-global_detected_seizures,166367,166404,37
Jensen_Eisai_groupC,2,6,ts-global_detected_seizures,166409,166438,29
Jensen_Eisai_groupC,1,5,ts-global_detected_seizures,166441,166464,23
Jensen_Eisai_groupC,1,5,ts-global_detected_seizures,166491,166526,35
Jensen_Eisai_groupC,2,6,ts-global_detected_seizures,166540,166562,22
Jensen_Eisai_groupC,1,5,ts-global_detected_seizures,166552,166626,74
Jensen_Eisai_groupC,2,6,ts-global_detected_seizures,166610,166638,28
Jensen_Eisai_groupC,1,5,ts-global_detected_seizures,166628,166659,31
Jensen_Eisai_groupC,2,6,ts-global_detected_seizures,166682,166723,41
Jensen_Eisai_groupC,1,5,ts-global_detected_seizures,166689,166721,32
Jensen_Eisai_groupC,1,5,ts-global_detected_seizures,166741,168656,1915
Jensen_Eisai_groupC,2,6,ts-global_detected_seizures,166754,167458,704
Jensen_Eisai_groupC,2,6,ts-global_detected_seizures,167460,167513,53
Jensen_Eisai_groupC,2,6,ts-global_detected_seizures,167514,167547,33
Jensen_Eisai_groupC,2,6,ts-global_detected_seizures,167639,167664,25
Jensen_Eisai_groupC,2,6,ts-global_detected_seizures,167703,167728,25
Jensen_Eisai_groupC,2,6,ts-global_detected_seizures,167792,167816,24
Jensen_Eisai_groupC,2,6,ts-global_detected_seizures,167851,167926,75
Jensen_Eisai_groupC,2,6,ts-global_detected_seizures,168061,168085,24
Jensen_Eisai_groupC,2,6,ts-global_detected_seizures,168306,168342,36
Jensen_Eisai_groupC,2,6,ts-global_detected_seizures,168418,172332,3914
Jensen_Eisai_groupC,1,5,ts-global_detected_seizures,168657,171487,2830
Jensen_Eisai_groupC,1,5,ts-global_detected_seizures,171488,172268,780
Jensen_Eisai_groupC,1,5,ts-global_detected_seizures,172276,172496,220
Jensen_Eisai_groupC,2,6,ts-global_detected_seizures,172354,172396,42
Jensen_Eisai_groupC,2,6,ts-global_detected_seizures,172354,172396,42
Jensen_Eisai_groupC,2,6,ts-global_detected_seizures,172397,172440,43
Jensen_Eisai_groupC,2,6,ts-global_detected_seizures,172466,172549,83
Jensen_Eisai_groupC,1,5,ts-global_detected_seizures,172497,172531,34
Jensen_Eisai_groupC,2,6,ts-global_detected_seizures,173106,173336,230
Jensen_Eisai_groupC,2,6,ts-global_detected_seizures,173337,173423,86
Jensen_Eisai_groupC,1,5,ts-global_detected_seizures,173414,173455,41
Jensen_Eisai_groupC,2,6,ts-global_detected_seizures,173424,173493,69
Jensen_Eisai_groupC,1,5,ts-global_detected_seizures,173456,173551,95
Jensen_Eisai_groupC,2,6,ts-global_detected_seizures,173512,173550,38
Jensen_Eisai_groupC,2,6,ts-global_detected_seizures,173551,173578,27
Jensen_Eisai_groupC,1,5,ts-global_detected_seizures,173552,173765,213
Jensen_Eisai_groupC,2,6,ts-global_detected_seizures,173579,173630,51
Jensen_Eisai_groupC,2,6,ts-global_detected_seizures,173631,173658,27
Jensen_Eisai_groupC,2,6,ts-global_detected_seizures,173659,173700,41
Jensen_Eisai_groupC,2,6,ts-global_detected_seizures,173701,173723,22
Jensen_Eisai_groupC,2,6,ts-global_detected_seizures,173741,173768,27
Jensen_Eisai_groupC,1,5,ts-global_detected_seizures,173768,174026,258
Jensen_Eisai_groupC,1,5,ts-global_detected_seizures,174027,174067,40
Jensen_Eisai_groupC,1,5,ts-global_detected_seizures,174073,174105,32
Jensen_Eisai_groupC,1,5,ts-global_detected_seizures,174107,174156,49
Jensen_Eisai_groupC,2,6,ts-global_detected_seizures,174148,174172,24
Jensen_Eisai_groupC,1,5,ts-global_detected_seizures,174158,174182,24
Jensen_Eisai_groupC,1,5,ts-global_detected_seizures,174202,174250,48
Jensen_Eisai_groupC,2,6,ts-global_detected_seizures,174240,174263,23
Jensen_Eisai_groupC,1,5,ts-global_detected_seizures,174251,174316,65
Jensen_Eisai_groupC,1,5,ts-global_detected_seizures,174363,174473,110
Jensen_Eisai_groupC,2,6,ts-global_detected_seizures,174409,174433,24
Jensen_Eisai_groupC,1,5,ts-global_detected_seizures,174474,174553,79
Jensen_Eisai_groupC,1,5,ts-global_detected_seizures,174593,174631,38
Jensen_Eisai_groupC,1,5,ts-global_detected_seizures,174632,174664,32
Jensen_Eisai_groupC,2,6,ts-global_detected_seizures,174654,174679,25
Jensen_Eisai_groupC,1,5,ts-global_detected_seizures,174677,174709,32
Jensen_Eisai_groupC,1,5,ts-global_detected_seizures,174728,174789,61
Jensen_Eisai_groupC,1,5,ts-global_detected_seizures,174790,174920,130
Jensen_Eisai_groupC,2,6,ts-global_detected_seizures,174940,174974,34
Jensen_Eisai_groupC,1,5,ts-global_detected_seizures,175005,175045,40
Jensen_Eisai_groupC,2,6,ts-global_detected_seizures,175045,175078,33
Jensen_Eisai_groupC,1,5,ts-global_detected_seizures,175059,175117,58
Jensen_Eisai_groupC,1,5,ts-global_detected_seizures,175207,175230,23
Jensen_Eisai_groupC,1,5,ts-global_detected_seizures,175233,175272,39
Jensen_Eisai_groupC,2,6,ts-global_detected_seizures,175252,175279,27
Jensen_Eisai_groupC,1,5,ts-global_detected_seizures,175273,175438,165
Jensen_Eisai_groupC,2,6,ts-global_detected_seizures,175285,175311,26
Jensen_Eisai_groupC,2,6,ts-global_detected_seizures,175439,175480,41
Jensen_Eisai_groupC,1,5,ts-global_detected_seizures,175444,175493,49
Jensen_Eisai_groupC,2,6,ts-global_detected_seizures,175511,175536,25
Jensen_Eisai_groupC,1,5,ts-global_detected_seizures,175529,175580,51
Jensen_Eisai_groupC,1,5,ts-global_detected_seizures,175581,175701,120
Jensen_Eisai_groupC,1,5,ts-global_detected_seizures,175702,175771,69
Jensen_Eisai_groupC,1,5,ts-global_detected_seizures,175772,175871,99
Jensen_Eisai_groupC,1,5,ts-global_detected_seizures,175872,176006,134
Jensen_Eisai_groupC,1,5,ts-global_detected_seizures,176020,176098,78
Jensen_Eisai_groupC,1,5,ts-global_detected_seizures,176143,176226,83
Jensen_Eisai_groupC,1,5,ts-global_detected_seizures,176227,176268,41
Jensen_Eisai_groupC,1,5,ts-global_detected_seizures,176269,176331,62
Jensen_Eisai_groupC,1,5,ts-global_detected_seizures,176332,176444,112
Jensen_Eisai_groupC,2,6,ts-global_detected_seizures,176405,176429,24
Jensen_Eisai_groupC,1,5,ts-global_detected_seizures,176481,176525,44
Jensen_Eisai_groupC,2,6,ts-global_detected_seizures,176502,176528,26
Jensen_Eisai_groupC,2,6,ts-global_detected_seizures,176554,176576,22
Jensen_Eisai_groupC,1,5,ts-global_detected_seizures,176587,176618,31
Jensen_Eisai_groupC,1,5,ts-global_detected_seizures,176619,176695,76
Jensen_Eisai_groupC,2,6,ts-global_detected_seizures,176676,176717,41
Jensen_Eisai_groupC,1,5,ts-global_detected_seizures,176697,176719,22
Jensen_Eisai_groupC,1,5,ts-global_detected_seizures,176721,176808,87
Jensen_Eisai_groupC,1,5,ts-global_detected_seizures,176809,176884,75
Jensen_Eisai_groupC,1,5,ts-global_detected_seizures,176885,177143,258
Jensen_Eisai_groupC,2,6,ts-global_detected_seizures,176942,176969,27
Jensen_Eisai_groupC,2,6,ts-global_detected_seizures,177020,177045,25
Jensen_Eisai_groupC,2,6,ts-global_detected_seizures,177072,177112,40
Jensen_Eisai_groupC,1,5,ts-global_detected_seizures,177144,177178,34
Jensen_Eisai_groupC,2,6,ts-global_detected_seizures,177168,177198,30
Jensen_Eisai_groupC,1,5,ts-global_detected_seizures,177195,177233,38
Jensen_Eisai_groupC,2,6,ts-global_detected_seizures,177222,177275,53
Jensen_Eisai_groupC,1,5,ts-global_detected_seizures,177235,177287,52
Jensen_Eisai_groupC,2,6,ts-global_detected_seizures,177276,177311,35
Jensen_Eisai_groupC,1,5,ts-global_detected_seizures,177295,177371,76
Jensen_Eisai_groupC,2,6,ts-global_detected_seizures,177350,177374,24
Jensen_Eisai_groupC,1,5,ts-global_detected_seizures,177404,177499,95
Jensen_Eisai_groupC,1,5,ts-global_detected_seizures,177500,177544,44
Jensen_Eisai_groupC,1,5,ts-global_detected_seizures,177556,177592,36
Jensen_Eisai_groupC,2,6,ts-global_detected_seizures,177576,177603,27
Jensen_Eisai_groupC,2,6,ts-global_detected_seizures,177604,177641,37
Jensen_Eisai_groupC,1,5,ts-global_detected_seizures,177605,177730,125
Jensen_Eisai_groupC,2,6,ts-global_detected_seizures,177642,177670,28
Jensen_Eisai_groupC,2,6,ts-global_detected_seizures,177724,177751,27
Jensen_Eisai_groupC,1,5,ts-global_detected_seizures,177734,177976,242
Jensen_Eisai_groupC,1,5,ts-global_detected_seizures,177977,178012,35
Jensen_Eisai_groupC,1,5,ts-global_detected_seizures,178026,178091,65
Jensen_Eisai_groupC,1,5,ts-global_detected_seizures,178097,178121,24
Jensen_Eisai_groupC,1,5,ts-global_detected_seizures,178128,178150,22
Jensen_Eisai_groupC,1,5,ts-global_detected_seizures,178170,178269,99
Jensen_Eisai_groupC,2,6,ts-global_detected_seizures,178179,178243,64
Jensen_Eisai_groupC,2,6,ts-global_detected_seizures,178280,178332,52
Jensen_Eisai_groupC,1,5,ts-global_detected_seizures,178391,178448,57
Jensen_Eisai_groupC,2,6,ts-global_detected_seizures,178398,178442,44
Jensen_Eisai_groupC,1,5,ts-global_detected_seizures,178449,178498,49
Jensen_Eisai_groupC,2,6,ts-global_detected_seizures,178465,178500,35
Jensen_Eisai_groupC,1,5,ts-global_detected_seizures,178499,178528,29
Jensen_Eisai_groupC,2,6,ts-global_detected_seizures,178511,178536,25
Jensen_Eisai_groupC,1,5,ts-global_detected_seizures,178529,178730,201
Jensen_Eisai_groupC,2,6,ts-global_detected_seizures,178537,178572,35
Jensen_Eisai_groupC,2,6,ts-global_detected_seizures,178645,178692,47
Jensen_Eisai_groupC,2,6,ts-global_detected_seizures,178693,178766,73
Jensen_Eisai_groupC,1,5,ts-global_detected_seizures,178733,178778,45
Jensen_Eisai_groupC,2,6,ts-global_detected_seizures,178783,178829,46
Jensen_Eisai_groupC,1,5,ts-global_detected_seizures,178794,178891,97
Jensen_Eisai_groupC,2,6,ts-global_detected_seizures,178850,178875,25
Jensen_Eisai_groupC,2,6,ts-global_detected_seizures,178876,178906,30
Jensen_Eisai_groupC,2,6,ts-global_detected_seizures,178907,178944,37
Jensen_Eisai_groupC,1,5,ts-global_detected_seizures,178913,179289,376
Jensen_Eisai_groupC,2,6,ts-global_detected_seizures,178945,179015,70
Jensen_Eisai_groupC,2,6,ts-global_detected_seizures,179016,179072,56
Jensen_Eisai_groupC,2,6,ts-global_detected_seizures,179115,179151,36
Jensen_Eisai_groupC,1,5,ts-global_detected_seizures,179291,179377,86
Jensen_Eisai_groupC,1,5,ts-global_detected_seizures,179388,179458,70
Jensen_Eisai_groupC,2,6,ts-global_detected_seizures,179411,179504,93
Jensen_Eisai_groupC,1,5,ts-global_detected_seizures,179476,179612,136
Jensen_Eisai_groupC,2,6,ts-global_detected_seizures,179505,179574,69
Jensen_Eisai_groupC,2,6,ts-global_detected_seizures,179575,179691,116
Jensen_Eisai_groupC,1,5,ts-global_detected_seizures,179613,179703,90
Jensen_Eisai_groupC,2,6,ts-global_detected_seizures,179692,179754,62
Jensen_Eisai_groupC,1,5,ts-global_detected_seizures,179743,179932,189
Jensen_Eisai_groupC,2,6,ts-global_detected_seizures,179759,179813,54
Jensen_Eisai_groupC,1,5,ts-global_detected_seizures,179933,179997,64
Jensen_Eisai_groupC,1,5,ts-global_detected_seizures,179998,180031,33
Jensen_Eisai_groupC,1,5,ts-global_detected_seizures,180195,180251,56
Jensen_Eisai_groupC,2,6,ts-global_detected_seizures,180229,180251,22
Jensen_Eisai_groupC,1,5,ts-global_detected_seizures,180276,180302,26
Jensen_Eisai_groupC,1,5,ts-global_detected_seizures,180379,180410,31
Jensen_Eisai_groupC,2,6,ts-global_detected_seizures,180380,180437,57
Jensen_Eisai_groupC,1,5,ts-global_detected_seizures,180523,180592,69
Jensen_Eisai_groupC,1,5,ts-global_detected_seizures,180610,180644,34
Jensen_Eisai_groupC,1,5,ts-global_detected_seizures,180693,180768,75
Jensen_Eisai_groupC,1,5,ts-global_detected_seizures,180846,180869,23
Jensen_Eisai_groupC,1,5,ts-global_detected_seizures,180878,180907,29
Jensen_Eisai_groupC,2,6,ts-global_detected_seizures,180988,181065,77
Jensen_Eisai_groupC,1,5,ts-global_detected_seizures,181098,181133,35
Jensen_Eisai_groupC,1,5,ts-global_detected_seizures,181140,181209,69
Jensen_Eisai_groupC,1,5,ts-global_detected_seizures,181242,181272,30
Jensen_Eisai_groupC,2,6,ts-global_detected_seizures,181274,181297,23
Jensen_Eisai_groupC,2,6,ts-global_detected_seizures,181367,181407,40
Jensen_Eisai_groupC,1,5,ts-global_detected_seizures,181399,181422,23
Jensen_Eisai_groupC,1,5,ts-global_detected_seizures,181468,181497,29
Jensen_Eisai_groupC,2,6,ts-global_detected_seizures,181480,181511,31
Jensen_Eisai_groupC,1,5,ts-global_detected_seizures,181598,181624,26
Jensen_Eisai_groupC,2,6,ts-global_detected_seizures,181599,181627,28
Jensen_Eisai_groupC,2,6,ts-global_detected_seizures,181665,181690,25
Jensen_Eisai_groupC,1,5,ts-global_detected_seizures,181670,181711,41
Jensen_Eisai_groupC,1,5,ts-global_detected_seizures,181712,181761,49
Jensen_Eisai_groupC,2,6,ts-global_detected_seizures,181740,181774,34
Jensen_Eisai_groupC,1,5,ts-global_detected_seizures,181780,181827,47
Jensen_Eisai_groupC,2,6,ts-global_detected_seizures,181813,181843,30
Jensen_Eisai_groupC,1,5,ts-global_detected_seizures,181832,181856,24
Jensen_Eisai_groupC,2,6,ts-global_detected_seizures,181894,181919,25
Jensen_Eisai_groupC,1,5,ts-global_detected_seizures,182001,182033,32
Jensen_Eisai_groupC,2,6,ts-global_detected_seizures,182045,182093,48
Jensen_Eisai_groupC,1,5,ts-global_detected_seizures,182093,182120,27
Jensen_Eisai_groupC,1,5,ts-global_detected_seizures,182141,182167,26
Jensen_Eisai_groupC,2,6,ts-global_detected_seizures,182191,182220,29
Jensen_Eisai_groupC,1,5,ts-global_detected_seizures,182216,182243,27
Jensen_Eisai_groupC,2,6,ts-global_detected_seizures,182299,182328,29
Jensen_Eisai_groupC,1,5,ts-global_detected_seizures,182366,182389,23
Jensen_Eisai_groupC,1,5,ts-global_detected_seizures,182396,182439,43
Jensen_Eisai_groupC,2,6,ts-global_detected_seizures,182411,182433,22
Jensen_Eisai_groupC,2,6,ts-global_detected_seizures,182436,182559,123
Jensen_Eisai_groupC,1,5,ts-global_detected_seizures,182445,182475,30
Jensen_Eisai_groupC,1,5,ts-global_detected_seizures,182524,182599,75
Jensen_Eisai_groupC,2,6,ts-global_detected_seizures,182570,182597,27
Jensen_Eisai_groupC,2,6,ts-global_detected_seizures,182665,182703,38
Jensen_Eisai_groupC,2,6,ts-global_detected_seizures,182716,182766,50
Jensen_Eisai_groupC,2,6,ts-global_detected_seizures,182855,182882,27
Jensen_Eisai_groupC,2,6,ts-global_detected_seizures,182899,182932,33
Jensen_Eisai_groupC,2,6,ts-global_detected_seizures,182953,182975,22
Jensen_Eisai_groupC,2,6,ts-global_detected_seizures,183078,183100,22
Jensen_Eisai_groupC,1,5,ts-global_detected_seizures,183132,183264,132
Jensen_Eisai_groupC,2,6,ts-global_detected_seizures,183230,183266,36
Jensen_Eisai_groupC,1,5,ts-global_detected_seizures,183265,183315,50
Jensen_Eisai_groupC,1,5,ts-global_detected_seizures,183316,183413,97
Jensen_Eisai_groupC,2,6,ts-global_detected_seizures,183337,183373,36
Jensen_Eisai_groupC,2,6,ts-global_detected_seizures,183381,183403,22
Jensen_Eisai_groupC,1,5,ts-global_detected_seizures,183414,183679,265
Jensen_Eisai_groupC,2,6,ts-global_detected_seizures,183424,183539,115
Jensen_Eisai_groupC,2,6,ts-global_detected_seizures,183540,183907,367
Jensen_Eisai_groupC,1,5,ts-global_detected_seizures,183680,183856,176
Jensen_Eisai_groupC,1,5,ts-global_detected_seizures,183881,183907,26
Jensen_Eisai_groupC,2,6,ts-global_detected_seizures,183923,184111,188
Jensen_Eisai_groupC,1,5,ts-global_detected_seizures,183939,183982,43
Jensen_Eisai_groupC,2,6,ts-global_detected_seizures,184112,184176,64
Jensen_Eisai_groupC,2,6,ts-global_detected_seizures,184177,184376,199
Jensen_Eisai_groupC,1,5,ts-global_detected_seizures,184230,184477,247
Jensen_Eisai_groupC,2,6,ts-global_detected_seizures,184377,184605,228
Jensen_Eisai_groupC,1,5,ts-global_detected_seizures,184500,184542,42
Jensen_Eisai_groupC,1,5,ts-global_detected_seizures,184604,184626,22
Jensen_Eisai_groupC,2,6,ts-global_detected_seizures,184606,184724,118
Jensen_Eisai_groupC,1,5,ts-global_detected_seizures,184644,184679,35
Jensen_Eisai_groupC,2,6,ts-global_detected_seizures,184735,184928,193
Jensen_Eisai_groupC,1,5,ts-global_detected_seizures,184752,184784,32
Jensen_Eisai_groupC,1,5,ts-global_detected_seizures,184883,184918,35
Jensen_Eisai_groupC,2,6,ts-global_detected_seizures,184937,185019,82
Jensen_Eisai_groupC,1,5,ts-global_detected_seizures,184958,184982,24
Jensen_Eisai_groupC,1,5,ts-global_detected_seizures,185019,185116,97
Jensen_Eisai_groupC,2,6,ts-global_detected_seizures,185021,185081,60
Jensen_Eisai_groupC,2,6,ts-global_detected_seizures,185082,185274,192
Jensen_Eisai_groupC,1,5,ts-global_detected_seizures,185117,185145,28
Jensen_Eisai_groupC,1,5,ts-global_detected_seizures,185170,185204,34
Jensen_Eisai_groupC,1,5,ts-global_detected_seizures,185251,185277,26
Jensen_Eisai_groupC,2,6,ts-global_detected_seizures,185277,185365,88
Jensen_Eisai_groupC,2,6,ts-global_detected_seizures,185366,185720,354
Jensen_Eisai_groupC,1,5,ts-global_detected_seizures,185373,185395,22
Jensen_Eisai_groupC,1,5,ts-global_detected_seizures,185428,185467,39
Jensen_Eisai_groupC,1,5,ts-global_detected_seizures,185471,185571,100
Jensen_Eisai_groupC,1,5,ts-global_detected_seizures,185581,185617,36
Jensen_Eisai_groupC,1,5,ts-global_detected_seizures,185658,185722,64
Jensen_Eisai_groupC,1,5,ts-global_detected_seizures,185753,185791,38
Jensen_Eisai_groupC,1,5,ts-global_detected_seizures,185933,185968,35
Jensen_Eisai_groupC,2,6,ts-global_detected_seizures,185953,185977,24
Jensen_Eisai_groupC,1,5,ts-global_detected_seizures,185979,186210,231
Jensen_Eisai_groupC,2,6,ts-global_detected_seizures,186016,186071,55
Jensen_Eisai_groupC,2,6,ts-global_detected_seizures,186101,186125,24
Jensen_Eisai_groupC,2,6,ts-global_detected_seizures,186134,186173,39
Jensen_Eisai_groupC,1,5,ts-global_detected_seizures,186223,186518,295
Jensen_Eisai_groupC,2,6,ts-global_detected_seizures,186309,186337,28
Jensen_Eisai_groupC,2,6,ts-global_detected_seizures,186436,186460,24
Jensen_Eisai_groupC,2,6,ts-global_detected_seizures,186478,186508,30
Jensen_Eisai_groupC,1,5,ts-global_detected_seizures,186520,186549,29
Jensen_Eisai_groupC,1,5,ts-global_detected_seizures,186553,186767,214
Jensen_Eisai_groupC,2,6,ts-global_detected_seizures,186574,186602,28
Jensen_Eisai_groupC,2,6,ts-global_detected_seizures,186706,186796,90
Jensen_Eisai_groupC,1,5,ts-global_detected_seizures,186768,187093,325
Jensen_Eisai_groupC,2,6,ts-global_detected_seizures,186797,186840,43
Jensen_Eisai_groupC,2,6,ts-global_detected_seizures,187004,187027,23
Jensen_Eisai_groupC,2,6,ts-global_detected_seizures,187085,187110,25
Jensen_Eisai_groupC,1,5,ts-global_detected_seizures,187094,187117,23
Jensen_Eisai_groupC,1,5,ts-global_detected_seizures,187118,187442,324
Jensen_Eisai_groupC,2,6,ts-global_detected_seizures,187263,187291,28
Jensen_Eisai_groupC,2,6,ts-global_detected_seizures,187367,187395,28
Jensen_Eisai_groupC,1,5,ts-global_detected_seizures,187443,187706,263
Jensen_Eisai_groupC,2,6,ts-global_detected_seizures,187459,187499,40
Jensen_Eisai_groupC,2,6,ts-global_detected_seizures,187617,187646,29
Jensen_Eisai_groupC,1,5,ts-global_detected_seizures,187707,187894,187
Jensen_Eisai_groupC,2,6,ts-global_detected_seizures,187713,187750,37
Jensen_Eisai_groupC,2,6,ts-global_detected_seizures,187858,187894,36
Jensen_Eisai_groupC,1,5,ts-global_detected_seizures,187895,188143,248
Jensen_Eisai_groupC,2,6,ts-global_detected_seizures,187924,187951,27
Jensen_Eisai_groupC,2,6,ts-global_detected_seizures,188051,188078,27
Jensen_Eisai_groupC,2,6,ts-global_detected_seizures,188139,188171,32
Jensen_Eisai_groupC,1,5,ts-global_detected_seizures,188144,188714,570
Jensen_Eisai_groupC,2,6,ts-global_detected_seizures,188203,188227,24
Jensen_Eisai_groupC,2,6,ts-global_detected_seizures,188274,188329,55
Jensen_Eisai_groupC,2,6,ts-global_detected_seizures,188341,188390,49
Jensen_Eisai_groupC,2,6,ts-global_detected_seizures,188460,188496,36
Jensen_Eisai_groupC,2,6,ts-global_detected_seizures,188510,188533,23
Jensen_Eisai_groupC,2,6,ts-global_detected_seizures,188552,188575,23
Jensen_Eisai_groupC,2,6,ts-global_detected_seizures,188651,188681,30
Jensen_Eisai_groupC,2,6,ts-global_detected_seizures,188709,188732,23
Jensen_Eisai_groupC,1,5,ts-global_detected_seizures,188716,188747,31
Jensen_Eisai_groupC,2,6,ts-global_detected_seizures,188734,188766,32
Jensen_Eisai_groupC,1,5,ts-global_detected_seizures,188748,188812,64
Jensen_Eisai_groupC,2,6,ts-global_detected_seizures,188796,188831,35
Jensen_Eisai_groupC,2,6,ts-global_detected_seizures,188885,188915,30
Jensen_Eisai_groupC,2,6,ts-global_detected_seizures,188978,189100,122
Jensen_Eisai_groupC,1,5,ts-global_detected_seizures,189042,189080,38
Jensen_Eisai_groupC,2,6,ts-global_detected_seizures,189192,189215,23
Jensen_Eisai_groupC,1,5,ts-global_detected_seizures,189277,189301,24
Jensen_Eisai_groupC,1,5,ts-global_detected_seizures,189320,189361,41
Jensen_Eisai_groupC,2,6,ts-global_detected_seizures,189321,189347,26
Jensen_Eisai_groupC,1,5,ts-global_detected_seizures,189383,189428,45
Jensen_Eisai_groupC,2,6,ts-global_detected_seizures,189456,189513,57
Jensen_Eisai_groupC,2,6,ts-global_detected_seizures,189563,189618,55
Jensen_Eisai_groupC,1,5,ts-global_detected_seizures,189608,189635,27
Jensen_Eisai_groupC,1,5,ts-global_detected_seizures,189718,189762,44
Jensen_Eisai_groupC,2,6,ts-global_detected_seizures,189800,189828,28
Jensen_Eisai_groupC,2,6,ts-global_detected_seizures,189863,189885,22
Jensen_Eisai_groupC,2,6,ts-global_detected_seizures,189893,189915,22
Jensen_Eisai_groupC,1,5,ts-global_detected_seizures,189957,190008,51
Jensen_Eisai_groupC,2,6,ts-global_detected_seizures,189958,189989,31
Jensen_Eisai_groupC,1,5,ts-global_detected_seizures,190020,190048,28
Jensen_Eisai_groupC,1,5,ts-global_detected_seizures,190049,190072,23
Jensen_Eisai_groupC,1,5,ts-global_detected_seizures,190109,190132,23
Jensen_Eisai_groupC,2,6,ts-global_detected_seizures,190145,190171,26
Jensen_Eisai_groupC,2,6,ts-global_detected_seizures,190195,190221,26
Jensen_Eisai_groupC,2,6,ts-global_detected_seizures,190234,190256,22
Jensen_Eisai_groupC,2,6,ts-global_detected_seizures,190288,190332,44
Jensen_Eisai_groupC,1,5,ts-global_detected_seizures,190372,190414,42
Jensen_Eisai_groupC,2,6,ts-global_detected_seizures,190375,190444,69
Jensen_Eisai_groupC,2,6,ts-global_detected_seizures,190445,190489,44
Jensen_Eisai_groupC,1,5,ts-global_detected_seizures,190516,190649,133
Jensen_Eisai_groupC,2,6,ts-global_detected_seizures,190523,190915,392
Jensen_Eisai_groupC,1,5,ts-global_detected_seizures,190663,190690,27
Jensen_Eisai_groupC,1,5,ts-global_detected_seizures,190708,190765,57
Jensen_Eisai_groupC,1,5,ts-global_detected_seizures,190794,190829,35
Jensen_Eisai_groupC,1,5,ts-global_detected_seizures,190854,190876,22
Jensen_Eisai_groupC,1,5,ts-global_detected_seizures,190903,190927,24
Jensen_Eisai_groupC,2,6,ts-global_detected_seizures,190916,190945,29
Jensen_Eisai_groupC,1,5,ts-global_detected_seizures,190954,190983,29
Jensen_Eisai_groupC,1,5,ts-global_detected_seizures,190984,191010,26
Jensen_Eisai_groupC,1,5,ts-global_detected_seizures,191013,191040,27
Jensen_Eisai_groupC,1,5,ts-global_detected_seizures,191053,191090,37
Jensen_Eisai_groupC,2,6,ts-global_detected_seizures,191067,191091,24
Jensen_Eisai_groupC,2,6,ts-global_detected_seizures,191114,191139,25
Jensen_Eisai_groupC,1,5,ts-global_detected_seizures,191151,191179,28
Jensen_Eisai_groupC,2,6,ts-global_detected_seizures,191156,191182,26
Jensen_Eisai_groupC,2,6,ts-global_detected_seizures,191220,191263,43
Jensen_Eisai_groupC,1,5,ts-global_detected_seizures,191247,191275,28
Jensen_Eisai_groupC,2,6,ts-global_detected_seizures,191270,191296,26
Jensen_Eisai_groupC,1,5,ts-global_detected_seizures,191289,191314,25
Jensen_Eisai_groupC,2,6,ts-global_detected_seizures,191304,191327,23
Jensen_Eisai_groupC,1,5,ts-global_detected_seizures,191363,191453,90
Jensen_Eisai_groupC,2,6,ts-global_detected_seizures,191364,191389,25
Jensen_Eisai_groupC,2,6,ts-global_detected_seizures,191424,191982,558
Jensen_Eisai_groupC,1,5,ts-global_detected_seizures,191474,191499,25
Jensen_Eisai_groupC,1,5,ts-global_detected_seizures,191522,191566,44
Jensen_Eisai_groupC,1,5,ts-global_detected_seizures,191567,191594,27
Jensen_Eisai_groupC,1,5,ts-global_detected_seizures,191616,191653,37
Jensen_Eisai_groupC,1,5,ts-global_detected_seizures,191678,191742,64
Jensen_Eisai_groupC,1,5,ts-global_detected_seizures,191809,191846,37
Jensen_Eisai_groupC,1,5,ts-global_detected_seizures,191872,191967,95
Jensen_Eisai_groupC,1,5,ts-global_detected_seizures,191971,191993,22
Jensen_Eisai_groupC,2,6,ts-global_detected_seizures,191983,192041,58
Jensen_Eisai_groupC,2,6,ts-global_detected_seizures,192043,192275,232
Jensen_Eisai_groupC,1,5,ts-global_detected_seizures,192048,192091,43
Jensen_Eisai_groupC,1,5,ts-global_detected_seizures,192094,192153,59
Jensen_Eisai_groupC,1,5,ts-global_detected_seizures,192184,192212,28
Jensen_Eisai_groupC,1,5,ts-global_detected_seizures,192218,192244,26
Jensen_Eisai_groupC,1,5,ts-global_detected_seizures,192270,192305,35
Jensen_Eisai_groupC,1,5,ts-global_detected_seizures,192307,192477,170
Jensen_Eisai_groupC,2,6,ts-global_detected_seizures,192317,192595,278
Jensen_Eisai_groupC,1,5,ts-global_detected_seizures,192478,192516,38
Jensen_Eisai_groupC,1,5,ts-global_detected_seizures,192517,192578,61
Jensen_Eisai_groupC,1,5,ts-global_detected_seizures,192593,192624,31
Jensen_Eisai_groupC,2,6,ts-global_detected_seizures,192596,193155,559
Jensen_Eisai_groupC,1,5,ts-global_detected_seizures,192709,192755,46
Jensen_Eisai_groupC,1,5,ts-global_detected_seizures,192819,192912,93
Jensen_Eisai_groupC,1,5,ts-global_detected_seizures,192929,192953,24
Jensen_Eisai_groupC,1,5,ts-global_detected_seizures,192954,192989,35
Jensen_Eisai_groupC,1,5,ts-global_detected_seizures,193002,193039,37
Jensen_Eisai_groupC,1,5,ts-global_detected_seizures,193053,193098,45
Jensen_Eisai_groupC,1,5,ts-global_detected_seizures,193113,193157,44
Jensen_Eisai_groupC,2,6,ts-global_detected_seizures,193157,193657,500
Jensen_Eisai_groupC,1,5,ts-global_detected_seizures,193158,193203,45
Jensen_Eisai_groupC,1,5,ts-global_detected_seizures,193255,193293,38
Jensen_Eisai_groupC,1,5,ts-global_detected_seizures,193297,193322,25
Jensen_Eisai_groupC,1,5,ts-global_detected_seizures,193362,193746,384
Jensen_Eisai_groupC,2,6,ts-global_detected_seizures,193658,193735,77
Jensen_Eisai_groupC,2,6,ts-global_detected_seizures,193736,193761,25
Jensen_Eisai_groupC,1,5,ts-global_detected_seizures,193747,193776,29
Jensen_Eisai_groupC,2,6,ts-global_detected_seizures,193819,193857,38
Jensen_Eisai_groupC,1,5,ts-global_detected_seizures,193820,193860,40
Jensen_Eisai_groupC,1,5,ts-global_detected_seizures,193867,193898,31
Jensen_Eisai_groupC,2,6,ts-global_detected_seizures,193889,193913,24
Jensen_Eisai_groupC,1,5,ts-global_detected_seizures,193915,193943,28
Jensen_Eisai_groupC,2,6,ts-global_detected_seizures,193968,193995,27
Jensen_Eisai_groupC,1,5,ts-global_detected_seizures,193997,194040,43
Jensen_Eisai_groupC,2,6,ts-global_detected_seizures,194035,194061,26
Jensen_Eisai_groupC,1,5,ts-global_detected_seizures,194043,194141,98
Jensen_Eisai_groupC,1,5,ts-global_detected_seizures,194143,194285,142
Jensen_Eisai_groupC,2,6,ts-global_detected_seizures,194173,194195,22
Jensen_Eisai_groupC,2,6,ts-global_detected_seizures,194257,194286,29
Jensen_Eisai_groupC,1,5,ts-global_detected_seizures,194286,194376,90
Jensen_Eisai_groupC,2,6,ts-global_detected_seizures,194375,194397,22
Jensen_Eisai_groupC,1,5,ts-global_detected_seizures,194380,194471,91
Jensen_Eisai_groupC,2,6,ts-global_detected_seizures,194398,194445,47
Jensen_Eisai_groupC,1,5,ts-global_detected_seizures,194534,194603,69
Jensen_Eisai_groupC,1,5,ts-global_detected_seizures,194619,194662,43
Jensen_Eisai_groupC,2,6,ts-global_detected_seizures,194652,194681,29
Jensen_Eisai_groupC,1,5,ts-global_detected_seizures,194740,194847,107
Jensen_Eisai_groupC,2,6,ts-global_detected_seizures,194757,194779,22
Jensen_Eisai_groupC,2,6,ts-global_detected_seizures,194812,194873,61
Jensen_Eisai_groupC,1,5,ts-global_detected_seizures,194863,194914,51
Jensen_Eisai_groupC,1,5,ts-global_detected_seizures,194959,194982,23
Jensen_Eisai_groupC,2,6,ts-global_detected_seizures,194977,195018,41
Jensen_Eisai_groupC,1,5,ts-global_detected_seizures,194991,195020,29
Jensen_Eisai_groupC,1,5,ts-global_detected_seizures,195028,195050,22
Jensen_Eisai_groupC,1,5,ts-global_detected_seizures,195061,195160,99
Jensen_Eisai_groupC,2,6,ts-global_detected_seizures,195089,195122,33
Jensen_Eisai_groupC,2,6,ts-global_detected_seizures,195124,195155,31
Jensen_Eisai_groupC,1,5,ts-global_detected_seizures,195165,195269,104
Jensen_Eisai_groupC,2,6,ts-global_detected_seizures,195210,195249,39
Jensen_Eisai_groupC,2,6,ts-global_detected_seizures,195299,195333,34
Jensen_Eisai_groupC,2,6,ts-global_detected_seizures,195334,195368,34
Jensen_Eisai_groupC,1,5,ts-global_detected_seizures,195336,195384,48
Jensen_Eisai_groupC,2,6,ts-global_detected_seizures,195369,195413,44
Jensen_Eisai_groupC,1,5,ts-global_detected_seizures,195407,195435,28
Jensen_Eisai_groupC,2,6,ts-global_detected_seizures,195460,195499,39
Jensen_Eisai_groupC,1,5,ts-global_detected_seizures,195574,197740,2166
Jensen_Eisai_groupC,2,6,ts-global_detected_seizures,195627,195694,67
Jensen_Eisai_groupC,2,6,ts-global_detected_seizures,195726,195852,126
Jensen_Eisai_groupC,2,6,ts-global_detected_seizures,195862,196008,146
Jensen_Eisai_groupC,2,6,ts-global_detected_seizures,196009,196058,49
Jensen_Eisai_groupC,2,6,ts-global_detected_seizures,196064,196102,38
Jensen_Eisai_groupC,2,6,ts-global_detected_seizures,196138,196185,47
Jensen_Eisai_groupC,2,6,ts-global_detected_seizures,196259,196281,22
Jensen_Eisai_groupC,2,6,ts-global_detected_seizures,196285,196367,82
Jensen_Eisai_groupC,2,6,ts-global_detected_seizures,196400,196424,24
Jensen_Eisai_groupC,2,6,ts-global_detected_seizures,196447,196525,78
Jensen_Eisai_groupC,2,6,ts-global_detected_seizures,196634,196672,38
Jensen_Eisai_groupC,2,6,ts-global_detected_seizures,196710,196738,28
Jensen_Eisai_groupC,2,6,ts-global_detected_seizures,196806,196828,22
Jensen_Eisai_groupC,2,6,ts-global_detected_seizures,196863,196891,28
Jensen_Eisai_groupC,2,6,ts-global_detected_seizures,196973,197001,28
Jensen_Eisai_groupC,2,6,ts-global_detected_seizures,197178,197300,122
Jensen_Eisai_groupC,2,6,ts-global_detected_seizures,197312,197336,24
Jensen_Eisai_groupC,2,6,ts-global_detected_seizures,197367,197435,68
Jensen_Eisai_groupC,2,6,ts-global_detected_seizures,197511,197536,25
Jensen_Eisai_groupC,2,6,ts-global_detected_seizures,197624,197653,29
Jensen_Eisai_groupC,1,5,ts-global_detected_seizures,197741,197767,26
Jensen_Eisai_groupC,1,5,ts-global_detected_seizures,197789,197888,99
Jensen_Eisai_groupC,2,6,ts-global_detected_seizures,197806,197830,24
Jensen_Eisai_groupC,2,6,ts-global_detected_seizures,197860,197883,23
Jensen_Eisai_groupC,1,5,ts-global_detected_seizures,197929,197977,48
Jensen_Eisai_groupC,2,6,ts-global_detected_seizures,197933,197963,30
Jensen_Eisai_groupC,2,6,ts-global_detected_seizures,197999,198029,30
Jensen_Eisai_groupC,1,5,ts-global_detected_seizures,198030,198055,25
Jensen_Eisai_groupC,2,6,ts-global_detected_seizures,198104,198128,24
Jensen_Eisai_groupC,1,5,ts-global_detected_seizures,198106,198129,23
Jensen_Eisai_groupC,2,6,ts-global_detected_seizures,198152,198196,44
Jensen_Eisai_groupC,2,6,ts-global_detected_seizures,198231,198262,31
Jensen_Eisai_groupC,1,5,ts-global_detected_seizures,198400,198422,22
Jensen_Eisai_groupC,1,5,ts-global_detected_seizures,198423,198512,89
Jensen_Eisai_groupC,2,6,ts-global_detected_seizures,198514,198536,22
Jensen_Eisai_groupC,1,5,ts-global_detected_seizures,198571,198595,24
Jensen_Eisai_groupC,1,5,ts-global_detected_seizures,198658,198681,23
Jensen_Eisai_groupC,2,6,ts-global_detected_seizures,198676,198707,31
Jensen_Eisai_groupC,1,5,ts-global_detected_seizures,198684,198727,43
Jensen_Eisai_groupC,2,6,ts-global_detected_seizures,198745,198796,51
Jensen_Eisai_groupC,1,5,ts-global_detected_seizures,198813,198846,33
Jensen_Eisai_groupC,1,5,ts-global_detected_seizures,198873,198908,35
Jensen_Eisai_groupC,2,6,ts-global_detected_seizures,198874,198945,71
Jensen_Eisai_groupC,1,5,ts-global_detected_seizures,198952,198978,26
Jensen_Eisai_groupC,2,6,ts-global_detected_seizures,198972,199068,96
Jensen_Eisai_groupC,1,5,ts-global_detected_seizures,199024,199049,25
Jensen_Eisai_groupC,1,5,ts-global_detected_seizures,199050,199072,22
Jensen_Eisai_groupC,2,6,ts-global_detected_seizures,199086,199109,23
Jensen_Eisai_groupC,2,6,ts-global_detected_seizures,199138,199160,22
Jensen_Eisai_groupC,2,6,ts-global_detected_seizures,199170,199206,36
Jensen_Eisai_groupC,1,5,ts-global_detected_seizures,199172,199212,40
Jensen_Eisai_groupC,2,6,ts-global_detected_seizures,199227,199250,23
Jensen_Eisai_groupC,2,6,ts-global_detected_seizures,199254,199287,33
Jensen_Eisai_groupC,1,5,ts-global_detected_seizures,199275,199305,30
Jensen_Eisai_groupC,1,5,ts-global_detected_seizures,199312,199416,104
Jensen_Eisai_groupC,2,6,ts-global_detected_seizures,199372,199413,41
Jensen_Eisai_groupC,1,5,ts-global_detected_seizures,199429,199473,44
Jensen_Eisai_groupC,2,6,ts-global_detected_seizures,199450,199474,24
Jensen_Eisai_groupC,1,5,ts-global_detected_seizures,199474,199496,22
Jensen_Eisai_groupC,1,5,ts-global_detected_seizures,199497,199528,31
Jensen_Eisai_groupC,2,6,ts-global_detected_seizures,199502,199529,27
Jensen_Eisai_groupC,1,5,ts-global_detected_seizures,199530,199614,84
Jensen_Eisai_groupC,2,6,ts-global_detected_seizures,199546,199568,22
Jensen_Eisai_groupC,2,6,ts-global_detected_seizures,199597,199635,38
Jensen_Eisai_groupC,1,5,ts-global_detected_seizures,199631,199678,47
Jensen_Eisai_groupC,2,6,ts-global_detected_seizures,199701,199730,29
Jensen_Eisai_groupC,1,5,ts-global_detected_seizures,199761,199790,29
Jensen_Eisai_groupC,1,5,ts-global_detected_seizures,199833,199999,166
Jensen_Eisai_groupC,2,6,ts-global_detected_seizures,199834,199860,26
Jensen_Eisai_groupC,2,6,ts-global_detected_seizures,199918,199951,33
Jensen_Eisai_groupC,2,6,ts-global_detected_seizures,200010,200032,22
Jensen_Eisai_groupC,2,6,ts-global_detected_seizures,200072,200246,174
Jensen_Eisai_groupC,1,5,ts-global_detected_seizures,200102,200138,36
Jensen_Eisai_groupC,1,5,ts-global_detected_seizures,200139,200185,46
Jensen_Eisai_groupC,2,6,ts-global_detected_seizures,200265,200288,23
Jensen_Eisai_groupC,2,6,ts-global_detected_seizures,200294,200317,23
Jensen_Eisai_groupC,1,5,ts-global_detected_seizures,200305,201192,887
Jensen_Eisai_groupC,2,6,ts-global_detected_seizures,200340,200366,26
Jensen_Eisai_groupC,2,6,ts-global_detected_seizures,200367,200389,22
Jensen_Eisai_groupC,2,6,ts-global_detected_seizures,200413,200458,45
Jensen_Eisai_groupC,2,6,ts-global_detected_seizures,200485,200518,33
Jensen_Eisai_groupC,2,6,ts-global_detected_seizures,200618,200672,54
Jensen_Eisai_groupC,2,6,ts-global_detected_seizures,200756,200794,38
Jensen_Eisai_groupC,2,6,ts-global_detected_seizures,200845,200880,35
Jensen_Eisai_groupC,2,6,ts-global_detected_seizures,200914,200960,46
Jensen_Eisai_groupC,2,6,ts-global_detected_seizures,200984,201065,81
Jensen_Eisai_groupC,2,6,ts-global_detected_seizures,201078,201126,48
Jensen_Eisai_groupC,2,6,ts-global_detected_seizures,201147,201176,29
Jensen_Eisai_groupC,2,6,ts-global_detected_seizures,201184,201207,23
Jensen_Eisai_groupC,1,5,ts-global_detected_seizures,201194,201251,57
Jensen_Eisai_groupC,2,6,ts-global_detected_seizures,201214,201244,30
Jensen_Eisai_groupC,1,5,ts-global_detected_seizures,201275,201297,22
Jensen_Eisai_groupC,1,5,ts-global_detected_seizures,201330,201376,46
Jensen_Eisai_groupC,2,6,ts-global_detected_seizures,201342,201384,42
Jensen_Eisai_groupC,1,5,ts-global_detected_seizures,201384,201411,27
Jensen_Eisai_groupC,2,6,ts-global_detected_seizures,201385,201413,28
Jensen_Eisai_groupC,2,6,ts-global_detected_seizures,201438,201477,39
Jensen_Eisai_groupC,1,5,ts-global_detected_seizures,201494,201521,27
Jensen_Eisai_groupC,2,6,ts-global_detected_seizures,201513,201545,32
Jensen_Eisai_groupC,1,5,ts-global_detected_seizures,201559,201622,63
Jensen_Eisai_groupC,2,6,ts-global_detected_seizures,201566,201592,26
Jensen_Eisai_groupC,2,6,ts-global_detected_seizures,201622,201706,84
Jensen_Eisai_groupC,1,5,ts-global_detected_seizures,201627,201652,25
Jensen_Eisai_groupC,2,6,ts-global_detected_seizures,201707,201753,46
Jensen_Eisai_groupC,1,5,ts-global_detected_seizures,201771,201867,96
Jensen_Eisai_groupC,2,6,ts-global_detected_seizures,201780,201803,23
Jensen_Eisai_groupC,2,6,ts-global_detected_seizures,201858,202426,568
Jensen_Eisai_groupC,1,5,ts-global_detected_seizures,201886,201920,34
Jensen_Eisai_groupC,1,5,ts-global_detected_seizures,201966,202062,96
Jensen_Eisai_groupC,1,5,ts-global_detected_seizures,202068,202093,25
Jensen_Eisai_groupC,1,5,ts-global_detected_seizures,202115,202202,87
Jensen_Eisai_groupC,1,5,ts-global_detected_seizures,202203,202225,22
Jensen_Eisai_groupC,1,5,ts-global_detected_seizures,202226,202256,30
Jensen_Eisai_groupC,1,5,ts-global_detected_seizures,202278,202319,41
Jensen_Eisai_groupC,1,5,ts-global_detected_seizures,202330,202359,29
Jensen_Eisai_groupC,1,5,ts-global_detected_seizures,202382,202422,40
Jensen_Eisai_groupC,1,5,ts-global_detected_seizures,202434,202489,55
Jensen_Eisai_groupC,2,6,ts-global_detected_seizures,202460,202486,26
Jensen_Eisai_groupC,2,6,ts-global_detected_seizures,202571,202606,35
Jensen_Eisai_groupC,1,5,ts-global_detected_seizures,202602,202672,70
Jensen_Eisai_groupC,2,6,ts-global_detected_seizures,202627,202649,22
Jensen_Eisai_groupC,2,6,ts-global_detected_seizures,202677,202700,23
Jensen_Eisai_groupC,1,5,ts-global_detected_seizures,202701,202735,34
Jensen_Eisai_groupC,1,5,ts-global_detected_seizures,202743,202767,24
Jensen_Eisai_groupC,2,6,ts-global_detected_seizures,202769,202801,32
Jensen_Eisai_groupC,1,5,ts-global_detected_seizures,202794,202907,113
Jensen_Eisai_groupC,2,6,ts-global_detected_seizures,202834,202874,40
Jensen_Eisai_groupC,2,6,ts-global_detected_seizures,202875,202901,26
Jensen_Eisai_groupC,1,5,ts-global_detected_seizures,202943,202976,33
Jensen_Eisai_groupC,2,6,ts-global_detected_seizures,202978,203003,25
Jensen_Eisai_groupC,1,5,ts-global_detected_seizures,203009,203045,36
Jensen_Eisai_groupC,1,5,ts-global_detected_seizures,203065,203091,26
Jensen_Eisai_groupC,1,5,ts-global_detected_seizures,203093,203137,44
Jensen_Eisai_groupC,2,6,ts-global_detected_seizures,203119,203149,30
Jensen_Eisai_groupC,2,6,ts-global_detected_seizures,203188,203228,40
Jensen_Eisai_groupC,1,5,ts-global_detected_seizures,203243,203378,135
Jensen_Eisai_groupC,1,5,ts-global_detected_seizures,203381,203440,59
Jensen_Eisai_groupC,2,6,ts-global_detected_seizures,203415,203455,40
Jensen_Eisai_groupC,1,5,ts-global_detected_seizures,203441,203473,32
Jensen_Eisai_groupC,2,6,ts-global_detected_seizures,203458,203536,78
Jensen_Eisai_groupC,1,5,ts-global_detected_seizures,203491,203539,48
Jensen_Eisai_groupC,1,5,ts-global_detected_seizures,203559,203582,23
Jensen_Eisai_groupC,1,5,ts-global_detected_seizures,203585,203631,46
Jensen_Eisai_groupC,2,6,ts-global_detected_seizures,203637,203709,72
Jensen_Eisai_groupC,1,5,ts-global_detected_seizures,203656,203723,67
Jensen_Eisai_groupC,1,5,ts-global_detected_seizures,203725,203755,30
Jensen_Eisai_groupC,2,6,ts-global_detected_seizures,203780,203805,25
Jensen_Eisai_groupC,1,5,ts-global_detected_seizures,203848,203915,67
Jensen_Eisai_groupC,1,5,ts-global_detected_seizures,203935,204025,90
Jensen_Eisai_groupC,2,6,ts-global_detected_seizures,203964,204011,47
Jensen_Eisai_groupC,2,6,ts-global_detected_seizures,204012,204052,40
Jensen_Eisai_groupC,1,5,ts-global_detected_seizures,204052,204105,53
Jensen_Eisai_groupC,2,6,ts-global_detected_seizures,204053,204134,81
Jensen_Eisai_groupC,1,5,ts-global_detected_seizures,204115,204138,23
Jensen_Eisai_groupC,1,5,ts-global_detected_seizures,204149,204176,27
Jensen_Eisai_groupC,1,5,ts-global_detected_seizures,204196,204328,132
Jensen_Eisai_groupC,2,6,ts-global_detected_seizures,204206,204231,25
Jensen_Eisai_groupC,2,6,ts-global_detected_seizures,204260,204286,26
Jensen_Eisai_groupC,2,6,ts-global_detected_seizures,204297,204320,23
Jensen_Eisai_groupC,1,5,ts-global_detected_seizures,204350,204372,22
Jensen_Eisai_groupC,1,5,ts-global_detected_seizures,204394,204453,59
Jensen_Eisai_groupC,1,5,ts-global_detected_seizures,204455,204671,216
Jensen_Eisai_groupC,2,6,ts-global_detected_seizures,204548,204595,47
Jensen_Eisai_groupC,2,6,ts-global_detected_seizures,204645,204677,32
Jensen_Eisai_groupC,1,5,ts-global_detected_seizures,204687,204727,40
Jensen_Eisai_groupC,2,6,ts-global_detected_seizures,204741,204765,24
Jensen_Eisai_groupC,1,5,ts-global_detected_seizures,204752,204789,37
Jensen_Eisai_groupC,1,5,ts-global_detected_seizures,204815,204841,26
Jensen_Eisai_groupC,2,6,ts-global_detected_seizures,204828,204853,25
Jensen_Eisai_groupC,1,5,ts-global_detected_seizures,204878,204992,114
Jensen_Eisai_groupC,2,6,ts-global_detected_seizures,204950,204973,23
Jensen_Eisai_groupC,1,5,ts-global_detected_seizures,205008,205096,88
Jensen_Eisai_groupC,2,6,ts-global_detected_seizures,205011,205033,22
Jensen_Eisai_groupC,2,6,ts-global_detected_seizures,205071,205095,24
Jensen_Eisai_groupC,1,5,ts-global_detected_seizures,205099,205134,35
Jensen_Eisai_groupC,2,6,ts-global_detected_seizures,205113,205144,31
Jensen_Eisai_groupC,1,5,ts-global_detected_seizures,205155,205189,34
Jensen_Eisai_groupC,2,6,ts-global_detected_seizures,205166,205199,33
Jensen_Eisai_groupC,1,5,ts-global_detected_seizures,205223,205262,39
Jensen_Eisai_groupC,2,6,ts-global_detected_seizures,205286,205316,30
Jensen_Eisai_groupC,1,5,ts-global_detected_seizures,205331,205378,47
Jensen_Eisai_groupC,1,5,ts-global_detected_seizures,205393,205470,77
Jensen_Eisai_groupC,2,6,ts-global_detected_seizures,205398,205426,28
Jensen_Eisai_groupC,1,5,ts-global_detected_seizures,205496,205539,43
Jensen_Eisai_groupC,2,6,ts-global_detected_seizures,205503,205535,32
Jensen_Eisai_groupC,2,6,ts-global_detected_seizures,205538,205561,23
Jensen_Eisai_groupC,1,5,ts-global_detected_seizures,205575,205599,24
Jensen_Eisai_groupC,2,6,ts-global_detected_seizures,205603,205628,25
Jensen_Eisai_groupC,2,6,ts-global_detected_seizures,205629,205663,34
Jensen_Eisai_groupC,1,5,ts-global_detected_seizures,205633,205665,32
Jensen_Eisai_groupC,2,6,ts-global_detected_seizures,205666,205694,28
Jensen_Eisai_groupC,1,5,ts-global_detected_seizures,205686,205724,38
Jensen_Eisai_groupC,1,5,ts-global_detected_seizures,205739,205790,51
Jensen_Eisai_groupC,1,5,ts-global_detected_seizures,205804,205834,30
Jensen_Eisai_groupC,2,6,ts-global_detected_seizures,205841,205872,31
Jensen_Eisai_groupC,1,5,ts-global_detected_seizures,205857,206026,169
Jensen_Eisai_groupC,2,6,ts-global_detected_seizures,205873,205897,24
Jensen_Eisai_groupC,2,6,ts-global_detected_seizures,205951,205991,40
Jensen_Eisai_groupC,2,6,ts-global_detected_seizures,205995,206036,41
Jensen_Eisai_groupC,1,5,ts-global_detected_seizures,206028,206081,53
Jensen_Eisai_groupC,1,5,ts-global_detected_seizures,206084,206131,47
Jensen_Eisai_groupC,2,6,ts-global_detected_seizures,206089,206112,23
Jensen_Eisai_groupC,1,5,ts-global_detected_seizures,206160,206202,42
Jensen_Eisai_groupC,2,6,ts-global_detected_seizures,206178,206215,37
Jensen_Eisai_groupC,1,5,ts-global_detected_seizures,206203,206269,66
Jensen_Eisai_groupC,2,6,ts-global_detected_seizures,206262,206285,23
Jensen_Eisai_groupC,1,5,ts-global_detected_seizures,206285,206325,40
Jensen_Eisai_groupC,2,6,ts-global_detected_seizures,206322,206363,41
Jensen_Eisai_groupC,1,5,ts-global_detected_seizures,206328,206368,40
Jensen_Eisai_groupC,2,6,ts-global_detected_seizures,206394,206429,35
Jensen_Eisai_groupC,1,5,ts-global_detected_seizures,206404,206427,23
Jensen_Eisai_groupC,2,6,ts-global_detected_seizures,206485,206519,34
Jensen_Eisai_groupC,2,6,ts-global_detected_seizures,206536,206559,23
Jensen_Eisai_groupC,2,6,ts-global_detected_seizures,206560,206628,68
Jensen_Eisai_groupC,1,5,ts-global_detected_seizures,206568,206642,74
Jensen_Eisai_groupC,1,5,ts-global_detected_seizures,206658,206686,28
Jensen_Eisai_groupC,2,6,ts-global_detected_seizures,206672,206694,22
Jensen_Eisai_groupC,1,5,ts-global_detected_seizures,206687,206737,50
Jensen_Eisai_groupC,2,6,ts-global_detected_seizures,206708,206735,27
Jensen_Eisai_groupC,2,6,ts-global_detected_seizures,206757,206832,75
Jensen_Eisai_groupC,1,5,ts-global_detected_seizures,206768,206795,27
Jensen_Eisai_groupC,1,5,ts-global_detected_seizures,206798,206824,26
Jensen_Eisai_groupC,2,6,ts-global_detected_seizures,206834,207202,368
Jensen_Eisai_groupC,1,5,ts-global_detected_seizures,206837,206862,25
Jensen_Eisai_groupC,1,5,ts-global_detected_seizures,206886,206926,40
Jensen_Eisai_groupC,1,5,ts-global_detected_seizures,206947,206982,35
Jensen_Eisai_groupC,1,5,ts-global_detected_seizures,207041,207070,29
Jensen_Eisai_groupC,1,5,ts-global_detected_seizures,207152,207193,41
Jensen_Eisai_groupC,1,5,ts-global_detected_seizures,207214,207270,56
Jensen_Eisai_groupC,2,6,ts-global_detected_seizures,207262,207302,40
Jensen_Eisai_groupC,1,5,ts-global_detected_seizures,207299,207342,43
Jensen_Eisai_groupC,1,5,ts-global_detected_seizures,207345,207397,52
Jensen_Eisai_groupC,1,5,ts-global_detected_seizures,207403,207500,97
Jensen_Eisai_groupC,2,6,ts-global_detected_seizures,207430,208116,686
Jensen_Eisai_groupC,1,5,ts-global_detected_seizures,207501,207587,86
Jensen_Eisai_groupC,1,5,ts-global_detected_seizures,207618,207652,34
Jensen_Eisai_groupC,1,5,ts-global_detected_seizures,207653,207691,38
Jensen_Eisai_groupC,1,5,ts-global_detected_seizures,207715,207769,54
Jensen_Eisai_groupC,1,5,ts-global_detected_seizures,207779,207837,58
Jensen_Eisai_groupC,1,5,ts-global_detected_seizures,207855,207893,38
Jensen_Eisai_groupC,1,5,ts-global_detected_seizures,207905,207943,38
Jensen_Eisai_groupC,1,5,ts-global_detected_seizures,207968,208043,75
Jensen_Eisai_groupC,1,5,ts-global_detected_seizures,208077,208125,48
Jensen_Eisai_groupC,2,6,ts-global_detected_seizures,208127,208157,30
Jensen_Eisai_groupC,1,5,ts-global_detected_seizures,208157,208204,47
Jensen_Eisai_groupC,1,5,ts-global_detected_seizures,208205,208291,86
Jensen_Eisai_groupC,2,6,ts-global_detected_seizures,208220,208247,27
Jensen_Eisai_groupC,2,6,ts-global_detected_seizures,208291,208321,30
Jensen_Eisai_groupC,1,5,ts-global_detected_seizures,208327,208437,110
Jensen_Eisai_groupC,2,6,ts-global_detected_seizures,208350,208372,22
Jensen_Eisai_groupC,2,6,ts-global_detected_seizures,208416,208456,40
Jensen_Eisai_groupC,1,5,ts-global_detected_seizures,208438,209341,903
Jensen_Eisai_groupC,2,6,ts-global_detected_seizures,208531,208556,25
Jensen_Eisai_groupC,2,6,ts-global_detected_seizures,208612,208634,22
Jensen_Eisai_groupC,2,6,ts-global_detected_seizures,208700,208727,27
Jensen_Eisai_groupC,2,6,ts-global_detected_seizures,208734,208764,30
Jensen_Eisai_groupC,2,6,ts-global_detected_seizures,208838,208861,23
Jensen_Eisai_groupC,2,6,ts-global_detected_seizures,208909,208954,45
Jensen_Eisai_groupC,2,6,ts-global_detected_seizures,208955,209043,88
Jensen_Eisai_groupC,2,6,ts-global_detected_seizures,209191,209240,49
Jensen_Eisai_groupC,2,6,ts-global_detected_seizures,209271,209296,25
Jensen_Eisai_groupC,1,5,ts-global_detected_seizures,209342,209576,234
Jensen_Eisai_groupC,2,6,ts-global_detected_seizures,209483,209508,25
Jensen_Eisai_groupC,2,6,ts-global_detected_seizures,209569,209593,24
Jensen_Eisai_groupC,1,5,ts-global_detected_seizures,209577,209886,309
Jensen_Eisai_groupC,2,6,ts-global_detected_seizures,209652,209680,28
Jensen_Eisai_groupC,2,6,ts-global_detected_seizures,209870,209910,40
Jensen_Eisai_groupC,1,5,ts-global_detected_seizures,209887,209933,46
Jensen_Eisai_groupC,1,5,ts-global_detected_seizures,209934,209985,51
Jensen_Eisai_groupC,1,5,ts-global_detected_seizures,209987,210016,29
Jensen_Eisai_groupC,1,5,ts-global_detected_seizures,210035,210062,27
Jensen_Eisai_groupC,2,6,ts-global_detected_seizures,210037,210062,25
Jensen_Eisai_groupC,2,6,ts-global_detected_seizures,210121,210151,30
Jensen_Eisai_groupC,1,5,ts-global_detected_seizures,210149,210181,32
Jensen_Eisai_groupC,2,6,ts-global_detected_seizures,210154,210176,22
Jensen_Eisai_groupC,2,6,ts-global_detected_seizures,210177,210260,83
Jensen_Eisai_groupC,1,5,ts-global_detected_seizures,210202,210252,50
Jensen_Eisai_groupC,1,5,ts-global_detected_seizures,210298,210344,46
Jensen_Eisai_groupC,2,6,ts-global_detected_seizures,210312,210355,43
Jensen_Eisai_groupC,1,5,ts-global_detected_seizures,210345,210378,33
Jensen_Eisai_groupC,2,6,ts-global_detected_seizures,210393,210426,33
Jensen_Eisai_groupC,1,5,ts-global_detected_seizures,210421,210469,48
Jensen_Eisai_groupC,2,6,ts-global_detected_seizures,210458,210488,30
Jensen_Eisai_groupC,1,5,ts-global_detected_seizures,210480,210509,29
Jensen_Eisai_groupC,2,6,ts-global_detected_seizures,210553,210575,22
Jensen_Eisai_groupC,1,5,ts-global_detected_seizures,210577,210634,57
Jensen_Eisai_groupC,2,6,ts-global_detected_seizures,210583,210611,28
Jensen_Eisai_groupC,2,6,ts-global_detected_seizures,210647,210702,55
Jensen_Eisai_groupC,1,5,ts-global_detected_seizures,210687,210715,28
Jensen_Eisai_groupC,2,6,ts-global_detected_seizures,210712,210741,29
Jensen_Eisai_groupC,1,5,ts-global_detected_seizures,210749,210793,44
Jensen_Eisai_groupC,1,5,ts-global_detected_seizures,210826,210854,28
Jensen_Eisai_groupC,1,5,ts-global_detected_seizures,210891,210929,38
Jensen_Eisai_groupC,2,6,ts-global_detected_seizures,210964,210986,22
Jensen_Eisai_groupC,1,5,ts-global_detected_seizures,210997,211036,39
Jensen_Eisai_groupC,2,6,ts-global_detected_seizures,211107,211136,29
Jensen_Eisai_groupC,1,5,ts-global_detected_seizures,211125,211195,70
Jensen_Eisai_groupC,2,6,ts-global_detected_seizures,211208,211241,33
Jensen_Eisai_groupC,1,5,ts-global_detected_seizures,211257,211285,28
Jensen_Eisai_groupC,2,6,ts-global_detected_seizures,211267,211304,37
Jensen_Eisai_groupC,1,5,ts-global_detected_seizures,211293,211337,44
Jensen_Eisai_groupC,2,6,ts-global_detected_seizures,211360,211391,31
Jensen_Eisai_groupC,1,5,ts-global_detected_seizures,211377,211400,23
Jensen_Eisai_groupC,1,5,ts-global_detected_seizures,211401,211430,29
Jensen_Eisai_groupC,2,6,ts-global_detected_seizures,211413,211453,40
Jensen_Eisai_groupC,1,5,ts-global_detected_seizures,211442,211476,34
Jensen_Eisai_groupC,2,6,ts-global_detected_seizures,211454,211575,121
Jensen_Eisai_groupC,1,5,ts-global_detected_seizures,211481,211514,33
Jensen_Eisai_groupC,2,6,ts-global_detected_seizures,211576,211776,200
Jensen_Eisai_groupC,1,5,ts-global_detected_seizures,211583,211638,55
Jensen_Eisai_groupC,1,5,ts-global_detected_seizures,211642,211665,23
Jensen_Eisai_groupC,1,5,ts-global_detected_seizures,211670,211693,23
Jensen_Eisai_groupC,1,5,ts-global_detected_seizures,211744,211770,26
Jensen_Eisai_groupC,2,6,ts-global_detected_seizures,211778,212053,275
Jensen_Eisai_groupC,1,5,ts-global_detected_seizures,211805,212147,342
Jensen_Eisai_groupC,2,6,ts-global_detected_seizures,212054,212778,724
Jensen_Eisai_groupC,1,5,ts-global_detected_seizures,212148,212490,342
Jensen_Eisai_groupC,1,5,ts-global_detected_seizures,212501,212875,374
Jensen_Eisai_groupC,2,6,ts-global_detected_seizures,212786,212811,25
Jensen_Eisai_groupC,1,5,ts-global_detected_seizures,212877,212921,44
Jensen_Eisai_groupC,1,5,ts-global_detected_seizures,212935,212963,28
Jensen_Eisai_groupC,1,5,ts-global_detected_seizures,212968,213011,43
Jensen_Eisai_groupC,2,6,ts-global_detected_seizures,212982,213020,38
Jensen_Eisai_groupC,1,5,ts-global_detected_seizures,213015,213039,24
Jensen_Eisai_groupC,2,6,ts-global_detected_seizures,213036,213058,22
Jensen_Eisai_groupC,1,5,ts-global_detected_seizures,213056,213092,36
Jensen_Eisai_groupC,2,6,ts-global_detected_seizures,213083,213107,24
Jensen_Eisai_groupC,1,5,ts-global_detected_seizures,213134,213156,22
Jensen_Eisai_groupC,2,6,ts-global_detected_seizures,213151,213184,33
Jensen_Eisai_groupC,1,5,ts-global_detected_seizures,213193,213225,32
Jensen_Eisai_groupC,2,6,ts-global_detected_seizures,213241,213269,28
Jensen_Eisai_groupC,1,5,ts-global_detected_seizures,213245,213293,48
Jensen_Eisai_groupC,1,5,ts-global_detected_seizures,213317,213362,45
Jensen_Eisai_groupC,2,6,ts-global_detected_seizures,213346,213377,31
Jensen_Eisai_groupC,1,5,ts-global_detected_seizures,213375,213402,27
Jensen_Eisai_groupC,2,6,ts-global_detected_seizures,213419,213444,25
Jensen_Eisai_groupC,1,5,ts-global_detected_seizures,213434,213472,38
Jensen_Eisai_groupC,2,6,ts-global_detected_seizures,213483,213506,23
Jensen_Eisai_groupC,1,5,ts-global_detected_seizures,213487,213518,31
Jensen_Eisai_groupC,2,6,ts-global_detected_seizures,213534,213564,30
Jensen_Eisai_groupC,1,5,ts-global_detected_seizures,213590,213622,32
Jensen_Eisai_groupC,1,5,ts-global_detected_seizures,213657,213696,39
Jensen_Eisai_groupC,2,6,ts-global_detected_seizures,213679,213704,25
Jensen_Eisai_groupC,1,5,ts-global_detected_seizures,213744,213845,101
Jensen_Eisai_groupC,1,5,ts-global_detected_seizures,213846,213872,26
Jensen_Eisai_groupC,1,5,ts-global_detected_seizures,213889,213944,55
Jensen_Eisai_groupC,2,6,ts-global_detected_seizures,213919,213944,25
Jensen_Eisai_groupC,2,6,ts-global_detected_seizures,214034,214071,37
Jensen_Eisai_groupC,1,5,ts-global_detected_seizures,214051,214119,68
Jensen_Eisai_groupC,1,5,ts-global_detected_seizures,214146,214172,26
Jensen_Eisai_groupC,2,6,ts-global_detected_seizures,214149,214185,36
Jensen_Eisai_groupC,1,5,ts-global_detected_seizures,214239,214264,25
Jensen_Eisai_groupC,2,6,ts-global_detected_seizures,214304,214610,306
Jensen_Eisai_groupC,1,5,ts-global_detected_seizures,214313,214365,52
Jensen_Eisai_groupC,1,5,ts-global_detected_seizures,214378,214412,34
Jensen_Eisai_groupC,1,5,ts-global_detected_seizures,214434,214512,78
Jensen_Eisai_groupC,1,5,ts-global_detected_seizures,214539,214564,25
Jensen_Eisai_groupC,1,5,ts-global_detected_seizures,214576,214599,23
Jensen_Eisai_groupC,1,5,ts-global_detected_seizures,214600,214700,100
Jensen_Eisai_groupC,2,6,ts-global_detected_seizures,214611,214752,141
Jensen_Eisai_groupC,1,5,ts-global_detected_seizures,214708,214852,144
Jensen_Eisai_groupC,2,6,ts-global_detected_seizures,214769,214807,38
Jensen_Eisai_groupC,2,6,ts-global_detected_seizures,214809,214861,52
Jensen_Eisai_groupC,1,5,ts-global_detected_seizures,214853,215118,265
Jensen_Eisai_groupC,2,6,ts-global_detected_seizures,214862,215194,332
Jensen_Eisai_groupC,1,5,ts-global_detected_seizures,215119,215168,49
Jensen_Eisai_groupC,1,5,ts-global_detected_seizures,215169,215330,161
Jensen_Eisai_groupC,2,6,ts-global_detected_seizures,215196,215219,23
Jensen_Eisai_groupC,2,6,ts-global_detected_seizures,215279,215304,25
Jensen_Eisai_groupC,2,6,ts-global_detected_seizures,215310,215332,22
Jensen_Eisai_groupC,1,5,ts-global_detected_seizures,215331,215474,143
Jensen_Eisai_groupC,2,6,ts-global_detected_seizures,215396,215440,44
Jensen_Eisai_groupC,2,6,ts-global_detected_seizures,215460,215486,26
Jensen_Eisai_groupC,1,5,ts-global_detected_seizures,215475,215511,36
Jensen_Eisai_groupC,1,5,ts-global_detected_seizures,215513,215560,47
Jensen_Eisai_groupC,2,6,ts-global_detected_seizures,215528,215550,22
Jensen_Eisai_groupC,1,5,ts-global_detected_seizures,215561,215644,83
Jensen_Eisai_groupC,2,6,ts-global_detected_seizures,215601,215625,24
Jensen_Eisai_groupC,1,5,ts-global_detected_seizures,215645,215789,144
Jensen_Eisai_groupC,1,5,ts-global_detected_seizures,215791,215839,48
Jensen_Eisai_groupC,2,6,ts-global_detected_seizures,215823,215851,28
Jensen_Eisai_groupC,1,5,ts-global_detected_seizures,215863,215947,84
Jensen_Eisai_groupC,2,6,ts-global_detected_seizures,215885,215911,26
Jensen_Eisai_groupC,1,5,ts-global_detected_seizures,215964,216003,39
Jensen_Eisai_groupC,1,5,ts-global_detected_seizures,216061,216125,64
Jensen_Eisai_groupC,1,5,ts-global_detected_seizures,216126,216149,23
Jensen_Eisai_groupC,2,6,ts-global_detected_seizures,216144,216171,27
Jensen_Eisai_groupC,1,5,ts-global_detected_seizures,216155,216197,42
Jensen_Eisai_groupC,1,5,ts-global_detected_seizures,216198,216233,35
Jensen_Eisai_groupC,1,5,ts-global_detected_seizures,216251,216304,53
Jensen_Eisai_groupC,1,5,ts-global_detected_seizures,216305,216354,49
Jensen_Eisai_groupC,1,5,ts-global_detected_seizures,216380,216429,49
Jensen_Eisai_groupC,1,5,ts-global_detected_seizures,216438,216464,26
Jensen_Eisai_groupC,2,6,ts-global_detected_seizures,216456,216485,29
Jensen_Eisai_groupC,1,5,ts-global_detected_seizures,216564,216586,22
Jensen_Eisai_groupC,1,5,ts-global_detected_seizures,216587,216636,49
Jensen_Eisai_groupC,1,5,ts-global_detected_seizures,216645,216693,48
Jensen_Eisai_groupC,1,5,ts-global_detected_seizures,216694,216716,22
Jensen_Eisai_groupC,1,5,ts-global_detected_seizures,216732,216758,26
Jensen_Eisai_groupC,1,5,ts-global_detected_seizures,216797,216834,37
Jensen_Eisai_groupC,1,5,ts-global_detected_seizures,216853,216877,24
Jensen_Eisai_groupC,1,5,ts-global_detected_seizures,216926,216953,27
Jensen_Eisai_groupC,1,5,ts-global_detected_seizures,216926,216953,27
Jensen_Eisai_groupC,1,5,ts-global_detected_seizures,216954,216976,22
Jensen_Eisai_groupC,1,5,ts-global_detected_seizures,216991,217017,26
Jensen_Eisai_groupC,2,6,ts-global_detected_seizures,216997,217019,22
Jensen_Eisai_groupC,1,5,ts-global_detected_seizures,217165,217189,24
Jensen_Eisai_groupC,1,5,ts-global_detected_seizures,217236,217261,25
Jensen_Eisai_groupC,1,5,ts-global_detected_seizures,217314,217358,44
Jensen_Eisai_groupC,1,5,ts-global_detected_seizures,217383,217412,29
Jensen_Eisai_groupC,1,5,ts-global_detected_seizures,217415,217439,24
Jensen_Eisai_groupC,1,5,ts-global_detected_seizures,217462,217499,37
Jensen_Eisai_groupC,1,5,ts-global_detected_seizures,217500,217528,28
Jensen_Eisai_groupC,1,5,ts-global_detected_seizures,217551,217691,140
Jensen_Eisai_groupC,2,6,ts-global_detected_seizures,217568,217598,30
Jensen_Eisai_groupC,1,5,ts-global_detected_seizures,217726,217757,31
Jensen_Eisai_groupC,1,5,ts-global_detected_seizures,217786,217857,71
Jensen_Eisai_groupC,2,6,ts-global_detected_seizures,217787,217815,28
Jensen_Eisai_groupC,1,5,ts-global_detected_seizures,217876,217947,71
Jensen_Eisai_groupC,1,5,ts-global_detected_seizures,217983,218014,31
Jensen_Eisai_groupC,2,6,ts-global_detected_seizures,218018,218045,27
Jensen_Eisai_groupC,1,5,ts-global_detected_seizures,218086,218193,107
Jensen_Eisai_groupC,1,5,ts-global_detected_seizures,218288,218336,48
Jensen_Eisai_groupC,1,5,ts-global_detected_seizures,218337,218384,47
Jensen_Eisai_groupC,2,6,ts-global_detected_seizures,218394,218418,24
Jensen_Eisai_groupC,1,5,ts-global_detected_seizures,218399,218487,88
Jensen_Eisai_groupC,1,5,ts-global_detected_seizures,218500,218523,23
Jensen_Eisai_groupC,1,5,ts-global_detected_seizures,218551,218589,38
Jensen_Eisai_groupC,2,6,ts-global_detected_seizures,218553,218596,43
Jensen_Eisai_groupC,1,5,ts-global_detected_seizures,218622,218661,39
Jensen_Eisai_groupC,1,5,ts-global_detected_seizures,218688,218716,28
Jensen_Eisai_groupC,1,5,ts-global_detected_seizures,218728,218783,55
Jensen_Eisai_groupC,1,5,ts-global_detected_seizures,218791,218854,63
Jensen_Eisai_groupC,1,5,ts-global_detected_seizures,218855,218880,25
Jensen_Eisai_groupC,2,6,ts-global_detected_seizures,218857,218886,29
Jensen_Eisai_groupC,1,5,ts-global_detected_seizures,218881,218930,49
Jensen_Eisai_groupC,1,5,ts-global_detected_seizures,218943,219070,127
Jensen_Eisai_groupC,2,6,ts-global_detected_seizures,219010,219042,32
Jensen_Eisai_groupC,2,6,ts-global_detected_seizures,219043,219071,28
Jensen_Eisai_groupC,2,6,ts-global_detected_seizures,219098,219127,29
Jensen_Eisai_groupC,2,6,ts-global_detected_seizures,219134,219161,27
Jensen_Eisai_groupC,1,5,ts-global_detected_seizures,219161,219202,41
Jensen_Eisai_groupC,2,6,ts-global_detected_seizures,219205,219243,38
Jensen_Eisai_groupC,1,5,ts-global_detected_seizures,219268,219309,41
Jensen_Eisai_groupC,1,5,ts-global_detected_seizures,219310,219555,245
Jensen_Eisai_groupC,2,6,ts-global_detected_seizures,219321,219366,45
Jensen_Eisai_groupC,2,6,ts-global_detected_seizures,219370,219440,70
Jensen_Eisai_groupC,2,6,ts-global_detected_seizures,219493,219537,44
Jensen_Eisai_groupC,1,5,ts-global_detected_seizures,219567,219662,95
Jensen_Eisai_groupC,2,6,ts-global_detected_seizures,219602,219652,50
Jensen_Eisai_groupC,1,5,ts-global_detected_seizures,219666,219696,30
Jensen_Eisai_groupC,1,5,ts-global_detected_seizures,219703,219940,237
Jensen_Eisai_groupC,2,6,ts-global_detected_seizures,219743,219773,30
Jensen_Eisai_groupC,2,6,ts-global_detected_seizures,219774,219800,26
Jensen_Eisai_groupC,2,6,ts-global_detected_seizures,219809,219852,43
Jensen_Eisai_groupC,2,6,ts-global_detected_seizures,219853,219882,29
Jensen_Eisai_groupC,2,6,ts-global_detected_seizures,219884,219907,23
Jensen_Eisai_groupC,2,6,ts-global_detected_seizures,219908,219950,42
Jensen_Eisai_groupC,1,5,ts-global_detected_seizures,219991,220101,110
Jensen_Eisai_groupC,2,6,ts-global_detected_seizures,220051,220107,56
Jensen_Eisai_groupC,1,5,ts-global_detected_seizures,220102,220226,124
Jensen_Eisai_groupC,2,6,ts-global_detected_seizures,220108,220161,53
Jensen_Eisai_groupC,1,5,ts-global_detected_seizures,220229,220471,242
Jensen_Eisai_groupC,2,6,ts-global_detected_seizures,220238,220287,49
Jensen_Eisai_groupC,2,6,ts-global_detected_seizures,220288,220310,22
Jensen_Eisai_groupC,2,6,ts-global_detected_seizures,220313,220340,27
Jensen_Eisai_groupC,2,6,ts-global_detected_seizures,220409,220441,32
Jensen_Eisai_groupC,1,5,ts-global_detected_seizures,220476,220518,42
Jensen_Eisai_groupC,2,6,ts-global_detected_seizures,220526,220578,52
Jensen_Eisai_groupC,1,5,ts-global_detected_seizures,220561,220671,110
Jensen_Eisai_groupC,2,6,ts-global_detected_seizures,220579,220603,24
Jensen_Eisai_groupC,2,6,ts-global_detected_seizures,220605,220633,28
Jensen_Eisai_groupC,1,5,ts-global_detected_seizures,220674,220705,31
Jensen_Eisai_groupC,1,5,ts-global_detected_seizures,220707,220830,123
Jensen_Eisai_groupC,1,5,ts-global_detected_seizures,220831,220912,81
Jensen_Eisai_groupC,2,6,ts-global_detected_seizures,220909,220932,23
Jensen_Eisai_groupC,1,5,ts-global_detected_seizures,220926,221046,120
Jensen_Eisai_groupC,1,5,ts-global_detected_seizures,221065,221235,170
Jensen_Eisai_groupC,2,6,ts-global_detected_seizures,221116,221139,23
Jensen_Eisai_groupC,1,5,ts-global_detected_seizures,221236,221357,121
Jensen_Eisai_groupC,1,5,ts-global_detected_seizures,221358,221703,345
Jensen_Eisai_groupC,2,6,ts-global_detected_seizures,221544,221570,26
Jensen_Eisai_groupC,2,6,ts-global_detected_seizures,221641,221846,205
Jensen_Eisai_groupC,1,5,ts-global_detected_seizures,221704,221876,172
Jensen_Eisai_groupC,2,6,ts-global_detected_seizures,221849,222130,281
Jensen_Eisai_groupC,1,5,ts-global_detected_seizures,221878,222028,150
Jensen_Eisai_groupC,1,5,ts-global_detected_seizures,222029,222306,277
Jensen_Eisai_groupC,2,6,ts-global_detected_seizures,222131,222404,273
Jensen_Eisai_groupC,1,5,ts-global_detected_seizures,222307,222333,26
Jensen_Eisai_groupC,1,5,ts-global_detected_seizures,222334,222361,27
Jensen_Eisai_groupC,1,5,ts-global_detected_seizures,222394,222418,24
Jensen_Eisai_groupC,2,6,ts-global_detected_seizures,222405,222459,54
Jensen_Eisai_groupC,1,5,ts-global_detected_seizures,222419,222485,66
Jensen_Eisai_groupC,2,6,ts-global_detected_seizures,222478,222730,252
Jensen_Eisai_groupC,1,5,ts-global_detected_seizures,222486,222662,176
Jensen_Eisai_groupC,1,5,ts-global_detected_seizures,222663,222824,161
Jensen_Eisai_groupC,2,6,ts-global_detected_seizures,222731,222777,46
Jensen_Eisai_groupC,2,6,ts-global_detected_seizures,222778,223065,287
Jensen_Eisai_groupC,1,5,ts-global_detected_seizures,222825,222924,99
Jensen_Eisai_groupC,1,5,ts-global_detected_seizures,222940,222976,36
Jensen_Eisai_groupC,1,5,ts-global_detected_seizures,222977,223201,224
Jensen_Eisai_groupC,2,6,ts-global_detected_seizures,223066,223108,42
Jensen_Eisai_groupC,2,6,ts-global_detected_seizures,223195,223241,46
Jensen_Eisai_groupC,1,5,ts-global_detected_seizures,223207,223453,246
Jensen_Eisai_groupC,1,5,ts-global_detected_seizures,223454,223616,162
Jensen_Eisai_groupC,2,6,ts-global_detected_seizures,223513,223542,29
Jensen_Eisai_groupC,1,5,ts-global_detected_seizures,223617,223712,95
Jensen_Eisai_groupC,1,5,ts-global_detected_seizures,223713,223871,158
Jensen_Eisai_groupC,1,5,ts-global_detected_seizures,223873,223977,104
Jensen_Eisai_groupC,2,6,ts-global_detected_seizures,223925,223962,37
Jensen_Eisai_groupC,1,5,ts-global_detected_seizures,224003,224140,137
Jensen_Eisai_groupC,1,5,ts-global_detected_seizures,224141,224259,118
Jensen_Eisai_groupC,1,5,ts-global_detected_seizures,224260,224470,210
Jensen_Eisai_groupC,2,6,ts-global_detected_seizures,224266,224290,24
Jensen_Eisai_groupC,2,6,ts-global_detected_seizures,224458,224480,22
Jensen_Eisai_groupC,1,5,ts-global_detected_seizures,224486,224556,70
Jensen_Eisai_groupC,1,5,ts-global_detected_seizures,224557,224954,397
Jensen_Eisai_groupC,2,6,ts-global_detected_seizures,224615,225062,447
Jensen_Eisai_groupC,1,5,ts-global_detected_seizures,225004,225060,56
Jensen_Eisai_groupC,1,5,ts-global_detected_seizures,225061,225124,63
Jensen_Eisai_groupC,2,6,ts-global_detected_seizures,225063,225335,272
Jensen_Eisai_groupC,1,5,ts-global_detected_seizures,225125,225173,48
Jensen_Eisai_groupC,1,5,ts-global_detected_seizures,225174,225231,57
Jensen_Eisai_groupC,1,5,ts-global_detected_seizures,225235,225306,71
Jensen_Eisai_groupC,1,5,ts-global_detected_seizures,225307,225348,41
Jensen_Eisai_groupC,2,6,ts-global_detected_seizures,225336,225382,46
Jensen_Eisai_groupC,1,5,ts-global_detected_seizures,225363,225498,135
Jensen_Eisai_groupC,2,6,ts-global_detected_seizures,225388,225714,326
Jensen_Eisai_groupC,1,5,ts-global_detected_seizures,225502,225672,170
Jensen_Eisai_groupC,1,5,ts-global_detected_seizures,225678,225712,34
Jensen_Eisai_groupC,1,5,ts-global_detected_seizures,225741,225923,182
Jensen_Eisai_groupC,2,6,ts-global_detected_seizures,225742,225766,24
Jensen_Eisai_groupC,2,6,ts-global_detected_seizures,225815,225840,25
Jensen_Eisai_groupC,2,6,ts-global_detected_seizures,225857,225925,68
Jensen_Eisai_groupC,1,5,ts-global_detected_seizures,225924,226186,262
Jensen_Eisai_groupC,2,6,ts-global_detected_seizures,225926,226247,321
Jensen_Eisai_groupC,1,5,ts-global_detected_seizures,226187,226225,38
Jensen_Eisai_groupC,1,5,ts-global_detected_seizures,226235,226425,190
Jensen_Eisai_groupC,2,6,ts-global_detected_seizures,226251,226540,289
Jensen_Eisai_groupC,1,5,ts-global_detected_seizures,226426,226471,45
Jensen_Eisai_groupC,1,5,ts-global_detected_seizures,226473,226549,76
Jensen_Eisai_groupC,2,6,ts-global_detected_seizures,226541,226581,40
Jensen_Eisai_groupC,1,5,ts-global_detected_seizures,226551,226689,138
Jensen_Eisai_groupC,2,6,ts-global_detected_seizures,226583,226622,39
Jensen_Eisai_groupC,2,6,ts-global_detected_seizures,226629,226929,300
Jensen_Eisai_groupC,1,5,ts-global_detected_seizures,226709,226818,109
Jensen_Eisai_groupC,1,5,ts-global_detected_seizures,226840,226862,22
Jensen_Eisai_groupC,1,5,ts-global_detected_seizures,226929,227235,306
Jensen_Eisai_groupC,2,6,ts-global_detected_seizures,226930,227022,92
Jensen_Eisai_groupC,2,6,ts-global_detected_seizures,227023,227121,98
Jensen_Eisai_groupC,2,6,ts-global_detected_seizures,227122,227243,121
Jensen_Eisai_groupC,1,5,ts-global_detected_seizures,227236,227267,31
Jensen_Eisai_groupC,2,6,ts-global_detected_seizures,227248,227783,535
Jensen_Eisai_groupC,1,5,ts-global_detected_seizures,227268,227312,44
Jensen_Eisai_groupC,1,5,ts-global_detected_seizures,227313,227336,23
Jensen_Eisai_groupC,1,5,ts-global_detected_seizures,227351,227373,22
Jensen_Eisai_groupC,1,5,ts-global_detected_seizures,227385,227420,35
Jensen_Eisai_groupC,1,5,ts-global_detected_seizures,227721,227762,41
Jensen_Eisai_groupC,1,5,ts-global_detected_seizures,228001,228068,67
Jensen_Eisai_groupC,1,5,ts-global_detected_seizures,228088,228115,27
Jensen_Eisai_groupC,2,6,ts-global_detected_seizures,228289,228323,34
Jensen_Eisai_groupC,1,5,ts-global_detected_seizures,228350,228375,25
Jensen_Eisai_groupC,2,6,ts-global_detected_seizures,228433,228685,252
Jensen_Eisai_groupC,1,5,ts-global_detected_seizures,228512,228540,28
Jensen_Eisai_groupC,1,5,ts-global_detected_seizures,228648,228676,28
Jensen_Eisai_groupC,2,6,ts-global_detected_seizures,228811,228834,23
Jensen_Eisai_groupC,1,5,ts-global_detected_seizures,228852,228907,55
Jensen_Eisai_groupC,1,5,ts-global_detected_seizures,228913,228965,52
Jensen_Eisai_groupC,1,5,ts-global_detected_seizures,229061,229084,23
Jensen_Eisai_groupC,2,6,ts-global_detected_seizures,229091,229121,30
Jensen_Eisai_groupC,1,5,ts-global_detected_seizures,229245,229272,27
Jensen_Eisai_groupC,2,6,ts-global_detected_seizures,229278,229301,23
Jensen_Eisai_groupC,1,5,ts-global_detected_seizures,229304,229337,33
Jensen_Eisai_groupC,2,6,ts-global_detected_seizures,229358,229394,36
Jensen_Eisai_groupC,2,6,ts-global_detected_seizures,229398,229420,22
Jensen_Eisai_groupC,1,5,ts-global_detected_seizures,229492,229515,23
Jensen_Eisai_groupC,2,6,ts-global_detected_seizures,229622,229684,62
Jensen_Eisai_groupC,1,5,ts-global_detected_seizures,229643,229665,22
Jensen_Eisai_groupC,1,5,ts-global_detected_seizures,229723,229800,77
Jensen_Eisai_groupC,2,6,ts-global_detected_seizures,229734,229756,22
Jensen_Eisai_groupC,2,6,ts-global_detected_seizures,229815,229845,30
Jensen_Eisai_groupC,1,5,ts-global_detected_seizures,229884,230689,805
Jensen_Eisai_groupC,2,6,ts-global_detected_seizures,229998,230022,24
Jensen_Eisai_groupC,2,6,ts-global_detected_seizures,230042,230067,25
Jensen_Eisai_groupC,2,6,ts-global_detected_seizures,230113,230665,552
Jensen_Eisai_groupC,2,6,ts-global_detected_seizures,230666,230763,97
Jensen_Eisai_groupC,1,5,ts-global_detected_seizures,230691,231832,1141
Jensen_Eisai_groupC,2,6,ts-global_detected_seizures,230765,230935,170
Jensen_Eisai_groupC,2,6,ts-global_detected_seizures,230936,231217,281
Jensen_Eisai_groupC,2,6,ts-global_detected_seizures,231218,231956,738
Jensen_Eisai_groupC,1,5,ts-global_detected_seizures,231833,231921,88
Jensen_Eisai_groupC,1,5,ts-global_detected_seizures,231922,232200,278
Jensen_Eisai_groupC,2,6,ts-global_detected_seizures,231957,232204,247
Jensen_Eisai_groupC,1,5,ts-global_detected_seizures,232201,232498,297
Jensen_Eisai_groupC,2,6,ts-global_detected_seizures,232205,232610,405
Jensen_Eisai_groupC,1,5,ts-global_detected_seizures,232499,232791,292
Jensen_Eisai_groupC,2,6,ts-global_detected_seizures,232611,232776,165
Jensen_Eisai_groupC,1,5,ts-global_detected_seizures,232792,233021,229
Jensen_Eisai_groupC,2,6,ts-global_detected_seizures,232796,232818,22
Jensen_Eisai_groupC,2,6,ts-global_detected_seizures,232819,232896,77
Jensen_Eisai_groupC,2,6,ts-global_detected_seizures,232902,233631,729
Jensen_Eisai_groupC,1,5,ts-global_detected_seizures,233022,233543,521
Jensen_Eisai_groupC,1,5,ts-global_detected_seizures,233544,233772,228
Jensen_Eisai_groupC,2,6,ts-global_detected_seizures,233632,234323,691
Jensen_Eisai_groupC,1,5,ts-global_detected_seizures,233773,234268,495
Jensen_Eisai_groupC,1,5,ts-global_detected_seizures,234269,234465,196
Jensen_Eisai_groupC,2,6,ts-global_detected_seizures,234324,234447,123
Jensen_Eisai_groupC,2,6,ts-global_detected_seizures,234448,234956,508
Jensen_Eisai_groupC,1,5,ts-global_detected_seizures,234475,234765,290
Jensen_Eisai_groupC,1,5,ts-global_detected_seizures,234768,235592,824
Jensen_Eisai_groupC,2,6,ts-global_detected_seizures,234957,235054,97
Jensen_Eisai_groupC,2,6,ts-global_detected_seizures,235055,235375,320
Jensen_Eisai_groupC,2,6,ts-global_detected_seizures,235415,235453,38
Jensen_Eisai_groupC,2,6,ts-global_detected_seizures,235454,236341,887
Jensen_Eisai_groupC,1,5,ts-global_detected_seizures,235593,235832,239
Jensen_Eisai_groupC,1,5,ts-global_detected_seizures,235833,235859,26
Jensen_Eisai_groupC,1,5,ts-global_detected_seizures,235860,236303,443
Jensen_Eisai_groupC,1,5,ts-global_detected_seizures,236304,236622,318
Jensen_Eisai_groupC,2,6,ts-global_detected_seizures,236342,236834,492
Jensen_Eisai_groupC,1,5,ts-global_detected_seizures,236623,236711,88
Jensen_Eisai_groupC,1,5,ts-global_detected_seizures,236725,237069,344
Jensen_Eisai_groupC,2,6,ts-global_detected_seizures,236965,236996,31
Jensen_Eisai_groupC,2,6,ts-global_detected_seizures,237059,237082,23
Jensen_Eisai_groupC,1,5,ts-global_detected_seizures,237075,237382,307
Jensen_Eisai_groupC,2,6,ts-global_detected_seizures,237153,237207,54
Jensen_Eisai_groupC,1,5,ts-global_detected_seizures,237383,237577,194
Jensen_Eisai_groupC,2,6,ts-global_detected_seizures,237397,237462,65
Jensen_Eisai_groupC,2,6,ts-global_detected_seizures,237526,237576,50
Jensen_Eisai_groupC,1,5,ts-global_detected_seizures,237578,237663,85
Jensen_Eisai_groupC,2,6,ts-global_detected_seizures,237613,237655,42
Jensen_Eisai_groupC,1,5,ts-global_detected_seizures,237679,237717,38
Jensen_Eisai_groupC,1,5,ts-global_detected_seizures,237721,237755,34
Jensen_Eisai_groupC,1,5,ts-global_detected_seizures,237756,238655,899
Jensen_Eisai_groupC,2,6,ts-global_detected_seizures,237986,238017,31
Jensen_Eisai_groupC,2,6,ts-global_detected_seizures,238072,238105,33
Jensen_Eisai_groupC,2,6,ts-global_detected_seizures,238229,238252,23
Jensen_Eisai_groupC,2,6,ts-global_detected_seizures,238362,238405,43
Jensen_Eisai_groupC,2,6,ts-global_detected_seizures,238567,239063,496
Jensen_Eisai_groupC,1,5,ts-global_detected_seizures,238658,238701,43
Jensen_Eisai_groupC,1,5,ts-global_detected_seizures,238702,238780,78
Jensen_Eisai_groupC,1,5,ts-global_detected_seizures,238787,238842,55
Jensen_Eisai_groupC,1,5,ts-global_detected_seizures,238867,238897,30
Jensen_Eisai_groupC,1,5,ts-global_detected_seizures,238920,239065,145
Jensen_Eisai_groupC,1,5,ts-global_detected_seizures,239066,239165,99
Jensen_Eisai_groupC,1,5,ts-global_detected_seizures,239167,239220,53
Jensen_Eisai_groupC,2,6,ts-global_detected_seizures,239335,239357,22
Jensen_Eisai_groupC,2,6,ts-global_detected_seizures,239409,239439,30
Jensen_Eisai_groupC,1,5,ts-global_detected_seizures,239554,239926,372
Jensen_Eisai_groupC,2,6,ts-global_detected_seizures,239564,239599,35
Jensen_Eisai_groupC,2,6,ts-global_detected_seizures,239711,239735,24
Jensen_Eisai_groupC,2,6,ts-global_detected_seizures,239817,239844,27
Jensen_Eisai_groupC,1,5,ts-global_detected_seizures,239943,239966,23
Jensen_Eisai_groupC,2,6,ts-global_detected_seizures,240062,240094,32
Jensen_Eisai_groupC,1,5,ts-global_detected_seizures,240134,240159,25
Jensen_Eisai_groupC,2,6,ts-global_detected_seizures,240190,240217,27
Jensen_Eisai_groupC,2,6,ts-global_detected_seizures,240287,240323,36
Jensen_Eisai_groupC,1,5,ts-global_detected_seizures,240390,240419,29
Jensen_Eisai_groupC,2,6,ts-global_detected_seizures,240425,240448,23
Jensen_Eisai_groupC,2,6,ts-global_detected_seizures,240488,240527,39
Jensen_Eisai_groupC,2,6,ts-global_detected_seizures,240592,240618,26
Jensen_Eisai_groupC,1,5,ts-global_detected_seizures,240723,240750,27
Jensen_Eisai_groupC,2,6,ts-global_detected_seizures,240741,240789,48
Jensen_Eisai_groupC,1,5,ts-global_detected_seizures,240781,240807,26
Jensen_Eisai_groupC,1,5,ts-global_detected_seizures,240866,240963,97
Jensen_Eisai_groupC,2,6,ts-global_detected_seizures,240900,240941,41
Jensen_Eisai_groupC,2,6,ts-global_detected_seizures,241012,241041,29
Jensen_Eisai_groupC,2,6,ts-global_detected_seizures,241084,241113,29
Jensen_Eisai_groupC,1,5,ts-global_detected_seizures,241164,241201,37
Jensen_Eisai_groupC,2,6,ts-global_detected_seizures,241201,241236,35
Jensen_Eisai_groupC,1,5,ts-global_detected_seizures,241238,241270,32
Jensen_Eisai_groupC,1,5,ts-global_detected_seizures,241274,241301,27
Jensen_Eisai_groupC,2,6,ts-global_detected_seizures,241311,241490,179
Jensen_Eisai_groupC,1,5,ts-global_detected_seizures,241328,241361,33
Jensen_Eisai_groupC,1,5,ts-global_detected_seizures,241364,241390,26
Jensen_Eisai_groupC,2,6,ts-global_detected_seizures,241533,241556,23
Jensen_Eisai_groupC,1,5,ts-global_detected_seizures,241596,241620,24
Jensen_Eisai_groupC,1,5,ts-global_detected_seizures,241652,241683,31
Jensen_Eisai_groupC,2,6,ts-global_detected_seizures,241672,241697,25
Jensen_Eisai_groupC,1,5,ts-global_detected_seizures,241781,241812,31
Jensen_Eisai_groupC,2,6,ts-global_detected_seizures,242030,242069,39
Jensen_Eisai_groupC,1,5,ts-global_detected_seizures,242091,242122,31
Jensen_Eisai_groupC,2,6,ts-global_detected_seizures,242108,242154,46
Jensen_Eisai_groupC,2,6,ts-global_detected_seizures,242108,242154,46
Jensen_Eisai_groupC,1,5,ts-global_detected_seizures,242123,242838,715
Jensen_Eisai_groupC,2,6,ts-global_detected_seizures,242269,242327,58
Jensen_Eisai_groupC,2,6,ts-global_detected_seizures,242410,242440,30
Jensen_Eisai_groupC,2,6,ts-global_detected_seizures,242538,242561,23
Jensen_Eisai_groupC,2,6,ts-global_detected_seizures,242632,242751,119
Jensen_Eisai_groupC,2,6,ts-global_detected_seizures,242763,242815,52
Jensen_Eisai_groupC,1,5,ts-global_detected_seizures,242839,245723,2884
Jensen_Eisai_groupC,2,6,ts-global_detected_seizures,243168,243200,32
Jensen_Eisai_groupC,2,6,ts-global_detected_seizures,243387,243422,35
Jensen_Eisai_groupC,2,6,ts-global_detected_seizures,243524,243593,69
Jensen_Eisai_groupC,2,6,ts-global_detected_seizures,243711,243738,27
Jensen_Eisai_groupC,2,6,ts-global_detected_seizures,243739,243762,23
Jensen_Eisai_groupC,2,6,ts-global_detected_seizures,243816,243839,23
Jensen_Eisai_groupC,2,6,ts-global_detected_seizures,243921,243963,42
Jensen_Eisai_groupC,2,6,ts-global_detected_seizures,244074,244096,22
Jensen_Eisai_groupC,2,6,ts-global_detected_seizures,244149,244173,24
Jensen_Eisai_groupC,2,6,ts-global_detected_seizures,244208,244270,62
Jensen_Eisai_groupC,2,6,ts-global_detected_seizures,244271,244298,27
Jensen_Eisai_groupC,2,6,ts-global_detected_seizures,244344,244379,35
Jensen_Eisai_groupC,2,6,ts-global_detected_seizures,244549,244685,136
Jensen_Eisai_groupC,2,6,ts-global_detected_seizures,244686,244713,27
Jensen_Eisai_groupC,2,6,ts-global_detected_seizures,244812,244834,22
Jensen_Eisai_groupC,2,6,ts-global_detected_seizures,244848,244871,23
Jensen_Eisai_groupC,2,6,ts-global_detected_seizures,244916,244945,29
Jensen_Eisai_groupC,2,6,ts-global_detected_seizures,244959,244991,32
Jensen_Eisai_groupC,2,6,ts-global_detected_seizures,245150,245179,29
Jensen_Eisai_groupC,2,6,ts-global_detected_seizures,245190,247464,2274
Jensen_Eisai_groupC,1,5,ts-global_detected_seizures,245996,246018,22
Jensen_Eisai_groupC,1,5,ts-global_detected_seizures,246022,246072,50
Jensen_Eisai_groupC,1,5,ts-global_detected_seizures,246073,246170,97
Jensen_Eisai_groupC,1,5,ts-global_detected_seizures,246272,246301,29
Jensen_Eisai_groupC,1,5,ts-global_detected_seizures,246451,246473,22
Jensen_Eisai_groupC,1,5,ts-global_detected_seizures,246941,246970,29
Jensen_Eisai_groupC,1,5,ts-global_detected_seizures,247000,247046,46
Jensen_Eisai_groupC,1,5,ts-global_detected_seizures,247189,247238,49
Jensen_Eisai_groupC,1,5,ts-global_detected_seizures,247456,247520,64
Jensen_Eisai_groupC,1,5,ts-global_detected_seizures,247522,247587,65
Jensen_Eisai_groupC,1,5,ts-global_detected_seizures,247588,247628,40
Jensen_Eisai_groupC,2,6,ts-global_detected_seizures,247599,247623,24
Jensen_Eisai_groupC,1,5,ts-global_detected_seizures,247629,247674,45
Jensen_Eisai_groupC,1,5,ts-global_detected_seizures,247678,247727,49
Jensen_Eisai_groupC,2,6,ts-global_detected_seizures,247686,247731,45
Jensen_Eisai_groupC,2,6,ts-global_detected_seizures,247800,247832,32
Jensen_Eisai_groupC,2,6,ts-global_detected_seizures,247904,247932,28
Jensen_Eisai_groupC,1,5,ts-global_detected_seizures,247912,247934,22
Jensen_Eisai_groupC,2,6,ts-global_detected_seizures,248001,248047,46
Jensen_Eisai_groupC,1,5,ts-global_detected_seizures,248013,248036,23
Jensen_Eisai_groupC,1,5,ts-global_detected_seizures,248057,248146,89
Jensen_Eisai_groupC,2,6,ts-global_detected_seizures,248059,248089,30
Jensen_Eisai_groupC,2,6,ts-global_detected_seizures,248187,248253,66
Jensen_Eisai_groupC,2,6,ts-global_detected_seizures,248262,248288,26
Jensen_Eisai_groupC,1,5,ts-global_detected_seizures,248317,248362,45
Jensen_Eisai_groupC,2,6,ts-global_detected_seizures,248354,248385,31
Jensen_Eisai_groupC,2,6,ts-global_detected_seizures,248439,248502,63
Jensen_Eisai_groupC,1,5,ts-global_detected_seizures,248509,248538,29
Jensen_Eisai_groupC,1,5,ts-global_detected_seizures,248567,248595,28
Jensen_Eisai_groupC,2,6,ts-global_detected_seizures,248579,248604,25
Jensen_Eisai_groupC,2,6,ts-global_detected_seizures,248605,248695,90
Jensen_Eisai_groupC,1,5,ts-global_detected_seizures,248613,248640,27
Jensen_Eisai_groupC,1,5,ts-global_detected_seizures,248646,248670,24
Jensen_Eisai_groupC,1,5,ts-global_detected_seizures,248672,248718,46
Jensen_Eisai_groupC,1,5,ts-global_detected_seizures,248719,248753,34
Jensen_Eisai_groupC,1,5,ts-global_detected_seizures,248784,248814,30
Jensen_Eisai_groupC,1,5,ts-global_detected_seizures,248842,248867,25
Jensen_Eisai_groupC,1,5,ts-global_detected_seizures,248868,248916,48
Jensen_Eisai_groupC,2,6,ts-global_detected_seizures,248974,249005,31
Jensen_Eisai_groupC,1,5,ts-global_detected_seizures,248977,249024,47
Jensen_Eisai_groupC,2,6,ts-global_detected_seizures,249057,249091,34
Jensen_Eisai_groupC,1,5,ts-global_detected_seizures,249094,249119,25
Jensen_Eisai_groupC,1,5,ts-global_detected_seizures,249160,249299,139
Jensen_Eisai_groupC,2,6,ts-global_detected_seizures,249215,249244,29
Jensen_Eisai_groupC,2,6,ts-global_detected_seizures,249274,249413,139
Jensen_Eisai_groupC,1,5,ts-global_detected_seizures,249341,249365,24
Jensen_Eisai_groupC,1,5,ts-global_detected_seizures,249384,249546,162
Jensen_Eisai_groupC,1,5,ts-global_detected_seizures,249603,249627,24
Jensen_Eisai_groupC,2,6,ts-global_detected_seizures,249646,249675,29
Jensen_Eisai_groupC,2,6,ts-global_detected_seizures,249712,249737,25
Jensen_Eisai_groupC,1,5,ts-global_detected_seizures,249726,249748,22
Jensen_Eisai_groupC,1,5,ts-global_detected_seizures,249787,249811,24
Jensen_Eisai_groupC,2,6,ts-global_detected_seizures,249789,249816,27
Jensen_Eisai_groupC,1,5,ts-global_detected_seizures,249825,249868,43
Jensen_Eisai_groupC,2,6,ts-global_detected_seizures,249837,249873,36
Jensen_Eisai_groupC,1,5,ts-global_detected_seizures,249869,249903,34
Jensen_Eisai_groupC,1,5,ts-global_detected_seizures,249912,249944,32
Jensen_Eisai_groupC,2,6,ts-global_detected_seizures,249935,249960,25
Jensen_Eisai_groupC,1,5,ts-global_detected_seizures,249982,250059,77
Jensen_Eisai_groupC,1,5,ts-global_detected_seizures,250064,250090,26
Jensen_Eisai_groupC,2,6,ts-global_detected_seizures,250130,250289,159
Jensen_Eisai_groupC,1,5,ts-global_detected_seizures,250256,250299,43
Jensen_Eisai_groupC,1,5,ts-global_detected_seizures,250306,250338,32
Jensen_Eisai_groupC,1,5,ts-global_detected_seizures,250379,250408,29
Jensen_Eisai_groupC,1,5,ts-global_detected_seizures,250413,250450,37
Jensen_Eisai_groupC,1,5,ts-global_detected_seizures,250474,250507,33
Jensen_Eisai_groupC,2,6,ts-global_detected_seizures,250520,250545,25
Jensen_Eisai_groupC,1,5,ts-global_detected_seizures,250581,250623,42
Jensen_Eisai_groupC,2,6,ts-global_detected_seizures,250589,250620,31
Jensen_Eisai_groupC,1,5,ts-global_detected_seizures,250652,250865,213
Jensen_Eisai_groupC,2,6,ts-global_detected_seizures,250760,250783,23
Jensen_Eisai_groupC,2,6,ts-global_detected_seizures,250836,250873,37
Jensen_Eisai_groupC,1,5,ts-global_detected_seizures,250866,251613,747
Jensen_Eisai_groupC,2,6,ts-global_detected_seizures,250953,250975,22
Jensen_Eisai_groupC,2,6,ts-global_detected_seizures,250984,251012,28
Jensen_Eisai_groupC,2,6,ts-global_detected_seizures,251048,251074,26
Jensen_Eisai_groupC,2,6,ts-global_detected_seizures,251265,251291,26
Jensen_Eisai_groupC,2,6,ts-global_detected_seizures,251292,251358,66
Jensen_Eisai_groupC,2,6,ts-global_detected_seizures,251360,251384,24
Jensen_Eisai_groupC,2,6,ts-global_detected_seizures,251433,251455,22
Jensen_Eisai_groupC,1,5,ts-global_detected_seizures,251614,251970,356
Jensen_Eisai_groupC,2,6,ts-global_detected_seizures,251636,251659,23
Jensen_Eisai_groupC,2,6,ts-global_detected_seizures,251733,251768,35
Jensen_Eisai_groupC,2,6,ts-global_detected_seizures,251876,251917,41
Jensen_Eisai_groupC,2,6,ts-global_detected_seizures,251943,251987,44
Jensen_Eisai_groupC,1,5,ts-global_detected_seizures,251978,252000,22
Jensen_Eisai_groupC,2,6,ts-global_detected_seizures,251988,252060,72
Jensen_Eisai_groupC,1,5,ts-global_detected_seizures,252001,252086,85
Jensen_Eisai_groupC,2,6,ts-global_detected_seizures,252078,252102,24
Jensen_Eisai_groupC,1,5,ts-global_detected_seizures,252087,252150,63
Jensen_Eisai_groupC,1,5,ts-global_detected_seizures,252159,252207,48
Jensen_Eisai_groupC,2,6,ts-global_detected_seizures,252210,252233,23
Jensen_Eisai_groupC,1,5,ts-global_detected_seizures,252211,252240,29
Jensen_Eisai_groupC,1,5,ts-global_detected_seizures,252313,252344,31
Jensen_Eisai_groupC,1,5,ts-global_detected_seizures,252402,252436,34
Jensen_Eisai_groupC,1,5,ts-global_detected_seizures,252451,252511,60
Jensen_Eisai_groupC,1,5,ts-global_detected_seizures,252522,252545,23
Jensen_Eisai_groupC,2,6,ts-global_detected_seizures,252523,252553,30
Jensen_Eisai_groupC,1,5,ts-global_detected_seizures,252546,252644,98
Jensen_Eisai_groupC,2,6,ts-global_detected_seizures,252613,252638,25
Jensen_Eisai_groupC,1,5,ts-global_detected_seizures,252645,252705,60
Jensen_Eisai_groupC,2,6,ts-global_detected_seizures,252669,252993,324
Jensen_Eisai_groupC,1,5,ts-global_detected_seizures,252707,252738,31
Jensen_Eisai_groupC,1,5,ts-global_detected_seizures,252739,252761,22
Jensen_Eisai_groupC,1,5,ts-global_detected_seizures,252811,252836,25
Jensen_Eisai_groupC,1,5,ts-global_detected_seizures,252883,252940,57
Jensen_Eisai_groupC,1,5,ts-global_detected_seizures,252979,253002,23
Jensen_Eisai_groupC,1,5,ts-global_detected_seizures,253031,253124,93
Jensen_Eisai_groupC,2,6,ts-global_detected_seizures,253055,253082,27
Jensen_Eisai_groupC,2,6,ts-global_detected_seizures,253085,253114,29
Jensen_Eisai_groupC,1,5,ts-global_detected_seizures,253125,253187,62
Jensen_Eisai_groupC,2,6,ts-global_detected_seizures,253131,253155,24
Jensen_Eisai_groupC,1,5,ts-global_detected_seizures,253215,253255,40
Jensen_Eisai_groupC,2,6,ts-global_detected_seizures,253224,253247,23
Jensen_Eisai_groupC,1,5,ts-global_detected_seizures,253272,253311,39
Jensen_Eisai_groupC,1,5,ts-global_detected_seizures,253350,253403,53
Jensen_Eisai_groupC,2,6,ts-global_detected_seizures,253390,253422,32
Jensen_Eisai_groupC,1,5,ts-global_detected_seizures,253407,253447,40
Jensen_Eisai_groupC,2,6,ts-global_detected_seizures,253456,253541,85
Jensen_Eisai_groupC,1,5,ts-global_detected_seizures,253473,253508,35
Jensen_Eisai_groupC,1,5,ts-global_detected_seizures,253530,253571,41
Jensen_Eisai_groupC,2,6,ts-global_detected_seizures,253542,253597,55
Jensen_Eisai_groupC,1,5,ts-global_detected_seizures,253580,253611,31
Jensen_Eisai_groupC,2,6,ts-global_detected_seizures,253598,254535,937
Jensen_Eisai_groupC,1,5,ts-global_detected_seizures,253666,253776,110
Jensen_Eisai_groupC,1,5,ts-global_detected_seizures,253777,253859,82
Jensen_Eisai_groupC,1,5,ts-global_detected_seizures,253915,256429,2514
Jensen_Eisai_groupC,2,6,ts-global_detected_seizures,254823,254849,26
Jensen_Eisai_groupC,2,6,ts-global_detected_seizures,254858,254888,30
Jensen_Eisai_groupC,2,6,ts-global_detected_seizures,254946,259030,4084
Jensen_Eisai_groupC,1,5,ts-global_detected_seizures,256430,257883,1453
Jensen_Eisai_groupC,1,5,ts-global_detected_seizures,257884,258245,361
Jensen_Eisai_groupC,1,5,ts-global_detected_seizures,258246,258958,712
Jensen_Eisai_groupC,1,5,ts-global_detected_seizures,258959,259030,71
Jensen_Eisai_groupC,2,6,ts-global_detected_seizures,259741,259947,206
Jensen_Eisai_groupC,2,6,ts-global_detected_seizures,259948,259991,43
Jensen_Eisai_groupC,2,6,ts-global_detected_seizures,259992,260019,27
Jensen_Eisai_groupC,2,6,ts-global_detected_seizures,260042,260072,30
Jensen_Eisai_groupC,1,5,ts-global_detected_seizures,260062,260139,77
Jensen_Eisai_groupC,1,5,ts-global_detected_seizures,260140,260164,24
Jensen_Eisai_groupC,2,6,ts-global_detected_seizures,260162,260185,23
Jensen_Eisai_groupC,1,5,ts-global_detected_seizures,260165,260229,64
Jensen_Eisai_groupC,1,5,ts-global_detected_seizures,260230,260315,85
Jensen_Eisai_groupC,2,6,ts-global_detected_seizures,260292,260317,25
Jensen_Eisai_groupC,1,5,ts-global_detected_seizures,260316,260378,62
Jensen_Eisai_groupC,2,6,ts-global_detected_seizures,260318,260361,43
Jensen_Eisai_groupC,1,5,ts-global_detected_seizures,260379,260490,111
Jensen_Eisai_groupC,2,6,ts-global_detected_seizures,260409,260431,22
Jensen_Eisai_groupC,2,6,ts-global_detected_seizures,260444,260469,25
Jensen_Eisai_groupC,1,5,ts-global_detected_seizures,260536,260611,75
Jensen_Eisai_groupC,1,5,ts-global_detected_seizures,260633,260668,35
Jensen_Eisai_groupC,1,5,ts-global_detected_seizures,260697,260744,47
Jensen_Eisai_groupC,1,5,ts-global_detected_seizures,260745,260774,29
Jensen_Eisai_groupC,1,5,ts-global_detected_seizures,260835,260859,24
Jensen_Eisai_groupC,2,6,ts-global_detected_seizures,260860,260882,22
Jensen_Eisai_groupC,2,6,ts-global_detected_seizures,260908,260930,22
Jensen_Eisai_groupC,1,5,ts-global_detected_seizures,260943,261000,57
Jensen_Eisai_groupC,2,6,ts-global_detected_seizures,260997,261020,23
Jensen_Eisai_groupC,1,5,ts-global_detected_seizures,261043,261084,41
Jensen_Eisai_groupC,2,6,ts-global_detected_seizures,261083,261117,34
Jensen_Eisai_groupC,1,5,ts-global_detected_seizures,261085,261126,41
Jensen_Eisai_groupC,1,5,ts-global_detected_seizures,261135,261165,30
Jensen_Eisai_groupC,2,6,ts-global_detected_seizures,261147,261171,24
Jensen_Eisai_groupC,1,5,ts-global_detected_seizures,261174,261238,64
Jensen_Eisai_groupC,2,6,ts-global_detected_seizures,261252,261277,25
Jensen_Eisai_groupC,1,5,ts-global_detected_seizures,261295,261353,58
Jensen_Eisai_groupC,1,5,ts-global_detected_seizures,261444,261489,45
Jensen_Eisai_groupC,1,5,ts-global_detected_seizures,261490,261525,35
Jensen_Eisai_groupC,1,5,ts-global_detected_seizures,261542,261589,47
Jensen_Eisai_groupC,2,6,ts-global_detected_seizures,261573,261600,27
Jensen_Eisai_groupC,1,5,ts-global_detected_seizures,261590,261619,29
Jensen_Eisai_groupC,1,5,ts-global_detected_seizures,261620,261723,103
Jensen_Eisai_groupC,1,5,ts-global_detected_seizures,261724,261754,30
Jensen_Eisai_groupC,1,5,ts-global_detected_seizures,261755,261808,53
Jensen_Eisai_groupC,1,5,ts-global_detected_seizures,261810,261862,52
Jensen_Eisai_groupC,1,5,ts-global_detected_seizures,261869,261891,22
Jensen_Eisai_groupC,1,5,ts-global_detected_seizures,261892,261928,36
Jensen_Eisai_groupC,1,5,ts-global_detected_seizures,261942,261992,50
Jensen_Eisai_groupC,1,5,ts-global_detected_seizures,261993,262032,39
Jensen_Eisai_groupC,1,5,ts-global_detected_seizures,262033,262066,33
Jensen_Eisai_groupC,1,5,ts-global_detected_seizures,262067,262152,85
Jensen_Eisai_groupC,2,6,ts-global_detected_seizures,262145,262172,27
Jensen_Eisai_groupC,1,5,ts-global_detected_seizures,262153,262231,78
Jensen_Eisai_groupC,1,5,ts-global_detected_seizures,262309,262335,26
Jensen_Eisai_groupC,1,5,ts-global_detected_seizures,262337,262368,31
Jensen_Eisai_groupC,1,5,ts-global_detected_seizures,262377,262400,23
Jensen_Eisai_groupC,1,5,ts-global_detected_seizures,262429,262549,120
Jensen_Eisai_groupC,1,5,ts-global_detected_seizures,262564,262588,24
Jensen_Eisai_groupC,1,5,ts-global_detected_seizures,262651,262688,37
Jensen_Eisai_groupC,2,6,ts-global_detected_seizures,262683,262706,23
Jensen_Eisai_groupC,1,5,ts-global_detected_seizures,262689,262717,28
Jensen_Eisai_groupC,1,5,ts-global_detected_seizures,262785,262865,80
Jensen_Eisai_groupC,2,6,ts-global_detected_seizures,262799,262829,30
Jensen_Eisai_groupC,1,5,ts-global_detected_seizures,262866,262912,46
Jensen_Eisai_groupC,2,6,ts-global_detected_seizures,262901,262929,28
Jensen_Eisai_groupC,1,5,ts-global_detected_seizures,262927,262970,43
Jensen_Eisai_groupC,1,5,ts-global_detected_seizures,263009,263033,24
Jensen_Eisai_groupC,1,5,ts-global_detected_seizures,263034,263073,39
Jensen_Eisai_groupC,2,6,ts-global_detected_seizures,263058,263083,25
Jensen_Eisai_groupC,1,5,ts-global_detected_seizures,263090,263232,142
Jensen_Eisai_groupC,1,5,ts-global_detected_seizures,263247,263274,27
Jensen_Eisai_groupC,2,6,ts-global_detected_seizures,263295,263320,25
Jensen_Eisai_groupC,1,5,ts-global_detected_seizures,263298,263344,46
Jensen_Eisai_groupC,1,5,ts-global_detected_seizures,263347,263375,28
Jensen_Eisai_groupC,1,5,ts-global_detected_seizures,263396,263423,27
Jensen_Eisai_groupC,1,5,ts-global_detected_seizures,263424,263460,36
Jensen_Eisai_groupC,1,5,ts-global_detected_seizures,263468,263542,74
Jensen_Eisai_groupC,1,5,ts-global_detected_seizures,263548,263607,59
Jensen_Eisai_groupC,1,5,ts-global_detected_seizures,263608,263646,38
Jensen_Eisai_groupC,1,5,ts-global_detected_seizures,263647,263710,63
Jensen_Eisai_groupC,1,5,ts-global_detected_seizures,263732,263947,215
Jensen_Eisai_groupC,2,6,ts-global_detected_seizures,263790,263824,34
Jensen_Eisai_groupC,2,6,ts-global_detected_seizures,263895,263921,26
Jensen_Eisai_groupC,1,5,ts-global_detected_seizures,263965,264022,57
Jensen_Eisai_groupC,2,6,ts-global_detected_seizures,263979,264011,32
Jensen_Eisai_groupC,1,5,ts-global_detected_seizures,264045,264203,158
Jensen_Eisai_groupC,2,6,ts-global_detected_seizures,264058,264087,29
Jensen_Eisai_groupC,2,6,ts-global_detected_seizures,264147,264170,23
Jensen_Eisai_groupC,2,6,ts-global_detected_seizures,264180,264222,42
Jensen_Eisai_groupC,1,5,ts-global_detected_seizures,264204,264337,133
Jensen_Eisai_groupC,2,6,ts-global_detected_seizures,264223,264245,22
Jensen_Eisai_groupC,2,6,ts-global_detected_seizures,264247,264280,33
Jensen_Eisai_groupC,2,6,ts-global_detected_seizures,264300,264325,25
Jensen_Eisai_groupC,1,5,ts-global_detected_seizures,264338,264379,41
Jensen_Eisai_groupC,1,5,ts-global_detected_seizures,264380,264453,73
Jensen_Eisai_groupC,2,6,ts-global_detected_seizures,264447,264476,29
Jensen_Eisai_groupC,1,5,ts-global_detected_seizures,264466,264588,122
Jensen_Eisai_groupC,2,6,ts-global_detected_seizures,264524,264548,24
Jensen_Eisai_groupC,2,6,ts-global_detected_seizures,264562,264590,28
Jensen_Eisai_groupC,2,6,ts-global_detected_seizures,264598,264620,22
Jensen_Eisai_groupC,1,5,ts-global_detected_seizures,264599,264644,45
Jensen_Eisai_groupC,1,5,ts-global_detected_seizures,264645,264682,37
Jensen_Eisai_groupC,1,5,ts-global_detected_seizures,264683,264766,83
Jensen_Eisai_groupC,1,5,ts-global_detected_seizures,264767,264802,35
Jensen_Eisai_groupC,1,5,ts-global_detected_seizures,264820,264908,88
Jensen_Eisai_groupC,2,6,ts-global_detected_seizures,264865,264949,84
Jensen_Eisai_groupC,1,5,ts-global_detected_seizures,264909,264973,64
Jensen_Eisai_groupC,1,5,ts-global_detected_seizures,264975,265187,212
Jensen_Eisai_groupC,2,6,ts-global_detected_seizures,264984,265019,35
Jensen_Eisai_groupC,2,6,ts-global_detected_seizures,265020,265043,23
Jensen_Eisai_groupC,2,6,ts-global_detected_seizures,265050,265093,43
Jensen_Eisai_groupC,2,6,ts-global_detected_seizures,265137,265177,40
Jensen_Eisai_groupC,1,5,ts-global_detected_seizures,265188,265224,36
Jensen_Eisai_groupC,2,6,ts-global_detected_seizures,265210,265248,38
Jensen_Eisai_groupC,1,5,ts-global_detected_seizures,265243,265360,117
Jensen_Eisai_groupC,2,6,ts-global_detected_seizures,265273,265308,35
Jensen_Eisai_groupC,2,6,ts-global_detected_seizures,265313,265343,30
Jensen_Eisai_groupC,2,6,ts-global_detected_seizures,265345,265370,25
Jensen_Eisai_groupC,1,5,ts-global_detected_seizures,265363,265396,33
Jensen_Eisai_groupC,2,6,ts-global_detected_seizures,265381,265403,22
Jensen_Eisai_groupC,1,5,ts-global_detected_seizures,265397,265428,31
Jensen_Eisai_groupC,2,6,ts-global_detected_seizures,265418,265505,87
Jensen_Eisai_groupC,2,6,ts-global_detected_seizures,265506,265532,26
Jensen_Eisai_groupC,2,6,ts-global_detected_seizures,265541,265598,57
Jensen_Eisai_groupC,1,5,ts-global_detected_seizures,265571,265599,28
Jensen_Eisai_groupC,2,6,ts-global_detected_seizures,265609,265651,42
Jensen_Eisai_groupC,2,6,ts-global_detected_seizures,265658,265696,38
Jensen_Eisai_groupC,1,5,ts-global_detected_seizures,265663,265688,25
Jensen_Eisai_groupC,2,6,ts-global_detected_seizures,265774,265801,27
Jensen_Eisai_groupC,2,6,ts-global_detected_seizures,265802,265847,45
Jensen_Eisai_groupC,1,5,ts-global_detected_seizures,265841,265868,27
Jensen_Eisai_groupC,2,6,ts-global_detected_seizures,265852,265913,61
Jensen_Eisai_groupC,2,6,ts-global_detected_seizures,265914,265959,45
Jensen_Eisai_groupC,2,6,ts-global_detected_seizures,266014,266040,26
Jensen_Eisai_groupC,2,6,ts-global_detected_seizures,266092,266124,32
Jensen_Eisai_groupC,1,5,ts-global_detected_seizures,266141,266217,76
Jensen_Eisai_groupC,1,5,ts-global_detected_seizures,266218,266248,30
Jensen_Eisai_groupC,1,5,ts-global_detected_seizures,266250,266277,27
Jensen_Eisai_groupC,2,6,ts-global_detected_seizures,266375,266401,26
Jensen_Eisai_groupC,2,6,ts-global_detected_seizures,266417,266440,23
Jensen_Eisai_groupC,2,6,ts-global_detected_seizures,266441,266472,31
Jensen_Eisai_groupC,1,5,ts-global_detected_seizures,266466,266507,41
Jensen_Eisai_groupC,2,6,ts-global_detected_seizures,266473,266495,22
Jensen_Eisai_groupC,2,6,ts-global_detected_seizures,266526,266571,45
Jensen_Eisai_groupC,1,5,ts-global_detected_seizures,266553,266578,25
Jensen_Eisai_groupC,2,6,ts-global_detected_seizures,266572,266595,23
Jensen_Eisai_groupC,2,6,ts-global_detected_seizures,266609,266757,148
Jensen_Eisai_groupC,1,5,ts-global_detected_seizures,266678,266723,45
Jensen_Eisai_groupC,2,6,ts-global_detected_seizures,266760,266850,90
Jensen_Eisai_groupC,2,6,ts-global_detected_seizures,266851,266879,28
Jensen_Eisai_groupC,2,6,ts-global_detected_seizures,266889,266931,42
Jensen_Eisai_groupC,1,5,ts-global_detected_seizures,266901,266964,63
Jensen_Eisai_groupC,2,6,ts-global_detected_seizures,266932,267084,152
Jensen_Eisai_groupC,1,5,ts-global_detected_seizures,267019,267045,26
Jensen_Eisai_groupC,1,5,ts-global_detected_seizures,267274,267298,24
Jensen_Eisai_groupC,1,5,ts-global_detected_seizures,267309,267368,59
Jensen_Eisai_groupC,2,6,ts-global_detected_seizures,267356,267428,72
Jensen_Eisai_groupC,1,5,ts-global_detected_seizures,267404,267427,23
Jensen_Eisai_groupC,1,5,ts-global_detected_seizures,267548,267618,70
Jensen_Eisai_groupC,1,5,ts-global_detected_seizures,267630,267784,154
Jensen_Eisai_groupC,2,6,ts-global_detected_seizures,267716,267749,33
Jensen_Eisai_groupC,1,5,ts-global_detected_seizures,267809,267953,144
Jensen_Eisai_groupC,2,6,ts-global_detected_seizures,268149,268233,84
Jensen_Eisai_groupC,1,5,ts-global_detected_seizures,268189,268216,27
Jensen_Eisai_groupC,1,5,ts-global_detected_seizures,268255,268359,104
Jensen_Eisai_groupC,2,6,ts-global_detected_seizures,268446,268471,25
Jensen_Eisai_groupC,1,5,ts-global_detected_seizures,268482,268547,65
Jensen_Eisai_groupC,2,6,ts-global_detected_seizures,268511,268542,31
Jensen_Eisai_groupC,1,5,ts-global_detected_seizures,268580,268609,29
Jensen_Eisai_groupC,1,5,ts-global_detected_seizures,268633,268687,54
Jensen_Eisai_groupC,2,6,ts-global_detected_seizures,268751,268779,28
Jensen_Eisai_groupC,1,5,ts-global_detected_seizures,268782,268942,160
Jensen_Eisai_groupC,2,6,ts-global_detected_seizures,268827,268856,29
Jensen_Eisai_groupC,2,6,ts-global_detected_seizures,268941,269012,71
Jensen_Eisai_groupC,1,5,ts-global_detected_seizures,268943,270896,1953
Jensen_Eisai_groupC,2,6,ts-global_detected_seizures,269082,269110,28
Jensen_Eisai_groupC,2,6,ts-global_detected_seizures,269138,269180,42
Jensen_Eisai_groupC,2,6,ts-global_detected_seizures,269307,269341,34
Jensen_Eisai_groupC,2,6,ts-global_detected_seizures,269509,269539,30
Jensen_Eisai_groupC,2,6,ts-global_detected_seizures,269540,269564,24
Jensen_Eisai_groupC,2,6,ts-global_detected_seizures,269618,269646,28
Jensen_Eisai_groupC,2,6,ts-global_detected_seizures,269690,269726,36
Jensen_Eisai_groupC,2,6,ts-global_detected_seizures,269795,269822,27
Jensen_Eisai_groupC,2,6,ts-global_detected_seizures,269858,269892,34
Jensen_Eisai_groupC,2,6,ts-global_detected_seizures,269929,270074,145
Jensen_Eisai_groupC,2,6,ts-global_detected_seizures,270189,270223,34
Jensen_Eisai_groupC,2,6,ts-global_detected_seizures,270235,270259,24
Jensen_Eisai_groupC,2,6,ts-global_detected_seizures,270307,270346,39
Jensen_Eisai_groupC,2,6,ts-global_detected_seizures,270356,270385,29
Jensen_Eisai_groupC,2,6,ts-global_detected_seizures,270399,270428,29
Jensen_Eisai_groupC,2,6,ts-global_detected_seizures,270473,270509,36
Jensen_Eisai_groupC,2,6,ts-global_detected_seizures,270542,270570,28
Jensen_Eisai_groupC,2,6,ts-global_detected_seizures,270582,270608,26
Jensen_Eisai_groupC,2,6,ts-global_detected_seizures,270645,270667,22
Jensen_Eisai_groupC,2,6,ts-global_detected_seizures,270738,270799,61
Jensen_Eisai_groupC,2,6,ts-global_detected_seizures,270849,270879,30
Jensen_Eisai_groupC,2,6,ts-global_detected_seizures,270909,270947,38
Jensen_Eisai_groupC,1,5,ts-global_detected_seizures,270929,270998,69
Jensen_Eisai_groupC,1,5,ts-global_detected_seizures,271157,271181,24
Jensen_Eisai_groupC,2,6,ts-global_detected_seizures,271173,271201,28
Jensen_Eisai_groupC,2,6,ts-global_detected_seizures,271236,271258,22
Jensen_Eisai_groupC,1,5,ts-global_detected_seizures,271258,271280,22
Jensen_Eisai_groupC,2,6,ts-global_detected_seizures,271287,271318,31
Jensen_Eisai_groupC,2,6,ts-global_detected_seizures,271352,271552,200
Jensen_Eisai_groupC,1,5,ts-global_detected_seizures,271363,271393,30
Jensen_Eisai_groupC,1,5,ts-global_detected_seizures,271414,271497,83
Jensen_Eisai_groupC,2,6,ts-global_detected_seizures,271553,271577,24
Jensen_Eisai_groupC,1,5,ts-global_detected_seizures,271586,271690,104
Jensen_Eisai_groupC,2,6,ts-global_detected_seizures,271608,271630,22
Jensen_Eisai_groupC,2,6,ts-global_detected_seizures,271677,271707,30
Jensen_Eisai_groupC,1,5,ts-global_detected_seizures,271698,271808,110
Jensen_Eisai_groupC,2,6,ts-global_detected_seizures,271739,271763,24
Jensen_Eisai_groupC,2,6,ts-global_detected_seizures,271824,271904,80
Jensen_Eisai_groupC,2,6,ts-global_detected_seizures,271924,271997,73
Jensen_Eisai_groupC,2,6,ts-global_detected_seizures,271998,272064,66
Jensen_Eisai_groupC,2,6,ts-global_detected_seizures,272065,272741,676
Jensen_Eisai_groupC,1,5,ts-global_detected_seizures,272096,272120,24
Jensen_Eisai_groupC,1,5,ts-global_detected_seizures,272208,272243,35
Jensen_Eisai_groupC,1,5,ts-global_detected_seizures,272244,272278,34
Jensen_Eisai_groupC,1,5,ts-global_detected_seizures,272304,272364,60
Jensen_Eisai_groupC,1,5,ts-global_detected_seizures,272387,272418,31
Jensen_Eisai_groupC,1,5,ts-global_detected_seizures,272457,272564,107
Jensen_Eisai_groupC,1,5,ts-global_detected_seizures,272592,272627,35
Jensen_Eisai_groupC,1,5,ts-global_detected_seizures,272709,272754,45
Jensen_Eisai_groupC,2,6,ts-global_detected_seizures,272742,272797,55
Jensen_Eisai_groupC,2,6,ts-global_detected_seizures,272798,274078,1280
Jensen_Eisai_groupC,1,5,ts-global_detected_seizures,272875,272923,48
Jensen_Eisai_groupC,1,5,ts-global_detected_seizures,272924,273099,175
Jensen_Eisai_groupC,1,5,ts-global_detected_seizures,273100,273123,23
Jensen_Eisai_groupC,1,5,ts-global_detected_seizures,273124,273156,32
Jensen_Eisai_groupC,1,5,ts-global_detected_seizures,273157,273179,22
Jensen_Eisai_groupC,1,5,ts-global_detected_seizures,273234,273311,77
Jensen_Eisai_groupC,1,5,ts-global_detected_seizures,273325,273368,43
Jensen_Eisai_groupC,1,5,ts-global_detected_seizures,273413,273508,95
Jensen_Eisai_groupC,1,5,ts-global_detected_seizures,273513,273572,59
Jensen_Eisai_groupC,1,5,ts-global_detected_seizures,273634,273662,28
Jensen_Eisai_groupC,1,5,ts-global_detected_seizures,273679,273744,65
Jensen_Eisai_groupC,1,5,ts-global_detected_seizures,273768,273801,33
Jensen_Eisai_groupC,1,5,ts-global_detected_seizures,273868,273938,70
Jensen_Eisai_groupC,1,5,ts-global_detected_seizures,273939,273966,27
Jensen_Eisai_groupC,1,5,ts-global_detected_seizures,273977,274001,24
Jensen_Eisai_groupC,1,5,ts-global_detected_seizures,274007,274044,37
Jensen_Eisai_groupC,1,5,ts-global_detected_seizures,274071,274135,64
Jensen_Eisai_groupC,2,6,ts-global_detected_seizures,274117,274155,38
Jensen_Eisai_groupC,1,5,ts-global_detected_seizures,274144,274204,60
Jensen_Eisai_groupC,1,5,ts-global_detected_seizures,274205,274241,36
Jensen_Eisai_groupC,1,5,ts-global_detected_seizures,274264,274323,59
Jensen_Eisai_groupC,1,5,ts-global_detected_seizures,274324,274680,356
Jensen_Eisai_groupC,2,6,ts-global_detected_seizures,274373,274413,40
Jensen_Eisai_groupC,2,6,ts-global_detected_seizures,274503,274530,27
Jensen_Eisai_groupC,1,5,ts-global_detected_seizures,274681,274707,26
Jensen_Eisai_groupC,1,5,ts-global_detected_seizures,274708,274731,23
Jensen_Eisai_groupC,2,6,ts-global_detected_seizures,274723,274756,33
Jensen_Eisai_groupC,1,5,ts-global_detected_seizures,274732,274755,23
Jensen_Eisai_groupC,1,5,ts-global_detected_seizures,274756,274891,135
Jensen_Eisai_groupC,1,5,ts-global_detected_seizures,274898,274949,51
Jensen_Eisai_groupC,2,6,ts-global_detected_seizures,274929,274953,24
Jensen_Eisai_groupC,1,5,ts-global_detected_seizures,274965,275023,58
Jensen_Eisai_groupC,1,5,ts-global_detected_seizures,275053,275127,74
Jensen_Eisai_groupC,2,6,ts-global_detected_seizures,275098,275138,40
Jensen_Eisai_groupC,1,5,ts-global_detected_seizures,275129,275162,33
Jensen_Eisai_groupC,1,5,ts-global_detected_seizures,275237,275285,48
Jensen_Eisai_groupC,2,6,ts-global_detected_seizures,275248,275282,34
Jensen_Eisai_groupC,2,6,ts-global_detected_seizures,275328,275357,29
Jensen_Eisai_groupC,1,5,ts-global_detected_seizures,275380,275417,37
Jensen_Eisai_groupC,1,5,ts-global_detected_seizures,275439,275486,47
Jensen_Eisai_groupC,2,6,ts-global_detected_seizures,275459,275541,82
Jensen_Eisai_groupC,1,5,ts-global_detected_seizures,275492,275563,71
Jensen_Eisai_groupC,1,5,ts-global_detected_seizures,275564,275617,53
Jensen_Eisai_groupC,1,5,ts-global_detected_seizures,275619,275664,45
Jensen_Eisai_groupC,1,5,ts-global_detected_seizures,275679,275721,42
Jensen_Eisai_groupC,2,6,ts-global_detected_seizures,275680,275717,37
Jensen_Eisai_groupC,2,6,ts-global_detected_seizures,275739,275762,23
Jensen_Eisai_groupC,1,5,ts-global_detected_seizures,275758,275876,118
Jensen_Eisai_groupC,2,6,ts-global_detected_seizures,275855,275877,22
Jensen_Eisai_groupC,1,5,ts-global_detected_seizures,275877,275908,31
Jensen_Eisai_groupC,2,6,ts-global_detected_seizures,275921,275944,23
Jensen_Eisai_groupC,1,5,ts-global_detected_seizures,275952,275985,33
Jensen_Eisai_groupC,2,6,ts-global_detected_seizures,276029,276055,26
Jensen_Eisai_groupC,1,5,ts-global_detected_seizures,276036,276077,41
Jensen_Eisai_groupC,1,5,ts-global_detected_seizures,276096,276124,28
Jensen_Eisai_groupC,2,6,ts-global_detected_seizures,276172,276198,26
Jensen_Eisai_groupC,1,5,ts-global_detected_seizures,276187,276250,63
Jensen_Eisai_groupC,2,6,ts-global_detected_seizures,276272,276328,56
Jensen_Eisai_groupC,1,5,ts-global_detected_seizures,276276,276301,25
Jensen_Eisai_groupC,1,5,ts-global_detected_seizures,276337,276395,58
Jensen_Eisai_groupC,1,5,ts-global_detected_seizures,276398,276467,69
Jensen_Eisai_groupC,1,5,ts-global_detected_seizures,276469,276493,24
Jensen_Eisai_groupC,1,5,ts-global_detected_seizures,276514,276571,57
Jensen_Eisai_groupC,2,6,ts-global_detected_seizures,276589,276620,31
Jensen_Eisai_groupC,1,5,ts-global_detected_seizures,276619,276644,25
Jensen_Eisai_groupC,1,5,ts-global_detected_seizures,276645,276669,24
Jensen_Eisai_groupC,2,6,ts-global_detected_seizures,276656,276686,30
Jensen_Eisai_groupC,1,5,ts-global_detected_seizures,276692,276777,85
Jensen_Eisai_groupC,2,6,ts-global_detected_seizures,276735,276793,58
Jensen_Eisai_groupC,1,5,ts-global_detected_seizures,276782,276809,27
Jensen_Eisai_groupC,1,5,ts-global_detected_seizures,276888,276940,52
Jensen_Eisai_groupC,2,6,ts-global_detected_seizures,276915,276952,37
Jensen_Eisai_groupC,1,5,ts-global_detected_seizures,276960,277053,93
Jensen_Eisai_groupC,1,5,ts-global_detected_seizures,277121,278711,1590
Jensen_Eisai_groupC,2,6,ts-global_detected_seizures,277253,277283,30
Jensen_Eisai_groupC,2,6,ts-global_detected_seizures,277304,277340,36
Jensen_Eisai_groupC,2,6,ts-global_detected_seizures,277485,277512,27
Jensen_Eisai_groupC,2,6,ts-global_detected_seizures,277523,277550,27
Jensen_Eisai_groupC,2,6,ts-global_detected_seizures,277650,277799,149
Jensen_Eisai_groupC,2,6,ts-global_detected_seizures,277821,277851,30
Jensen_Eisai_groupC,2,6,ts-global_detected_seizures,277867,277890,23
Jensen_Eisai_groupC,2,6,ts-global_detected_seizures,277914,277941,27
Jensen_Eisai_groupC,2,6,ts-global_detected_seizures,277988,278010,22
Jensen_Eisai_groupC,2,6,ts-global_detected_seizures,278246,278289,43
Jensen_Eisai_groupC,2,6,ts-global_detected_seizures,278344,278370,26
Jensen_Eisai_groupC,2,6,ts-global_detected_seizures,278449,278475,26
Jensen_Eisai_groupC,2,6,ts-global_detected_seizures,278537,278579,42
Jensen_Eisai_groupC,2,6,ts-global_detected_seizures,278580,278633,53
Jensen_Eisai_groupC,2,6,ts-global_detected_seizures,278711,278846,135
Jensen_Eisai_groupC,1,5,ts-global_detected_seizures,278712,278904,192
Jensen_Eisai_groupC,2,6,ts-global_detected_seizures,278847,278880,33
Jensen_Eisai_groupC,1,5,ts-global_detected_seizures,278905,279303,398
Jensen_Eisai_groupC,2,6,ts-global_detected_seizures,278937,278972,35
Jensen_Eisai_groupC,2,6,ts-global_detected_seizures,279028,279054,26
Jensen_Eisai_groupC,2,6,ts-global_detected_seizures,279106,279142,36
Jensen_Eisai_groupC,2,6,ts-global_detected_seizures,279182,279210,28
Jensen_Eisai_groupC,2,6,ts-global_detected_seizures,279242,279264,22
Jensen_Eisai_groupC,2,6,ts-global_detected_seizures,279287,279364,77
Jensen_Eisai_groupC,1,5,ts-global_detected_seizures,279304,279454,150
Jensen_Eisai_groupC,2,6,ts-global_detected_seizures,279367,279474,107
Jensen_Eisai_groupC,2,6,ts-global_detected_seizures,279475,279509,34
Jensen_Eisai_groupC,1,5,ts-global_detected_seizures,279477,279543,66
Jensen_Eisai_groupC,2,6,ts-global_detected_seizures,279522,279560,38
Jensen_Eisai_groupC,1,5,ts-global_detected_seizures,279544,279567,23
Jensen_Eisai_groupC,1,5,ts-global_detected_seizures,279607,279631,24
Jensen_Eisai_groupC,2,6,ts-global_detected_seizures,279706,279733,27
Jensen_Eisai_groupC,2,6,ts-global_detected_seizures,279769,279794,25
Jensen_Eisai_groupC,2,6,ts-global_detected_seizures,279810,279839,29
Jensen_Eisai_groupC,1,5,ts-global_detected_seizures,279851,279888,37
Jensen_Eisai_groupC,2,6,ts-global_detected_seizures,279865,279889,24
Jensen_Eisai_groupC,1,5,ts-global_detected_seizures,279949,279983,34
Jensen_Eisai_groupC,2,6,ts-global_detected_seizures,279963,279996,33
Jensen_Eisai_groupC,1,5,ts-global_detected_seizures,280036,280083,47
Jensen_Eisai_groupC,2,6,ts-global_detected_seizures,280039,280091,52
Jensen_Eisai_groupC,1,5,ts-global_detected_seizures,280139,280167,28
Jensen_Eisai_groupC,2,6,ts-global_detected_seizures,280149,280199,50
Jensen_Eisai_groupC,1,5,ts-global_detected_seizures,280202,280230,28
Jensen_Eisai_groupC,2,6,ts-global_detected_seizures,280221,280252,31
Jensen_Eisai_groupC,1,5,ts-global_detected_seizures,280231,280254,23
Jensen_Eisai_groupC,2,6,ts-global_detected_seizures,280271,280299,28
Jensen_Eisai_groupC,2,6,ts-global_detected_seizures,280323,280354,31
Jensen_Eisai_groupC,1,5,ts-global_detected_seizures,280325,280394,69
Jensen_Eisai_groupC,2,6,ts-global_detected_seizures,280377,280479,102
Jensen_Eisai_groupC,1,5,ts-global_detected_seizures,280407,280440,33
Jensen_Eisai_groupC,1,5,ts-global_detected_seizures,280465,280497,32
Jensen_Eisai_groupC,2,6,ts-global_detected_seizures,280480,280561,81
Jensen_Eisai_groupC,2,6,ts-global_detected_seizures,280563,280619,56
Jensen_Eisai_groupC,1,5,ts-global_detected_seizures,280569,280624,55
Jensen_Eisai_groupC,2,6,ts-global_detected_seizures,280717,280779,62
Jensen_Eisai_groupC,1,5,ts-global_detected_seizures,280742,280795,53
Jensen_Eisai_groupC,2,6,ts-global_detected_seizures,280795,280827,32
Jensen_Eisai_groupC,1,5,ts-global_detected_seizures,280806,280886,80
Jensen_Eisai_groupC,2,6,ts-global_detected_seizures,280852,280874,22
Jensen_Eisai_groupC,2,6,ts-global_detected_seizures,280879,280901,22
Jensen_Eisai_groupC,1,5,ts-global_detected_seizures,280898,280920,22
Jensen_Eisai_groupC,1,5,ts-global_detected_seizures,280940,280979,39
Jensen_Eisai_groupC,1,5,ts-global_detected_seizures,280985,281023,38
Jensen_Eisai_groupC,1,5,ts-global_detected_seizures,281056,281085,29
Jensen_Eisai_groupC,2,6,ts-global_detected_seizures,281057,281080,23
Jensen_Eisai_groupC,1,5,ts-global_detected_seizures,281098,281130,32
Jensen_Eisai_groupC,2,6,ts-global_detected_seizures,281135,281183,48
Jensen_Eisai_groupC,1,5,ts-global_detected_seizures,281167,281213,46
Jensen_Eisai_groupC,2,6,ts-global_detected_seizures,281218,281250,32
Jensen_Eisai_groupC,1,5,ts-global_detected_seizures,281229,281344,115
Jensen_Eisai_groupC,2,6,ts-global_detected_seizures,281299,281343,44
Jensen_Eisai_groupC,2,6,ts-global_detected_seizures,281409,281440,31
Jensen_Eisai_groupC,1,5,ts-global_detected_seizures,281426,281465,39
Jensen_Eisai_groupC,1,5,ts-global_detected_seizures,281468,281511,43
Jensen_Eisai_groupC,2,6,ts-global_detected_seizures,281484,281519,35
Jensen_Eisai_groupC,1,5,ts-global_detected_seizures,281572,281621,49
Jensen_Eisai_groupC,2,6,ts-global_detected_seizures,281606,281634,28
Jensen_Eisai_groupC,1,5,ts-global_detected_seizures,281649,281711,62
Jensen_Eisai_groupC,2,6,ts-global_detected_seizures,281684,281711,27
Jensen_Eisai_groupC,1,5,ts-global_detected_seizures,281714,281763,49
Jensen_Eisai_groupC,2,6,ts-global_detected_seizures,281770,281896,126
Jensen_Eisai_groupC,1,5,ts-global_detected_seizures,281813,281944,131
Jensen_Eisai_groupC,2,6,ts-global_detected_seizures,281897,281919,22
Jensen_Eisai_groupC,2,6,ts-global_detected_seizures,281932,281959,27
Jensen_Eisai_groupC,1,5,ts-global_detected_seizures,281945,282151,206
Jensen_Eisai_groupC,2,6,ts-global_detected_seizures,281985,282010,25
Jensen_Eisai_groupC,2,6,ts-global_detected_seizures,282011,282061,50
Jensen_Eisai_groupC,2,6,ts-global_detected_seizures,282111,282139,28
Jensen_Eisai_groupC,1,5,ts-global_detected_seizures,282159,282188,29
Jensen_Eisai_groupC,2,6,ts-global_detected_seizures,282167,282191,24
Jensen_Eisai_groupC,1,5,ts-global_detected_seizures,282189,282234,45
Jensen_Eisai_groupC,2,6,ts-global_detected_seizures,282216,282251,35
Jensen_Eisai_groupC,1,5,ts-global_detected_seizures,282235,282273,38
Jensen_Eisai_groupC,2,6,ts-global_detected_seizures,282292,282321,29
Jensen_Eisai_groupC,1,5,ts-global_detected_seizures,282303,282326,23
Jensen_Eisai_groupC,1,5,ts-global_detected_seizures,282334,282430,96
Jensen_Eisai_groupC,2,6,ts-global_detected_seizures,282422,282458,36
Jensen_Eisai_groupC,1,5,ts-global_detected_seizures,282445,282485,40
Jensen_Eisai_groupC,1,5,ts-global_detected_seizures,282492,282514,22
Jensen_Eisai_groupC,2,6,ts-global_detected_seizures,282514,282542,28
Jensen_Eisai_groupC,1,5,ts-global_detected_seizures,282530,282584,54
Jensen_Eisai_groupC,1,5,ts-global_detected_seizures,282585,282653,68
Jensen_Eisai_groupC,2,6,ts-global_detected_seizures,282602,282646,44
Jensen_Eisai_groupC,2,6,ts-global_detected_seizures,282745,282772,27
Jensen_Eisai_groupC,1,5,ts-global_detected_seizures,282751,282778,27
Jensen_Eisai_groupC,2,6,ts-global_detected_seizures,282803,283097,294
Jensen_Eisai_groupC,1,5,ts-global_detected_seizures,282818,282840,22
Jensen_Eisai_groupC,1,5,ts-global_detected_seizures,282842,282877,35
Jensen_Eisai_groupC,1,5,ts-global_detected_seizures,282904,282932,28
Jensen_Eisai_groupC,1,5,ts-global_detected_seizures,282947,282972,25
Jensen_Eisai_groupC,1,5,ts-global_detected_seizures,282999,283026,27
Jensen_Eisai_groupC,1,5,ts-global_detected_seizures,283063,283120,57
Jensen_Eisai_groupC,2,6,ts-global_detected_seizures,283120,283783,663
Jensen_Eisai_groupC,1,5,ts-global_detected_seizures,283149,283211,62
Jensen_Eisai_groupC,1,5,ts-global_detected_seizures,283239,283279,40
Jensen_Eisai_groupC,1,5,ts-global_detected_seizures,283297,283340,43
Jensen_Eisai_groupC,1,5,ts-global_detected_seizures,283342,283375,33
Jensen_Eisai_groupC,1,5,ts-global_detected_seizures,283385,283446,61
Jensen_Eisai_groupC,1,5,ts-global_detected_seizures,283508,283623,115
Jensen_Eisai_groupC,1,5,ts-global_detected_seizures,283653,283717,64
Jensen_Eisai_groupC,1,5,ts-global_detected_seizures,283729,283789,60
Jensen_Eisai_groupC,1,5,ts-global_detected_seizures,283792,283971,179
Jensen_Eisai_groupC,2,6,ts-global_detected_seizures,283842,284201,359
Jensen_Eisai_groupC,1,5,ts-global_detected_seizures,283985,284018,33
Jensen_Eisai_groupC,1,5,ts-global_detected_seizures,284035,284064,29
Jensen_Eisai_groupC,1,5,ts-global_detected_seizures,284085,284119,34
Jensen_Eisai_groupC,1,5,ts-global_detected_seizures,284120,284178,58
Jensen_Eisai_groupC,2,6,ts-global_detected_seizures,284215,284246,31
Jensen_Eisai_groupC,1,5,ts-global_detected_seizures,284257,284312,55
Jensen_Eisai_groupC,2,6,ts-global_detected_seizures,284261,284294,33
Jensen_Eisai_groupC,1,5,ts-global_detected_seizures,284326,284370,44
Jensen_Eisai_groupC,1,5,ts-global_detected_seizures,284405,284489,84
Jensen_Eisai_groupC,2,6,ts-global_detected_seizures,284445,284478,33
Jensen_Eisai_groupC,1,5,ts-global_detected_seizures,284516,284559,43
Jensen_Eisai_groupC,2,6,ts-global_detected_seizures,284554,284579,25
Jensen_Eisai_groupC,1,5,ts-global_detected_seizures,284567,284652,85
Jensen_Eisai_groupC,2,6,ts-global_detected_seizures,284618,284657,39
Jensen_Eisai_groupC,1,5,ts-global_detected_seizures,284658,284728,70
Jensen_Eisai_groupC,2,6,ts-global_detected_seizures,284750,284779,29
Jensen_Eisai_groupC,1,5,ts-global_detected_seizures,284751,284967,216
Jensen_Eisai_groupC,2,6,ts-global_detected_seizures,284950,285002,52
Jensen_Eisai_groupC,1,5,ts-global_detected_seizures,284968,285049,81
Jensen_Eisai_groupC,2,6,ts-global_detected_seizures,285057,285106,49
Jensen_Eisai_groupC,1,5,ts-global_detected_seizures,285068,285112,44
Jensen_Eisai_groupC,2,6,ts-global_detected_seizures,285109,285133,24
Jensen_Eisai_groupC,1,5,ts-global_detected_seizures,285114,285138,24
Jensen_Eisai_groupC,1,5,ts-global_detected_seizures,285183,285310,127
Jensen_Eisai_groupC,2,6,ts-global_detected_seizures,285225,285250,25
Jensen_Eisai_groupC,2,6,ts-global_detected_seizures,285297,285325,28
Jensen_Eisai_groupC,1,5,ts-global_detected_seizures,285311,286978,1667
Jensen_Eisai_groupC,2,6,ts-global_detected_seizures,285354,285377,23
Jensen_Eisai_groupC,2,6,ts-global_detected_seizures,285411,285434,23
Jensen_Eisai_groupC,2,6,ts-global_detected_seizures,285441,285470,29
Jensen_Eisai_groupC,2,6,ts-global_detected_seizures,285489,285676,187
Jensen_Eisai_groupC,2,6,ts-global_detected_seizures,285708,285737,29
Jensen_Eisai_groupC,2,6,ts-global_detected_seizures,285776,285805,29
Jensen_Eisai_groupC,2,6,ts-global_detected_seizures,285957,286053,96
Jensen_Eisai_groupC,2,6,ts-global_detected_seizures,286077,286119,42
Jensen_Eisai_groupC,2,6,ts-global_detected_seizures,286165,286221,56
Jensen_Eisai_groupC,2,6,ts-global_detected_seizures,286249,286276,27
Jensen_Eisai_groupC,2,6,ts-global_detected_seizures,286278,286310,32
Jensen_Eisai_groupC,2,6,ts-global_detected_seizures,286318,286364,46
Jensen_Eisai_groupC,2,6,ts-global_detected_seizures,286451,286502,51
Jensen_Eisai_groupC,2,6,ts-global_detected_seizures,286505,286532,27
Jensen_Eisai_groupC,2,6,ts-global_detected_seizures,286560,286600,40
Jensen_Eisai_groupC,2,6,ts-global_detected_seizures,286685,286721,36
Jensen_Eisai_groupC,2,6,ts-global_detected_seizures,286818,286845,27
Jensen_Eisai_groupC,2,6,ts-global_detected_seizures,286916,286954,38
Jensen_Eisai_groupC,2,6,ts-global_detected_seizures,286963,287002,39
Jensen_Eisai_groupC,1,5,ts-global_detected_seizures,286979,287131,152
Jensen_Eisai_groupC,2,6,ts-global_detected_seizures,287016,287049,33
Jensen_Eisai_groupC,1,5,ts-global_detected_seizures,287132,288031,899
Jensen_Eisai_groupC,2,6,ts-global_detected_seizures,287137,287162,25
Jensen_Eisai_groupC,2,6,ts-global_detected_seizures,287204,287371,167
Jensen_Eisai_groupC,2,6,ts-global_detected_seizures,287372,288634,1262
Jensen_Eisai_groupC,1,5,ts-global_detected_seizures,288039,288077,38
Jensen_Eisai_groupC,1,5,ts-global_detected_seizures,288127,288169,42
Jensen_Eisai_groupC,1,5,ts-global_detected_seizures,288262,288284,22
Jensen_Eisai_groupC,1,5,ts-global_detected_seizures,288307,288346,39
Jensen_Eisai_groupC,1,5,ts-global_detected_seizures,288371,288421,50
Jensen_Eisai_groupC,1,5,ts-global_detected_seizures,288463,288494,31
Jensen_Eisai_groupC,1,5,ts-global_detected_seizures,288563,288593,30
Jensen_Eisai_groupC,1,5,ts-global_detected_seizures,288640,288694,54
Jensen_Eisai_groupC,1,5,ts-global_detected_seizures,288711,288756,45
Jensen_Eisai_groupC,1,5,ts-global_detected_seizures,288757,289058,301
Jensen_Eisai_groupC,2,6,ts-global_detected_seizures,288759,288810,51
Jensen_Eisai_groupC,2,6,ts-global_detected_seizures,288833,288889,56
Jensen_Eisai_groupC,2,6,ts-global_detected_seizures,288911,288934,23
Jensen_Eisai_groupC,2,6,ts-global_detected_seizures,288945,288969,24
Jensen_Eisai_groupC,1,5,ts-global_detected_seizures,289070,289132,62
Jensen_Eisai_groupC,2,6,ts-global_detected_seizures,289126,289152,26
Jensen_Eisai_groupC,1,5,ts-global_detected_seizures,289136,289166,30
Jensen_Eisai_groupC,1,5,ts-global_detected_seizures,289226,289256,30
Jensen_Eisai_groupC,1,5,ts-global_detected_seizures,289258,289296,38
Jensen_Eisai_groupC,1,5,ts-global_detected_seizures,289309,289351,42
Jensen_Eisai_groupC,2,6,ts-global_detected_seizures,289365,289414,49
Jensen_Eisai_groupC,1,5,ts-global_detected_seizures,289452,289490,38
Jensen_Eisai_groupC,1,5,ts-global_detected_seizures,289586,289649,63
Jensen_Eisai_groupC,1,5,ts-global_detected_seizures,289654,289697,43
Jensen_Eisai_groupC,2,6,ts-global_detected_seizures,289687,289715,28
Jensen_Eisai_groupC,1,5,ts-global_detected_seizures,289720,289753,33
Jensen_Eisai_groupC,1,5,ts-global_detected_seizures,289764,289792,28
Jensen_Eisai_groupC,2,6,ts-global_detected_seizures,289831,289868,37
Jensen_Eisai_groupC,1,5,ts-global_detected_seizures,289895,289924,29
Jensen_Eisai_groupC,2,6,ts-global_detected_seizures,289914,290071,157
Jensen_Eisai_groupC,1,5,ts-global_detected_seizures,289925,290106,181
Jensen_Eisai_groupC,2,6,ts-global_detected_seizures,290098,290134,36
Jensen_Eisai_groupC,1,5,ts-global_detected_seizures,290145,290181,36
Jensen_Eisai_groupC,1,5,ts-global_detected_seizures,290207,290258,51
Jensen_Eisai_groupC,2,6,ts-global_detected_seizures,290212,290246,34
Jensen_Eisai_groupC,2,6,ts-global_detected_seizures,290315,290342,27
Jensen_Eisai_groupC,1,5,ts-global_detected_seizures,290340,290422,82
Jensen_Eisai_groupC,1,5,ts-global_detected_seizures,290340,290422,82
Jensen_Eisai_groupC,1,5,ts-global_detected_seizures,290426,290456,30
Jensen_Eisai_groupC,2,6,ts-global_detected_seizures,290435,290457,22
Jensen_Eisai_groupC,2,6,ts-global_detected_seizures,290464,290497,33
Jensen_Eisai_groupC,1,5,ts-global_detected_seizures,290476,290502,26
Jensen_Eisai_groupC,1,5,ts-global_detected_seizures,290526,290552,26
Jensen_Eisai_groupC,2,6,ts-global_detected_seizures,290537,290562,25
Jensen_Eisai_groupC,1,5,ts-global_detected_seizures,290563,290640,77
Jensen_Eisai_groupC,2,6,ts-global_detected_seizures,290609,290632,23
Jensen_Eisai_groupC,2,6,ts-global_detected_seizures,290666,290692,26
Jensen_Eisai_groupC,1,5,ts-global_detected_seizures,290694,290733,39
Jensen_Eisai_groupC,1,5,ts-global_detected_seizures,290764,290797,33
Jensen_Eisai_groupC,2,6,ts-global_detected_seizures,290795,290851,56
Jensen_Eisai_groupC,1,5,ts-global_detected_seizures,290815,290884,69
Jensen_Eisai_groupC,1,5,ts-global_detected_seizures,290891,290930,39
Jensen_Eisai_groupC,1,5,ts-global_detected_seizures,290971,291021,50
Jensen_Eisai_groupC,2,6,ts-global_detected_seizures,291028,291059,31
Jensen_Eisai_groupC,1,5,ts-global_detected_seizures,291064,291100,36
Jensen_Eisai_groupC,1,5,ts-global_detected_seizures,291101,291125,24
Jensen_Eisai_groupC,2,6,ts-global_detected_seizures,291115,291138,23
Jensen_Eisai_groupC,2,6,ts-global_detected_seizures,291184,291214,30
Jensen_Eisai_groupC,1,5,ts-global_detected_seizures,291194,291230,36
Jensen_Eisai_groupC,2,6,ts-global_detected_seizures,291230,291273,43
Jensen_Eisai_groupC,1,5,ts-global_detected_seizures,291255,291283,28
Jensen_Eisai_groupC,2,6,ts-global_detected_seizures,291276,291303,27
Jensen_Eisai_groupC,1,5,ts-global_detected_seizures,291319,291350,31
Jensen_Eisai_groupC,2,6,ts-global_detected_seizures,291320,291368,48
Jensen_Eisai_groupC,1,5,ts-global_detected_seizures,291352,291404,52
Jensen_Eisai_groupC,1,5,ts-global_detected_seizures,291432,291511,79
Jensen_Eisai_groupC,2,6,ts-global_detected_seizures,291456,291486,30
Jensen_Eisai_groupC,2,6,ts-global_detected_seizures,291549,291621,72
Jensen_Eisai_groupC,1,5,ts-global_detected_seizures,291590,291645,55
Jensen_Eisai_groupC,1,5,ts-global_detected_seizures,291649,291671,22
Jensen_Eisai_groupC,1,5,ts-global_detected_seizures,291688,291714,26
Jensen_Eisai_groupC,1,5,ts-global_detected_seizures,291715,291738,23
Jensen_Eisai_groupC,1,5,ts-global_detected_seizures,291781,291838,57
Jensen_Eisai_groupC,1,5,ts-global_detected_seizures,291846,291977,131
Jensen_Eisai_groupC,2,6,ts-global_detected_seizures,292005,292029,24
Jensen_Eisai_groupC,1,5,ts-global_detected_seizures,292012,292061,49
Jensen_Eisai_groupC,1,5,ts-global_detected_seizures,292079,292178,99
Jensen_Eisai_groupC,2,6,ts-global_detected_seizures,292081,292126,45
Jensen_Eisai_groupC,2,6,ts-global_detected_seizures,292132,292154,22
Jensen_Eisai_groupC,2,6,ts-global_detected_seizures,292156,292208,52
Jensen_Eisai_groupC,1,5,ts-global_detected_seizures,292227,292267,40
Jensen_Eisai_groupC,1,5,ts-global_detected_seizures,292276,292331,55
Jensen_Eisai_groupC,2,6,ts-global_detected_seizures,292325,292353,28
Jensen_Eisai_groupC,1,5,ts-global_detected_seizures,292335,292363,28
Jensen_Eisai_groupC,2,6,ts-global_detected_seizures,292354,292378,24
Jensen_Eisai_groupC,1,5,ts-global_detected_seizures,292385,292407,22
Jensen_Eisai_groupC,2,6,ts-global_detected_seizures,292392,292419,27
Jensen_Eisai_groupC,1,5,ts-global_detected_seizures,292409,292459,50
Jensen_Eisai_groupC,2,6,ts-global_detected_seizures,292420,292451,31
Jensen_Eisai_groupC,1,5,ts-global_detected_seizures,292464,292505,41
Jensen_Eisai_groupC,2,6,ts-global_detected_seizures,292476,292509,33
Jensen_Eisai_groupC,2,6,ts-global_detected_seizures,292589,292612,23
Jensen_Eisai_groupC,1,5,ts-global_detected_seizures,292674,292699,25
Jensen_Eisai_groupC,2,6,ts-global_detected_seizures,292683,292710,27
Jensen_Eisai_groupC,1,5,ts-global_detected_seizures,292725,292752,27
Jensen_Eisai_groupC,1,5,ts-global_detected_seizures,292776,292801,25
Jensen_Eisai_groupC,1,5,ts-global_detected_seizures,292816,292841,25
Jensen_Eisai_groupC,1,5,ts-global_detected_seizures,292885,293121,236
Jensen_Eisai_groupC,2,6,ts-global_detected_seizures,292901,292956,55
Jensen_Eisai_groupC,2,6,ts-global_detected_seizures,292970,293016,46
Jensen_Eisai_groupC,2,6,ts-global_detected_seizures,293040,293077,37
Jensen_Eisai_groupC,2,6,ts-global_detected_seizures,293118,293157,39
Jensen_Eisai_groupC,1,5,ts-global_detected_seizures,293148,293175,27
Jensen_Eisai_groupC,1,5,ts-global_detected_seizures,293189,293229,40
Jensen_Eisai_groupC,1,5,ts-global_detected_seizures,293268,293310,42
Jensen_Eisai_groupC,1,5,ts-global_detected_seizures,293313,293335,22
Jensen_Eisai_groupC,1,5,ts-global_detected_seizures,293345,293367,22
Jensen_Eisai_groupC,1,5,ts-global_detected_seizures,293388,293429,41
Jensen_Eisai_groupC,1,5,ts-global_detected_seizures,293431,293463,32
Jensen_Eisai_groupC,2,6,ts-global_detected_seizures,293460,293503,43
Jensen_Eisai_groupC,1,5,ts-global_detected_seizures,293469,293521,52
Jensen_Eisai_groupC,2,6,ts-global_detected_seizures,293505,293535,30
Jensen_Eisai_groupC,1,5,ts-global_detected_seizures,293523,293548,25
Jensen_Eisai_groupC,2,6,ts-global_detected_seizures,293551,293577,26
Jensen_Eisai_groupC,1,5,ts-global_detected_seizures,293591,293696,105
Jensen_Eisai_groupC,2,6,ts-global_detected_seizures,293621,293657,36
Jensen_Eisai_groupC,1,5,ts-global_detected_seizures,293750,293822,72
Jensen_Eisai_groupC,1,5,ts-global_detected_seizures,293840,293935,95
Jensen_Eisai_groupC,1,5,ts-global_detected_seizures,293937,293985,48
Jensen_Eisai_groupC,2,6,ts-global_detected_seizures,293968,294000,32
Jensen_Eisai_groupC,2,6,ts-global_detected_seizures,294008,294031,23
Jensen_Eisai_groupC,1,5,ts-global_detected_seizures,294049,294074,25
Jensen_Eisai_groupC,1,5,ts-global_detected_seizures,294075,294175,100
Jensen_Eisai_groupC,2,6,ts-global_detected_seizures,294100,294271,171
Jensen_Eisai_groupC,1,5,ts-global_detected_seizures,294208,294241,33
Jensen_Eisai_groupC,1,5,ts-global_detected_seizures,294242,294293,51
Jensen_Eisai_groupC,2,6,ts-global_detected_seizures,294281,295054,773
Jensen_Eisai_groupC,1,5,ts-global_detected_seizures,294315,294350,35
Jensen_Eisai_groupC,1,5,ts-global_detected_seizures,294354,294410,56
Jensen_Eisai_groupC,1,5,ts-global_detected_seizures,294438,294489,51
Jensen_Eisai_groupC,1,5,ts-global_detected_seizures,294507,294567,60
Jensen_Eisai_groupC,1,5,ts-global_detected_seizures,294708,294839,131
Jensen_Eisai_groupC,1,5,ts-global_detected_seizures,294860,295142,282
Jensen_Eisai_groupC,2,6,ts-global_detected_seizures,295055,295331,276
Jensen_Eisai_groupC,1,5,ts-global_detected_seizures,295147,295229,82
Jensen_Eisai_groupC,1,5,ts-global_detected_seizures,295235,295293,58
Jensen_Eisai_groupC,1,5,ts-global_detected_seizures,295294,295347,53
Jensen_Eisai_groupC,2,6,ts-global_detected_seizures,295333,295355,22
Jensen_Eisai_groupC,1,5,ts-global_detected_seizures,295351,295393,42
Jensen_Eisai_groupC,2,6,ts-global_detected_seizures,295358,295395,37
Jensen_Eisai_groupC,1,5,ts-global_detected_seizures,295412,295442,30
Jensen_Eisai_groupC,1,5,ts-global_detected_seizures,295459,295572,113
Jensen_Eisai_groupC,2,6,ts-global_detected_seizures,295499,295523,24
Jensen_Eisai_groupC,1,5,ts-global_detected_seizures,295590,295624,34
Jensen_Eisai_groupC,1,5,ts-global_detected_seizures,295646,295670,24
Jensen_Eisai_groupC,1,5,ts-global_detected_seizures,295688,295710,22
Jensen_Eisai_groupC,2,6,ts-global_detected_seizures,295750,295778,28
Jensen_Eisai_groupC,1,5,ts-global_detected_seizures,295753,295893,140
Jensen_Eisai_groupC,2,6,ts-global_detected_seizures,295805,295868,63
Jensen_Eisai_groupC,1,5,ts-global_detected_seizures,295918,296030,112
Jensen_Eisai_groupC,2,6,ts-global_detected_seizures,295995,296026,31
Jensen_Eisai_groupC,1,5,ts-global_detected_seizures,296058,296088,30
Jensen_Eisai_groupC,1,5,ts-global_detected_seizures,296096,296126,30
Jensen_Eisai_groupC,1,5,ts-global_detected_seizures,296142,296179,37
Jensen_Eisai_groupC,1,5,ts-global_detected_seizures,296247,296345,98
Jensen_Eisai_groupC,1,5,ts-global_detected_seizures,296368,296397,29
Jensen_Eisai_groupC,1,5,ts-global_detected_seizures,296409,296451,42
Jensen_Eisai_groupC,1,5,ts-global_detected_seizures,296460,296494,34
Jensen_Eisai_groupC,1,5,ts-global_detected_seizures,296495,296525,30
Jensen_Eisai_groupC,2,6,ts-global_detected_seizures,296508,296538,30
Jensen_Eisai_groupC,1,5,ts-global_detected_seizures,296539,296576,37
Jensen_Eisai_groupC,2,6,ts-global_detected_seizures,296550,296625,75
Jensen_Eisai_groupC,1,5,ts-global_detected_seizures,296577,296656,79
Jensen_Eisai_groupC,2,6,ts-global_detected_seizures,296626,296667,41
Jensen_Eisai_groupC,1,5,ts-global_detected_seizures,296667,296693,26
Jensen_Eisai_groupC,2,6,ts-global_detected_seizures,296668,296692,24
Jensen_Eisai_groupC,1,5,ts-global_detected_seizures,296712,296772,60
Jensen_Eisai_groupC,2,6,ts-global_detected_seizures,296805,296836,31
Jensen_Eisai_groupC,1,5,ts-global_detected_seizures,296825,296867,42
Jensen_Eisai_groupC,2,6,ts-global_detected_seizures,296857,296881,24
Jensen_Eisai_groupC,1,5,ts-global_detected_seizures,296868,296923,55
Jensen_Eisai_groupC,2,6,ts-global_detected_seizures,296934,297538,604
Jensen_Eisai_groupC,1,5,ts-global_detected_seizures,296957,296991,34
Jensen_Eisai_groupC,1,5,ts-global_detected_seizures,297003,297032,29
Jensen_Eisai_groupC,1,5,ts-global_detected_seizures,297052,297081,29
Jensen_Eisai_groupC,1,5,ts-global_detected_seizures,297087,297120,33
Jensen_Eisai_groupC,1,5,ts-global_detected_seizures,297138,297162,24
Jensen_Eisai_groupC,1,5,ts-global_detected_seizures,297210,297290,80
Jensen_Eisai_groupC,1,5,ts-global_detected_seizures,297291,297348,57
Jensen_Eisai_groupC,1,5,ts-global_detected_seizures,297381,297417,36
Jensen_Eisai_groupC,1,5,ts-global_detected_seizures,297434,297458,24
Jensen_Eisai_groupC,1,5,ts-global_detected_seizures,297470,297531,61
Jensen_Eisai_groupC,2,6,ts-global_detected_seizures,297540,297564,24
Jensen_Eisai_groupC,1,5,ts-global_detected_seizures,297550,298621,1071
Jensen_Eisai_groupC,2,6,ts-global_detected_seizures,297740,297762,22
Jensen_Eisai_groupC,2,6,ts-global_detected_seizures,298101,298619,518
Jensen_Eisai_groupC,1,5,ts-global_detected_seizures,298622,298661,39
Jensen_Eisai_groupC,1,5,ts-global_detected_seizures,298667,298705,38
Jensen_Eisai_groupC,1,5,ts-global_detected_seizures,298715,298746,31
Jensen_Eisai_groupC,1,5,ts-global_detected_seizures,298750,298785,35
Jensen_Eisai_groupC,1,5,ts-global_detected_seizures,298815,298838,23
Jensen_Eisai_groupC,1,5,ts-global_detected_seizures,298845,298911,66
Jensen_Eisai_groupC,2,6,ts-global_detected_seizures,298949,298973,24
Jensen_Eisai_groupC,1,5,ts-global_detected_seizures,298979,299002,23
Jensen_Eisai_groupC,1,5,ts-global_detected_seizures,299006,299036,30
Jensen_Eisai_groupC,1,5,ts-global_detected_seizures,299073,299110,37
Jensen_Eisai_groupC,1,5,ts-global_detected_seizures,299132,299184,52
Jensen_Eisai_groupC,2,6,ts-global_detected_seizures,299154,299184,30
Jensen_Eisai_groupC,2,6,ts-global_detected_seizures,299185,299211,26
Jensen_Eisai_groupC,1,5,ts-global_detected_seizures,299210,299238,28
Jensen_Eisai_groupC,2,6,ts-global_detected_seizures,299217,299265,48
Jensen_Eisai_groupC,1,5,ts-global_detected_seizures,299290,299354,64
Jensen_Eisai_groupC,1,5,ts-global_detected_seizures,299359,300388,1029
Jensen_Eisai_groupC,2,6,ts-global_detected_seizures,299656,299681,25
Jensen_Eisai_groupC,2,6,ts-global_detected_seizures,299686,299751,65
Jensen_Eisai_groupC,2,6,ts-global_detected_seizures,299752,300023,271
Jensen_Eisai_groupC,2,6,ts-global_detected_seizures,300030,300155,125
Jensen_Eisai_groupC,2,6,ts-global_detected_seizures,300156,300757,601
Jensen_Eisai_groupC,1,5,ts-global_detected_seizures,300389,300643,254
Jensen_Eisai_groupC,1,5,ts-global_detected_seizures,300678,300718,40
Jensen_Eisai_groupC,1,5,ts-global_detected_seizures,300719,300948,229
Jensen_Eisai_groupC,2,6,ts-global_detected_seizures,300790,301175,385
Jensen_Eisai_groupC,1,5,ts-global_detected_seizures,300949,301154,205
Jensen_Eisai_groupC,1,5,ts-global_detected_seizures,301155,301499,344
Jensen_Eisai_groupC,2,6,ts-global_detected_seizures,301176,301214,38
Jensen_Eisai_groupC,2,6,ts-global_detected_seizures,301215,301273,58
Jensen_Eisai_groupC,2,6,ts-global_detected_seizures,301287,301322,35
Jensen_Eisai_groupC,1,5,ts-global_detected_seizures,301500,301948,448
Jensen_Eisai_groupC,2,6,ts-global_detected_seizures,301516,301545,29
Jensen_Eisai_groupC,1,5,ts-global_detected_seizures,301950,302181,231
Jensen_Eisai_groupC,2,6,ts-global_detected_seizures,302020,302053,33
Jensen_Eisai_groupC,1,5,ts-global_detected_seizures,302182,302288,106
Jensen_Eisai_groupC,1,5,ts-global_detected_seizures,302289,302371,82
Jensen_Eisai_groupC,1,5,ts-global_detected_seizures,302372,302400,28
Jensen_Eisai_groupC,1,5,ts-global_detected_seizures,302401,302469,68
Jensen_Eisai_groupC,1,5,ts-global_detected_seizures,302485,302589,104
Jensen_Eisai_groupC,1,5,ts-global_detected_seizures,302600,302695,95
Jensen_Eisai_groupC,1,5,ts-global_detected_seizures,302757,302786,29
Jensen_Eisai_groupC,1,5,ts-global_detected_seizures,302813,302842,29
Jensen_Eisai_groupC,1,5,ts-global_detected_seizures,302843,302897,54
Jensen_Eisai_groupC,1,5,ts-global_detected_seizures,302927,302962,35
Jensen_Eisai_groupC,1,5,ts-global_detected_seizures,302987,303038,51
Jensen_Eisai_groupC,1,5,ts-global_detected_seizures,303052,303074,22
Jensen_Eisai_groupC,2,6,ts-global_detected_seizures,303071,303094,23
Jensen_Eisai_groupC,1,5,ts-global_detected_seizures,303097,303153,56
Jensen_Eisai_groupC,1,5,ts-global_detected_seizures,303176,303265,89
Jensen_Eisai_groupC,1,5,ts-global_detected_seizures,303300,303346,46
Jensen_Eisai_groupC,1,5,ts-global_detected_seizures,303347,303414,67
Jensen_Eisai_groupC,2,6,ts-global_detected_seizures,303429,303457,28
Jensen_Eisai_groupC,1,5,ts-global_detected_seizures,303436,303465,29
Jensen_Eisai_groupC,1,5,ts-global_detected_seizures,303475,303508,33
Jensen_Eisai_groupC,2,6,ts-global_detected_seizures,303509,303537,28
Jensen_Eisai_groupC,1,5,ts-global_detected_seizures,303523,303569,46
Jensen_Eisai_groupC,1,5,ts-global_detected_seizures,303580,303619,39
Jensen_Eisai_groupC,1,5,ts-global_detected_seizures,303622,303653,31
Jensen_Eisai_groupC,1,5,ts-global_detected_seizures,303660,303690,30
Jensen_Eisai_groupC,2,6,ts-global_detected_seizures,303662,303686,24
Jensen_Eisai_groupC,1,5,ts-global_detected_seizures,303699,303745,46
Jensen_Eisai_groupC,1,5,ts-global_detected_seizures,303746,303829,83
Jensen_Eisai_groupC,1,5,ts-global_detected_seizures,303875,303942,67
Jensen_Eisai_groupC,1,5,ts-global_detected_seizures,303964,303991,27
Jensen_Eisai_groupC,1,5,ts-global_detected_seizures,304029,304081,52
Jensen_Eisai_groupC,1,5,ts-global_detected_seizures,304102,304142,40
Jensen_Eisai_groupC,1,5,ts-global_detected_seizures,304143,304187,44
Jensen_Eisai_groupC,1,5,ts-global_detected_seizures,304209,304232,23
Jensen_Eisai_groupC,1,5,ts-global_detected_seizures,304233,304277,44
Jensen_Eisai_groupC,1,5,ts-global_detected_seizures,304303,304399,96
Jensen_Eisai_groupC,1,5,ts-global_detected_seizures,304418,304493,75
Jensen_Eisai_groupC,1,5,ts-global_detected_seizures,304494,304539,45
Jensen_Eisai_groupC,1,5,ts-global_detected_seizures,304541,304605,64
Jensen_Eisai_groupC,1,5,ts-global_detected_seizures,304625,304661,36
Jensen_Eisai_groupC,1,5,ts-global_detected_seizures,304662,304804,142
Jensen_Eisai_groupC,1,5,ts-global_detected_seizures,304817,304843,26
Jensen_Eisai_groupC,2,6,ts-global_detected_seizures,304820,304847,27
Jensen_Eisai_groupC,1,5,ts-global_detected_seizures,304845,304932,87
Jensen_Eisai_groupC,2,6,ts-global_detected_seizures,304849,304872,23
Jensen_Eisai_groupC,2,6,ts-global_detected_seizures,304927,304949,22
Jensen_Eisai_groupC,1,5,ts-global_detected_seizures,304933,304975,42
Jensen_Eisai_groupC,2,6,ts-global_detected_seizures,304963,305000,37
Jensen_Eisai_groupC,1,5,ts-global_detected_seizures,304976,305016,40
Jensen_Eisai_groupC,2,6,ts-global_detected_seizures,305016,305051,35
Jensen_Eisai_groupC,1,5,ts-global_detected_seizures,305017,305074,57
Jensen_Eisai_groupC,2,6,ts-global_detected_seizures,305072,305122,50
Jensen_Eisai_groupC,1,5,ts-global_detected_seizures,305075,305151,76
Jensen_Eisai_groupC,1,5,ts-global_detected_seizures,305152,305184,32
Jensen_Eisai_groupC,1,5,ts-global_detected_seizures,305186,305225,39
Jensen_Eisai_groupC,2,6,ts-global_detected_seizures,305217,305250,33
Jensen_Eisai_groupC,1,5,ts-global_detected_seizures,305227,305270,43
Jensen_Eisai_groupC,2,6,ts-global_detected_seizures,305251,305299,48
Jensen_Eisai_groupC,1,5,ts-global_detected_seizures,305285,305314,29
Jensen_Eisai_groupC,1,5,ts-global_detected_seizures,305317,305547,230
Jensen_Eisai_groupC,2,6,ts-global_detected_seizures,305320,305374,54
Jensen_Eisai_groupC,2,6,ts-global_detected_seizures,305392,305419,27
Jensen_Eisai_groupC,2,6,ts-global_detected_seizures,305420,305518,98
Jensen_Eisai_groupC,2,6,ts-global_detected_seizures,305522,305548,26
Jensen_Eisai_groupC,1,5,ts-global_detected_seizures,305548,305575,27
Jensen_Eisai_groupC,2,6,ts-global_detected_seizures,305581,305613,32
Jensen_Eisai_groupC,1,5,ts-global_detected_seizures,305602,305684,82
Jensen_Eisai_groupC,2,6,ts-global_detected_seizures,305639,305672,33
Jensen_Eisai_groupC,1,5,ts-global_detected_seizures,305693,305844,151
Jensen_Eisai_groupC,2,6,ts-global_detected_seizures,305704,305730,26
Jensen_Eisai_groupC,2,6,ts-global_detected_seizures,305731,305760,29
Jensen_Eisai_groupC,2,6,ts-global_detected_seizures,305774,305822,48
Jensen_Eisai_groupC,2,6,ts-global_detected_seizures,305823,305845,22
Jensen_Eisai_groupC,2,6,ts-global_detected_seizures,305858,305887,29
Jensen_Eisai_groupC,1,5,ts-global_detected_seizures,305878,305943,65
Jensen_Eisai_groupC,2,6,ts-global_detected_seizures,305889,305959,70
Jensen_Eisai_groupC,2,6,ts-global_detected_seizures,305993,306032,39
Jensen_Eisai_groupC,1,5,ts-global_detected_seizures,306002,306118,116
Jensen_Eisai_groupC,2,6,ts-global_detected_seizures,306041,306073,32
Jensen_Eisai_groupC,2,6,ts-global_detected_seizures,306076,306113,37
Jensen_Eisai_groupC,1,5,ts-global_detected_seizures,306122,306150,28
Jensen_Eisai_groupC,2,6,ts-global_detected_seizures,306132,306190,58
Jensen_Eisai_groupC,1,5,ts-global_detected_seizures,306180,306276,96
Jensen_Eisai_groupC,2,6,ts-global_detected_seizures,306193,306244,51
Jensen_Eisai_groupC,1,5,ts-global_detected_seizures,306279,306540,261
Jensen_Eisai_groupC,2,6,ts-global_detected_seizures,306377,306400,23
Jensen_Eisai_groupC,2,6,ts-global_detected_seizures,306418,306443,25
Jensen_Eisai_groupC,2,6,ts-global_detected_seizures,306492,306540,48
Jensen_Eisai_groupC,1,5,ts-global_detected_seizures,306563,306922,359
Jensen_Eisai_groupC,2,6,ts-global_detected_seizures,306600,306645,45
Jensen_Eisai_groupC,1,5,ts-global_detected_seizures,306953,306985,32
Jensen_Eisai_groupC,1,5,ts-global_detected_seizures,306986,307090,104
Jensen_Eisai_groupC,1,5,ts-global_detected_seizures,307091,307127,36
Jensen_Eisai_groupC,1,5,ts-global_detected_seizures,307128,307249,121
Jensen_Eisai_groupC,2,6,ts-global_detected_seizures,307173,307344,171
Jensen_Eisai_groupC,1,5,ts-global_detected_seizures,307250,307303,53
Jensen_Eisai_groupC,1,5,ts-global_detected_seizures,307307,307528,221
Jensen_Eisai_groupC,2,6,ts-global_detected_seizures,307349,307380,31
Jensen_Eisai_groupC,2,6,ts-global_detected_seizures,307382,307407,25
Jensen_Eisai_groupC,2,6,ts-global_detected_seizures,307454,307516,62
Jensen_Eisai_groupC,1,5,ts-global_detected_seizures,307552,307700,148
Jensen_Eisai_groupC,2,6,ts-global_detected_seizures,307558,307583,25
Jensen_Eisai_groupC,2,6,ts-global_detected_seizures,307604,307636,32
Jensen_Eisai_groupC,2,6,ts-global_detected_seizures,307637,307809,172
Jensen_Eisai_groupC,1,5,ts-global_detected_seizures,307709,307732,23
Jensen_Eisai_groupC,1,5,ts-global_detected_seizures,307733,307924,191
Jensen_Eisai_groupC,2,6,ts-global_detected_seizures,307811,307861,50
Jensen_Eisai_groupC,1,5,ts-global_detected_seizures,307926,308047,121
Jensen_Eisai_groupC,1,5,ts-global_detected_seizures,308066,308200,134
Jensen_Eisai_groupC,2,6,ts-global_detected_seizures,308195,308217,22
Jensen_Eisai_groupC,1,5,ts-global_detected_seizures,308239,308279,40
Jensen_Eisai_groupC,1,5,ts-global_detected_seizures,308289,308355,66
Jensen_Eisai_groupC,2,6,ts-global_detected_seizures,308334,308356,22
Jensen_Eisai_groupC,1,5,ts-global_detected_seizures,308356,308399,43
Jensen_Eisai_groupC,1,5,ts-global_detected_seizures,308400,308648,248
Jensen_Eisai_groupC,2,6,ts-global_detected_seizures,308639,309015,376
Jensen_Eisai_groupC,1,5,ts-global_detected_seizures,308649,308757,108
Jensen_Eisai_groupC,1,5,ts-global_detected_seizures,308758,309362,604
Jensen_Eisai_groupC,2,6,ts-global_detected_seizures,309023,309056,33
Jensen_Eisai_groupC,2,6,ts-global_detected_seizures,309057,309264,207
Jensen_Eisai_groupC,2,6,ts-global_detected_seizures,309273,309325,52
Jensen_Eisai_groupC,2,6,ts-global_detected_seizures,309337,309367,30
Jensen_Eisai_groupC,2,6,ts-global_detected_seizures,309370,309400,30
Jensen_Eisai_groupC,1,5,ts-global_detected_seizures,309384,309471,87
Jensen_Eisai_groupC,2,6,ts-global_detected_seizures,309403,309445,42
Jensen_Eisai_groupC,2,6,ts-global_detected_seizures,309456,309533,77
Jensen_Eisai_groupC,1,5,ts-global_detected_seizures,309472,309523,51
Jensen_Eisai_groupC,1,5,ts-global_detected_seizures,309534,309683,149
Jensen_Eisai_groupC,1,5,ts-global_detected_seizures,309684,310101,417
Jensen_Eisai_groupC,2,6,ts-global_detected_seizures,309765,309795,30
Jensen_Eisai_groupC,2,6,ts-global_detected_seizures,309946,309968,22
Jensen_Eisai_groupC,1,5,ts-global_detected_seizures,310102,310166,64
Jensen_Eisai_groupC,1,5,ts-global_detected_seizures,310167,310322,155
Jensen_Eisai_groupC,2,6,ts-global_detected_seizures,310183,310227,44
Jensen_Eisai_groupC,1,5,ts-global_detected_seizures,310323,310440,117
Jensen_Eisai_groupC,1,5,ts-global_detected_seizures,310441,310492,51
Jensen_Eisai_groupC,1,5,ts-global_detected_seizures,310493,310645,152
Jensen_Eisai_groupC,2,6,ts-global_detected_seizures,310517,310539,22
Jensen_Eisai_groupC,1,5,ts-global_detected_seizures,310646,310681,35
Jensen_Eisai_groupC,1,5,ts-global_detected_seizures,310692,311520,828
Jensen_Eisai_groupC,2,6,ts-global_detected_seizures,310788,310817,29
Jensen_Eisai_groupC,2,6,ts-global_detected_seizures,311053,311077,24
Jensen_Eisai_groupC,2,6,ts-global_detected_seizures,311111,311611,500
Jensen_Eisai_groupC,1,5,ts-global_detected_seizures,311521,311602,81
Jensen_Eisai_groupC,1,5,ts-global_detected_seizures,311603,311698,95
Jensen_Eisai_groupC,2,6,ts-global_detected_seizures,311680,312186,506
Jensen_Eisai_groupC,1,5,ts-global_detected_seizures,311702,311764,62
Jensen_Eisai_groupC,1,5,ts-global_detected_seizures,311766,311817,51
Jensen_Eisai_groupC,1,5,ts-global_detected_seizures,311819,311887,68
Jensen_Eisai_groupC,1,5,ts-global_detected_seizures,311888,311959,71
Jensen_Eisai_groupC,1,5,ts-global_detected_seizures,311961,312100,139
Jensen_Eisai_groupC,1,5,ts-global_detected_seizures,312103,312129,26
Jensen_Eisai_groupC,1,5,ts-global_detected_seizures,312130,312232,102
Jensen_Eisai_groupC,2,6,ts-global_detected_seizures,312188,312221,33
Jensen_Eisai_groupC,1,5,ts-global_detected_seizures,312254,312318,64
Jensen_Eisai_groupC,1,5,ts-global_detected_seizures,312324,312362,38
Jensen_Eisai_groupC,1,5,ts-global_detected_seizures,312363,312497,134
Jensen_Eisai_groupC,2,6,ts-global_detected_seizures,312370,312398,28
Jensen_Eisai_groupC,2,6,ts-global_detected_seizures,312425,312453,28
Jensen_Eisai_groupC,2,6,ts-global_detected_seizures,312490,312871,381
Jensen_Eisai_groupC,1,5,ts-global_detected_seizures,312506,312657,151
Jensen_Eisai_groupC,1,5,ts-global_detected_seizures,312747,312804,57
Jensen_Eisai_groupC,1,5,ts-global_detected_seizures,312805,312831,26
Jensen_Eisai_groupC,1,5,ts-global_detected_seizures,312854,312954,100
Jensen_Eisai_groupC,2,6,ts-global_detected_seizures,312872,312920,48
Jensen_Eisai_groupC,2,6,ts-global_detected_seizures,312969,312991,22
Jensen_Eisai_groupC,1,5,ts-global_detected_seizures,312977,313065,88
Jensen_Eisai_groupC,1,5,ts-global_detected_seizures,313084,313178,94
Jensen_Eisai_groupC,1,5,ts-global_detected_seizures,313179,313281,102
Jensen_Eisai_groupC,2,6,ts-global_detected_seizures,313181,313203,22
Jensen_Eisai_groupC,1,5,ts-global_detected_seizures,313282,313327,45
Jensen_Eisai_groupC,2,6,ts-global_detected_seizures,313291,313331,40
Jensen_Eisai_groupC,1,5,ts-global_detected_seizures,313335,313378,43
Jensen_Eisai_groupC,2,6,ts-global_detected_seizures,313354,313381,27
Jensen_Eisai_groupC,1,5,ts-global_detected_seizures,313379,313490,111
Jensen_Eisai_groupC,1,5,ts-global_detected_seizures,313491,313546,55
Jensen_Eisai_groupC,1,5,ts-global_detected_seizures,313566,313625,59
Jensen_Eisai_groupC,2,6,ts-global_detected_seizures,313592,313616,24
Jensen_Eisai_groupC,1,5,ts-global_detected_seizures,313642,313702,60
Jensen_Eisai_groupC,2,6,ts-global_detected_seizures,313649,314167,518
Jensen_Eisai_groupC,1,5,ts-global_detected_seizures,313725,313769,44
Jensen_Eisai_groupC,1,5,ts-global_detected_seizures,313771,313797,26
Jensen_Eisai_groupC,1,5,ts-global_detected_seizures,313819,313874,55
Jensen_Eisai_groupC,1,5,ts-global_detected_seizures,313875,314136,261
Jensen_Eisai_groupC,1,5,ts-global_detected_seizures,314137,314163,26
Jensen_Eisai_groupC,1,5,ts-global_detected_seizures,314165,314199,34
Jensen_Eisai_groupC,2,6,ts-global_detected_seizures,314168,314213,45
Jensen_Eisai_groupC,1,5,ts-global_detected_seizures,314217,314314,97
Jensen_Eisai_groupC,2,6,ts-global_detected_seizures,314226,314255,29
Jensen_Eisai_groupC,1,5,ts-global_detected_seizures,314329,314412,83
Jensen_Eisai_groupC,1,5,ts-global_detected_seizures,314419,314442,23
Jensen_Eisai_groupC,1,5,ts-global_detected_seizures,314450,314478,28
Jensen_Eisai_groupC,1,5,ts-global_detected_seizures,314479,314620,141
Jensen_Eisai_groupC,2,6,ts-global_detected_seizures,314506,314535,29
Jensen_Eisai_groupC,2,6,ts-global_detected_seizures,314565,314589,24
Jensen_Eisai_groupC,1,5,ts-global_detected_seizures,314621,314660,39
Jensen_Eisai_groupC,1,5,ts-global_detected_seizures,314668,314734,66
Jensen_Eisai_groupC,1,5,ts-global_detected_seizures,314735,314759,24
Jensen_Eisai_groupC,2,6,ts-global_detected_seizures,314736,314759,23
Jensen_Eisai_groupC,1,5,ts-global_detected_seizures,314772,314811,39
Jensen_Eisai_groupC,1,5,ts-global_detected_seizures,314817,314967,150
Jensen_Eisai_groupC,2,6,ts-global_detected_seizures,314927,314958,31
Jensen_Eisai_groupC,1,5,ts-global_detected_seizures,315004,315040,36
Jensen_Eisai_groupC,1,5,ts-global_detected_seizures,315057,315149,92
Jensen_Eisai_groupC,2,6,ts-global_detected_seizures,315151,315487,336
Jensen_Eisai_groupC,1,5,ts-global_detected_seizures,315218,315260,42
Jensen_Eisai_groupC,1,5,ts-global_detected_seizures,315264,315286,22
Jensen_Eisai_groupC,1,5,ts-global_detected_seizures,315287,315653,366
Jensen_Eisai_groupC,2,6,ts-global_detected_seizures,315488,315520,32
Jensen_Eisai_groupC,2,6,ts-global_detected_seizures,315543,315804,261
Jensen_Eisai_groupC,1,5,ts-global_detected_seizures,315654,315718,64
Jensen_Eisai_groupC,1,5,ts-global_detected_seizures,315767,315835,68
Jensen_Eisai_groupC,2,6,ts-global_detected_seizures,315807,315849,42
Jensen_Eisai_groupC,2,6,ts-global_detected_seizures,315853,315883,30
Jensen_Eisai_groupC,1,5,ts-global_detected_seizures,315893,315930,37
Jensen_Eisai_groupC,2,6,ts-global_detected_seizures,315931,316524,593
Jensen_Eisai_groupC,1,5,ts-global_detected_seizures,316012,316080,68
Jensen_Eisai_groupC,1,5,ts-global_detected_seizures,316329,316366,37
Jensen_Eisai_groupC,2,6,ts-global_detected_seizures,316535,316557,22
Jensen_Eisai_groupC,2,6,ts-global_detected_seizures,316732,316756,24
Jensen_Eisai_groupC,2,6,ts-global_detected_seizures,316810,316838,28
Jensen_Eisai_groupC,1,5,ts-global_detected_seizures,317015,317098,83
Jensen_Eisai_groupC,1,5,ts-global_detected_seizures,317099,317377,278
Jensen_Eisai_groupC,2,6,ts-global_detected_seizures,317376,317414,38
Jensen_Eisai_groupC,1,5,ts-global_detected_seizures,317378,317637,259
Jensen_Eisai_groupC,2,6,ts-global_detected_seizures,317429,317463,34
Jensen_Eisai_groupC,2,6,ts-global_detected_seizures,317464,317503,39
Jensen_Eisai_groupC,2,6,ts-global_detected_seizures,317549,317576,27
Jensen_Eisai_groupC,1,5,ts-global_detected_seizures,317638,317850,212
Jensen_Eisai_groupC,2,6,ts-global_detected_seizures,317740,317767,27
Jensen_Eisai_groupC,2,6,ts-global_detected_seizures,317841,317869,28
Jensen_Eisai_groupC,1,5,ts-global_detected_seizures,317851,318373,522
Jensen_Eisai_groupC,2,6,ts-global_detected_seizures,318369,318492,123
Jensen_Eisai_groupC,1,5,ts-global_detected_seizures,318406,318807,401
Jensen_Eisai_groupC,2,6,ts-global_detected_seizures,318731,319689,958
Jensen_Eisai_groupC,1,5,ts-global_detected_seizures,318808,318837,29
Jensen_Eisai_groupC,1,5,ts-global_detected_seizures,318838,318876,38
Jensen_Eisai_groupC,1,5,ts-global_detected_seizures,318879,319189,310
Jensen_Eisai_groupC,1,5,ts-global_detected_seizures,319204,319292,88
Jensen_Eisai_groupC,1,5,ts-global_detected_seizures,319313,319617,304
Jensen_Eisai_groupC,1,5,ts-global_detected_seizures,319618,319777,159
Jensen_Eisai_groupC,2,6,ts-global_detected_seizures,319690,319720,30
Jensen_Eisai_groupC,2,6,ts-global_detected_seizures,319721,319849,128
Jensen_Eisai_groupC,1,5,ts-global_detected_seizures,319778,319869,91
Jensen_Eisai_groupC,2,6,ts-global_detected_seizures,319865,319902,37
Jensen_Eisai_groupC,1,5,ts-global_detected_seizures,319871,319936,65
Jensen_Eisai_groupC,2,6,ts-global_detected_seizures,319903,320692,789
Jensen_Eisai_groupC,1,5,ts-global_detected_seizures,319937,319962,25
Jensen_Eisai_groupC,1,5,ts-global_detected_seizures,319972,320263,291
Jensen_Eisai_groupC,1,5,ts-global_detected_seizures,320264,320780,516
Jensen_Eisai_groupC,2,6,ts-global_detected_seizures,320693,320750,57
Jensen_Eisai_groupC,2,6,ts-global_detected_seizures,320751,321103,352
Jensen_Eisai_groupC,1,5,ts-global_detected_seizures,320789,320859,70
Jensen_Eisai_groupC,1,5,ts-global_detected_seizures,320860,321222,362
Jensen_Eisai_groupC,2,6,ts-global_detected_seizures,321104,321217,113
Jensen_Eisai_groupC,1,5,ts-global_detected_seizures,321224,321370,146
Jensen_Eisai_groupC,2,6,ts-global_detected_seizures,321246,321418,172
Jensen_Eisai_groupC,1,5,ts-global_detected_seizures,321373,321848,475
Jensen_Eisai_groupC,2,6,ts-global_detected_seizures,321420,321695,275
Jensen_Eisai_groupC,2,6,ts-global_detected_seizures,321696,321775,79
Jensen_Eisai_groupC,2,6,ts-global_detected_seizures,321777,322243,466
Jensen_Eisai_groupC,1,5,ts-global_detected_seizures,321849,321888,39
Jensen_Eisai_groupC,1,5,ts-global_detected_seizures,321889,321938,49
Jensen_Eisai_groupC,1,5,ts-global_detected_seizures,321944,322238,294
Jensen_Eisai_groupC,1,5,ts-global_detected_seizures,322240,322631,391
Jensen_Eisai_groupC,2,6,ts-global_detected_seizures,322244,322273,29
Jensen_Eisai_groupC,2,6,ts-global_detected_seizures,322469,322521,52
Jensen_Eisai_groupC,1,5,ts-global_detected_seizures,322632,322751,119
Jensen_Eisai_groupC,2,6,ts-global_detected_seizures,322672,322695,23
Jensen_Eisai_groupC,1,5,ts-global_detected_seizures,322752,323768,1016
Jensen_Eisai_groupC,2,6,ts-global_detected_seizures,322797,322822,25
Jensen_Eisai_groupC,2,6,ts-global_detected_seizures,322874,322906,32
Jensen_Eisai_groupC,2,6,ts-global_detected_seizures,322874,322906,32
Jensen_Eisai_groupC,2,6,ts-global_detected_seizures,323129,323164,35
Jensen_Eisai_groupC,2,6,ts-global_detected_seizures,323379,323948,569
Jensen_Eisai_groupC,1,5,ts-global_detected_seizures,323769,323976,207
Jensen_Eisai_groupC,2,6,ts-global_detected_seizures,323949,324199,250
Jensen_Eisai_groupC,1,5,ts-global_detected_seizures,323977,324471,494
Jensen_Eisai_groupC,2,6,ts-global_detected_seizures,324234,324303,69
Jensen_Eisai_groupC,2,6,ts-global_detected_seizures,324395,324443,48
Jensen_Eisai_groupC,1,5,ts-global_detected_seizures,324472,324757,285
Jensen_Eisai_groupC,2,6,ts-global_detected_seizures,324581,324613,32
Jensen_Eisai_groupC,2,6,ts-global_detected_seizures,324668,324700,32
Jensen_Eisai_groupC,1,5,ts-global_detected_seizures,324758,324829,71
Jensen_Eisai_groupC,1,5,ts-global_detected_seizures,324831,325610,779
Jensen_Eisai_groupC,2,6,ts-global_detected_seizures,324852,324886,34
Jensen_Eisai_groupC,2,6,ts-global_detected_seizures,324954,325000,46
Jensen_Eisai_groupC,2,6,ts-global_detected_seizures,325021,325083,62
Jensen_Eisai_groupC,2,6,ts-global_detected_seizures,325417,325449,32
Jensen_Eisai_groupC,1,5,ts-global_detected_seizures,325633,326206,573
Jensen_Eisai_groupC,2,6,ts-global_detected_seizures,325777,325852,75
Jensen_Eisai_groupC,2,6,ts-global_detected_seizures,325854,325898,44
Jensen_Eisai_groupC,2,6,ts-global_detected_seizures,325997,326021,24
Jensen_Eisai_groupC,2,6,ts-global_detected_seizures,326047,326076,29
Jensen_Eisai_groupC,2,6,ts-global_detected_seizures,326097,326125,28
Jensen_Eisai_groupC,2,6,ts-global_detected_seizures,326175,326205,30
Jensen_Eisai_groupC,1,5,ts-global_detected_seizures,326207,326838,631
Jensen_Eisai_groupC,2,6,ts-global_detected_seizures,326272,326299,27
Jensen_Eisai_groupC,2,6,ts-global_detected_seizures,326336,326367,31
Jensen_Eisai_groupC,2,6,ts-global_detected_seizures,326413,326444,31
Jensen_Eisai_groupC,2,6,ts-global_detected_seizures,326649,326696,47
Jensen_Eisai_groupC,2,6,ts-global_detected_seizures,326724,326749,25
Jensen_Eisai_groupC,2,6,ts-global_detected_seizures,326771,326794,23
Jensen_Eisai_groupC,1,5,ts-global_detected_seizures,326839,326957,118
Jensen_Eisai_groupC,2,6,ts-global_detected_seizures,326886,326908,22
Jensen_Eisai_groupC,1,5,ts-global_detected_seizures,326958,327350,392
Jensen_Eisai_groupC,2,6,ts-global_detected_seizures,327000,327033,33
Jensen_Eisai_groupC,2,6,ts-global_detected_seizures,327184,327224,40
Jensen_Eisai_groupC,2,6,ts-global_detected_seizures,327225,327253,28
Jensen_Eisai_groupC,2,6,ts-global_detected_seizures,327256,327296,40
Jensen_Eisai_groupC,1,5,ts-global_detected_seizures,327351,327836,485
Jensen_Eisai_groupC,2,6,ts-global_detected_seizures,327394,327417,23
Jensen_Eisai_groupC,2,6,ts-global_detected_seizures,327549,327571,22
Jensen_Eisai_groupC,2,6,ts-global_detected_seizures,327648,327671,23
Jensen_Eisai_groupC,2,6,ts-global_detected_seizures,327714,327761,47
Jensen_Eisai_groupC,2,6,ts-global_detected_seizures,327836,328691,855
Jensen_Eisai_groupC,1,5,ts-global_detected_seizures,327837,327929,92
Jensen_Eisai_groupC,1,5,ts-global_detected_seizures,327931,327998,67
Jensen_Eisai_groupC,1,5,ts-global_detected_seizures,328026,328080,54
Jensen_Eisai_groupC,1,5,ts-global_detected_seizures,328087,328592,505
Jensen_Eisai_groupC,1,5,ts-global_detected_seizures,328593,328668,75
Jensen_Eisai_groupC,1,5,ts-global_detected_seizures,328670,328696,26
Jensen_Eisai_groupC,2,6,ts-global_detected_seizures,328692,328775,83
Jensen_Eisai_groupC,1,5,ts-global_detected_seizures,328697,328721,24
Jensen_Eisai_groupC,1,5,ts-global_detected_seizures,328722,329104,382
Jensen_Eisai_groupC,2,6,ts-global_detected_seizures,328776,329648,872
Jensen_Eisai_groupC,1,5,ts-global_detected_seizures,329118,329293,175
Jensen_Eisai_groupC,1,5,ts-global_detected_seizures,329342,329365,23
Jensen_Eisai_groupC,1,5,ts-global_detected_seizures,329526,329657,131
Jensen_Eisai_groupC,2,6,ts-global_detected_seizures,329649,330624,975
Jensen_Eisai_groupC,1,5,ts-global_detected_seizures,329658,329932,274
Jensen_Eisai_groupC,1,5,ts-global_detected_seizures,330285,330307,22
Jensen_Eisai_groupC,1,5,ts-global_detected_seizures,330409,330449,40
Jensen_Eisai_groupC,1,5,ts-global_detected_seizures,330481,330524,43
Jensen_Eisai_groupC,2,6,ts-global_detected_seizures,330643,331409,766
Jensen_Eisai_groupC,1,5,ts-global_detected_seizures,330895,330920,25
Jensen_Eisai_groupC,1,5,ts-global_detected_seizures,330995,331579,584
Jensen_Eisai_groupC,1,5,ts-global_detected_seizures,331580,331668,88
Jensen_Eisai_groupC,2,6,ts-global_detected_seizures,331662,332121,459
Jensen_Eisai_groupC,1,5,ts-global_detected_seizures,331796,331819,23
Jensen_Eisai_groupC,1,5,ts-global_detected_seizures,332103,332178,75
Jensen_Eisai_groupC,2,6,ts-global_detected_seizures,332122,332149,27
Jensen_Eisai_groupC,2,6,ts-global_detected_seizures,332312,332338,26
Jensen_Eisai_groupC,1,5,ts-global_detected_seizures,332331,332358,27
Jensen_Eisai_groupC,1,5,ts-global_detected_seizures,332359,332381,22
Jensen_Eisai_groupC,2,6,ts-global_detected_seizures,332379,332408,29
Jensen_Eisai_groupC,1,5,ts-global_detected_seizures,332460,332504,44
Jensen_Eisai_groupC,1,5,ts-global_detected_seizures,332555,332591,36
Jensen_Eisai_groupC,2,6,ts-global_detected_seizures,332707,332760,53
Jensen_Eisai_groupC,2,6,ts-global_detected_seizures,332761,332793,32
Jensen_Eisai_groupC,1,5,ts-global_detected_seizures,332799,332821,22
Jensen_Eisai_groupC,1,5,ts-global_detected_seizures,332921,332996,75
Jensen_Eisai_groupC,2,6,ts-global_detected_seizures,332978,333002,24
Jensen_Eisai_groupC,1,5,ts-global_detected_seizures,333050,333079,29
Jensen_Eisai_groupC,2,6,ts-global_detected_seizures,333186,333236,50
Jensen_Eisai_groupC,2,6,ts-global_detected_seizures,333237,333290,53
Jensen_Eisai_groupC,1,5,ts-global_detected_seizures,333238,333285,47
Jensen_Eisai_groupC,1,5,ts-global_detected_seizures,333360,333390,30
Jensen_Eisai_groupC,2,6,ts-global_detected_seizures,333372,333398,26
Jensen_Eisai_groupC,2,6,ts-global_detected_seizures,333427,333503,76
Jensen_Eisai_groupC,1,5,ts-global_detected_seizures,333453,333480,27
Jensen_Eisai_groupC,1,5,ts-global_detected_seizures,333521,333547,26
Jensen_Eisai_groupC,1,5,ts-global_detected_seizures,333570,333607,37
Jensen_Eisai_groupC,2,6,ts-global_detected_seizures,333672,333701,29
Jensen_Eisai_groupC,1,5,ts-global_detected_seizures,333720,333743,23
Jensen_Eisai_groupC,2,6,ts-global_detected_seizures,333792,333817,25
Jensen_Eisai_groupC,1,5,ts-global_detected_seizures,333859,333978,119
Jensen_Eisai_groupC,2,6,ts-global_detected_seizures,333904,333938,34
Jensen_Eisai_groupC,2,6,ts-global_detected_seizures,333957,333984,27
Jensen_Eisai_groupC,1,5,ts-global_detected_seizures,334026,334054,28
Jensen_Eisai_groupC,1,5,ts-global_detected_seizures,334103,334125,22
Jensen_Eisai_groupC,1,5,ts-global_detected_seizures,334130,334171,41
Jensen_Eisai_groupC,2,6,ts-global_detected_seizures,334174,334203,29
Jensen_Eisai_groupC,1,5,ts-global_detected_seizures,334240,334292,52
Jensen_Eisai_groupC,2,6,ts-global_detected_seizures,334250,334335,85
Jensen_Eisai_groupC,1,5,ts-global_detected_seizures,334293,334361,68
Jensen_Eisai_groupC,1,5,ts-global_detected_seizures,334367,334436,69
Jensen_Eisai_groupC,1,5,ts-global_detected_seizures,334439,334478,39
Jensen_Eisai_groupC,2,6,ts-global_detected_seizures,334476,334498,22
Jensen_Eisai_groupC,1,5,ts-global_detected_seizures,334479,334503,24
Jensen_Eisai_groupC,1,5,ts-global_detected_seizures,334553,334584,31
Jensen_Eisai_groupC,2,6,ts-global_detected_seizures,334637,334659,22
Jensen_Eisai_groupC,2,6,ts-global_detected_seizures,334660,334801,141
Jensen_Eisai_groupC,1,5,ts-global_detected_seizures,334663,334709,46
Jensen_Eisai_groupC,1,5,ts-global_detected_seizures,334713,334741,28
Jensen_Eisai_groupC,1,5,ts-global_detected_seizures,334751,334787,36
Jensen_Eisai_groupC,1,5,ts-global_detected_seizures,334788,334860,72
Jensen_Eisai_groupC,2,6,ts-global_detected_seizures,334812,334913,101
Jensen_Eisai_groupC,1,5,ts-global_detected_seizures,334861,334891,30
Jensen_Eisai_groupC,1,5,ts-global_detected_seizures,334895,334928,33
Jensen_Eisai_groupC,2,6,ts-global_detected_seizures,334956,334992,36
Jensen_Eisai_groupC,1,5,ts-global_detected_seizures,334967,335101,134
Jensen_Eisai_groupC,2,6,ts-global_detected_seizures,335039,335066,27
Jensen_Eisai_groupC,1,5,ts-global_detected_seizures,335139,335193,54
Jensen_Eisai_groupC,2,6,ts-global_detected_seizures,335180,335222,42
Jensen_Eisai_groupC,1,5,ts-global_detected_seizures,335248,335284,36
Jensen_Eisai_groupC,2,6,ts-global_detected_seizures,335268,335290,22
Jensen_Eisai_groupC,1,5,ts-global_detected_seizures,335348,335439,91
Jensen_Eisai_groupC,2,6,ts-global_detected_seizures,335391,335416,25
Jensen_Eisai_groupC,1,5,ts-global_detected_seizures,335480,335510,30
Jensen_Eisai_groupC,2,6,ts-global_detected_seizures,335487,335547,60
Jensen_Eisai_groupC,1,5,ts-global_detected_seizures,335511,335549,38
Jensen_Eisai_groupC,1,5,ts-global_detected_seizures,335580,335608,28
Jensen_Eisai_groupC,1,5,ts-global_detected_seizures,335617,335646,29
Jensen_Eisai_groupC,1,5,ts-global_detected_seizures,335680,335706,26
Jensen_Eisai_groupC,2,6,ts-global_detected_seizures,335723,335747,24
Jensen_Eisai_groupC,1,5,ts-global_detected_seizures,335736,335770,34
Jensen_Eisai_groupC,1,5,ts-global_detected_seizures,335778,335808,30
Jensen_Eisai_groupC,1,5,ts-global_detected_seizures,335826,336041,215
Jensen_Eisai_groupC,2,6,ts-global_detected_seizures,335853,335879,26
Jensen_Eisai_groupC,2,6,ts-global_detected_seizures,335881,335928,47
Jensen_Eisai_groupC,1,5,ts-global_detected_seizures,336042,336082,40
Jensen_Eisai_groupC,1,5,ts-global_detected_seizures,336083,336130,47
Jensen_Eisai_groupC,2,6,ts-global_detected_seizures,336108,336135,27
Jensen_Eisai_groupC,1,5,ts-global_detected_seizures,336164,336201,37
Jensen_Eisai_groupC,2,6,ts-global_detected_seizures,336174,336204,30
Jensen_Eisai_groupC,1,5,ts-global_detected_seizures,336208,336281,73
Jensen_Eisai_groupC,2,6,ts-global_detected_seizures,336235,336320,85
Jensen_Eisai_groupC,1,5,ts-global_detected_seizures,336320,336357,37
Jensen_Eisai_groupC,2,6,ts-global_detected_seizures,336408,336513,105
Jensen_Eisai_groupC,1,5,ts-global_detected_seizures,336409,336520,111
Jensen_Eisai_groupC,2,6,ts-global_detected_seizures,336514,336549,35
Jensen_Eisai_groupC,1,5,ts-global_detected_seizures,336554,336625,71
Jensen_Eisai_groupC,2,6,ts-global_detected_seizures,336649,336671,22
Jensen_Eisai_groupC,1,5,ts-global_detected_seizures,336683,336706,23
Jensen_Eisai_groupC,1,5,ts-global_detected_seizures,336731,336774,43
Jensen_Eisai_groupC,1,5,ts-global_detected_seizures,336861,336959,98
Jensen_Eisai_groupC,2,6,ts-global_detected_seizures,336913,336938,25
Jensen_Eisai_groupC,1,5,ts-global_detected_seizures,336977,337007,30
Jensen_Eisai_groupC,2,6,ts-global_detected_seizures,336980,337014,34
Jensen_Eisai_groupC,1,5,ts-global_detected_seizures,337041,337064,23
Jensen_Eisai_groupC,1,5,ts-global_detected_seizures,337065,337104,39
Jensen_Eisai_groupC,2,6,ts-global_detected_seizures,337107,337166,59
Jensen_Eisai_groupC,1,5,ts-global_detected_seizures,337155,337194,39
Jensen_Eisai_groupC,2,6,ts-global_detected_seizures,337259,337311,52
Jensen_Eisai_groupC,2,6,ts-global_detected_seizures,337369,337394,25
Jensen_Eisai_groupC,1,5,ts-global_detected_seizures,337394,337480,86
Jensen_Eisai_groupC,1,5,ts-global_detected_seizures,337494,338718,1224
Jensen_Eisai_groupC,2,6,ts-global_detected_seizures,337598,337622,24
Jensen_Eisai_groupC,2,6,ts-global_detected_seizures,337674,337715,41
Jensen_Eisai_groupC,2,6,ts-global_detected_seizures,337844,338686,842
Jensen_Eisai_groupC,1,5,ts-global_detected_seizures,338719,344667,5948
Jensen_Eisai_groupC,2,6,ts-global_detected_seizures,338812,338834,22
Jensen_Eisai_groupC,2,6,ts-global_detected_seizures,339004,339038,34
Jensen_Eisai_groupC,2,6,ts-global_detected_seizures,339114,339139,25
Jensen_Eisai_groupC,2,6,ts-global_detected_seizures,339180,339203,23
Jensen_Eisai_groupC,2,6,ts-global_detected_seizures,339267,339299,32
Jensen_Eisai_groupC,2,6,ts-global_detected_seizures,339382,339430,48
Jensen_Eisai_groupC,2,6,ts-global_detected_seizures,339959,339995,36
Jensen_Eisai_groupC,2,6,ts-global_detected_seizures,340012,340038,26
Jensen_Eisai_groupC,2,6,ts-global_detected_seizures,340040,340066,26
Jensen_Eisai_groupC,2,6,ts-global_detected_seizures,340417,340464,47
Jensen_Eisai_groupC,2,6,ts-global_detected_seizures,340481,342590,2109
Jensen_Eisai_groupC,2,6,ts-global_detected_seizures,342622,342652,30
Jensen_Eisai_groupC,2,6,ts-global_detected_seizures,342693,345051,2358
Jensen_Eisai_groupC,1,5,ts-global_detected_seizures,344670,344772,102
Jensen_Eisai_groupC,1,5,ts-global_detected_seizures,344774,344813,39
Jensen_Eisai_groupC,1,5,ts-global_detected_seizures,344814,344844,30
Jensen_Eisai_groupC,1,5,ts-global_detected_seizures,344845,344883,38
Jensen_Eisai_groupC,1,5,ts-global_detected_seizures,344905,344953,48
Jensen_Eisai_groupC,4,8,LL-global_detected_seizures,211761,211789,28
Jensen_Eisai_groupE,2,6,LL-indiv_detected_seizures,33092,33119,27
Jensen_Eisai_groupE,2,6,ts-indiv_detected_seizures,1,2559,2558
Jensen_Eisai_groupE,2,6,ts-indiv_detected_seizures,2560,3715,1155
Jensen_Eisai_groupE,2,6,ts-indiv_detected_seizures,3716,5934,2218
Jensen_Eisai_groupE,2,6,ts-indiv_detected_seizures,5935,7182,1247
Jensen_Eisai_groupE,2,6,ts-indiv_detected_seizures,7184,9138,1954
Jensen_Eisai_groupE,2,6,ts-indiv_detected_seizures,9139,9176,37
Jensen_Eisai_groupE,2,6,ts-indiv_detected_seizures,9177,11375,2198
Jensen_Eisai_groupE,2,6,ts-indiv_detected_seizures,11376,15674,4298
Jensen_Eisai_groupE,2,6,ts-indiv_detected_seizures,15675,19234,3559
Jensen_Eisai_groupE,2,6,ts-indiv_detected_seizures,19235,22590,3355
Jensen_Eisai_groupE,2,6,ts-indiv_detected_seizures,22591,22750,159
Jensen_Eisai_groupE,2,6,ts-indiv_detected_seizures,22751,23390,639
Jensen_Eisai_groupE,2,6,ts-indiv_detected_seizures,23391,23464,73
Jensen_Eisai_groupE,2,6,ts-indiv_detected_seizures,23465,27060,3595
Jensen_Eisai_groupE,2,6,ts-indiv_detected_seizures,27061,27873,812
Jensen_Eisai_groupE,2,6,ts-indiv_detected_seizures,27874,28937,1063
Jensen_Eisai_groupE,2,6,ts-indiv_detected_seizures,28938,29065,127
Jensen_Eisai_groupE,2,6,ts-indiv_detected_seizures,29066,29179,113
Jensen_Eisai_groupE,2,6,ts-indiv_detected_seizures,29198,29265,67
Jensen_Eisai_groupE,2,6,ts-indiv_detected_seizures,29266,29808,542
Jensen_Eisai_groupE,2,6,ts-indiv_detected_seizures,29819,29941,122
Jensen_Eisai_groupE,2,6,ts-indiv_detected_seizures,29942,30046,104
Jensen_Eisai_groupE,2,6,ts-indiv_detected_seizures,30063,30566,503
Jensen_Eisai_groupE,2,6,ts-indiv_detected_seizures,30568,30591,23
Jensen_Eisai_groupE,2,6,ts-indiv_detected_seizures,30594,31134,540
Jensen_Eisai_groupE,2,6,ts-indiv_detected_seizures,31135,31860,725
Jensen_Eisai_groupE,2,6,ts-indiv_detected_seizures,31902,32403,501
Jensen_Eisai_groupE,2,6,ts-indiv_detected_seizures,32404,33094,690
Jensen_Eisai_groupE,2,6,ts-indiv_detected_seizures,33135,42285,9150
Jensen_Eisai_groupE,2,6,ts-indiv_detected_seizures,42287,44464,2177
Jensen_Eisai_groupE,2,6,ts-indiv_detected_seizures,44475,44613,138
Jensen_Eisai_groupE,2,6,ts-indiv_detected_seizures,44614,44767,153
Jensen_Eisai_groupE,2,6,ts-indiv_detected_seizures,44768,44799,31
Jensen_Eisai_groupE,2,6,ts-indiv_detected_seizures,44807,44971,164
Jensen_Eisai_groupE,2,6,ts-indiv_detected_seizures,44978,45111,133
Jensen_Eisai_groupE,2,6,ts-indiv_detected_seizures,45112,45186,74
Jensen_Eisai_groupE,2,6,ts-indiv_detected_seizures,45187,45432,245
Jensen_Eisai_groupE,2,6,ts-indiv_detected_seizures,45433,45517,84
Jensen_Eisai_groupE,2,6,ts-indiv_detected_seizures,45518,46218,700
Jensen_Eisai_groupE,2,6,ts-indiv_detected_seizures,46219,47502,1283
Jensen_Eisai_groupE,2,6,ts-indiv_detected_seizures,47516,47680,164
Jensen_Eisai_groupE,2,6,ts-indiv_detected_seizures,47700,47844,144
Jensen_Eisai_groupE,2,6,ts-indiv_detected_seizures,47848,47944,96
Jensen_Eisai_groupE,2,6,ts-indiv_detected_seizures,47945,48261,316
Jensen_Eisai_groupE,2,6,ts-indiv_detected_seizures,48307,49647,1340
Jensen_Eisai_groupE,2,6,ts-indiv_detected_seizures,49669,50832,1163
Jensen_Eisai_groupE,2,6,ts-indiv_detected_seizures,50836,51136,300
Jensen_Eisai_groupE,2,6,ts-indiv_detected_seizures,51137,51934,797
Jensen_Eisai_groupE,2,6,ts-indiv_detected_seizures,51935,52156,221
Jensen_Eisai_groupE,2,6,ts-indiv_detected_seizures,52157,54634,2477
Jensen_Eisai_groupE,2,6,ts-indiv_detected_seizures,54645,54797,152
Jensen_Eisai_groupE,2,6,ts-indiv_detected_seizures,54798,54840,42
Jensen_Eisai_groupE,2,6,ts-indiv_detected_seizures,54853,54977,124
Jensen_Eisai_groupE,2,6,ts-indiv_detected_seizures,54978,56123,1145
Jensen_Eisai_groupE,2,6,ts-indiv_detected_seizures,56124,56384,260
Jensen_Eisai_groupE,2,6,ts-indiv_detected_seizures,56386,75032,18646
Jensen_Eisai_groupE,2,6,ts-indiv_detected_seizures,75033,86440,11407
Jensen_Eisai_groupE,2,6,LL-global_detected_seizures,33092,33121,29
Jensen_Eisai_groupE,2,6,Non_Seizures,5814.556,5850.64,36.0840000000007
Jensen_Eisai_groupE,2,6,Non_Seizures,18097.919,18120.353,22.4339999999975
Jensen_Eisai_groupE,2,6,Non_Seizures,46829.789,46853.281,23.4920000000056
Jensen_Eisai_groupE,2,6,Non_Seizures,55666.864,55688.663,21.7989999999991
Jensen_Eisai_groupE,2,6,Non_Seizures,66157.637,66175.996,18.3589999999967
Jensen_Eisai_groupE,2,6,Non_Seizures,76706.56,76724.602,18.0420000000013
Jensen_Eisai_groupE,2,6,True_Seizures,31875.135,31902.955,27.8200000000033
Jensen_Eisai_groupE,2,6,True_Seizures,33085.11,33137.498,52.387999999999
Jensen_Eisai_groupF,2,6,LL-global_detected_seizures,78971,79002,31
Jensen_Eisai_groupF,2,6,Non_Seizures,38538.942,38553.619,14.676999999996
Jensen_Eisai_groupF,2,6,Non_Seizures,60867.112,60881.478,14.3660000000018
Jensen_Eisai_groupF,2,6,Non_Seizures,78945.578,78952.656,7.07800000000861
Jensen_Eisai_groupG,1,5,LL-global_detected_seizures,113,148,35
Jensen_Eisai_groupG,1,5,LL-global_detected_seizures,188,246,58
Jensen_Eisai_groupG,1,5,LL-global_detected_seizures,250,287,37
Jensen_Eisai_groupG,1,5,LL-global_detected_seizures,294,339,45
Jensen_Eisai_groupG,2,6,LL-global_detected_seizures,362,384,22
Jensen_Eisai_groupG,1,5,LL-global_detected_seizures,515,543,28
Jensen_Eisai_groupG,1,5,LL-global_detected_seizures,594,622,28
Jensen_Eisai_groupG,1,5,LL-global_detected_seizures,803,841,38
Jensen_Eisai_groupG,1,5,LL-global_detected_seizures,930,956,26
Jensen_Eisai_groupG,1,5,LL-global_detected_seizures,960,985,25
Jensen_Eisai_groupG,1,5,LL-global_detected_seizures,1463,1494,31
Jensen_Eisai_groupG,1,5,LL-global_detected_seizures,1600,1624,24
Jensen_Eisai_groupG,1,5,LL-global_detected_seizures,1740,1792,52
Jensen_Eisai_groupG,1,5,LL-global_detected_seizures,1795,1824,29
Jensen_Eisai_groupG,1,5,LL-global_detected_seizures,1872,1896,24
Jensen_Eisai_groupG,1,5,LL-global_detected_seizures,2184,2220,36
Jensen_Eisai_groupG,1,5,LL-global_detected_seizures,2284,2309,25
Jensen_Eisai_groupG,1,5,LL-global_detected_seizures,2519,2541,22
Jensen_Eisai_groupG,1,5,LL-global_detected_seizures,2576,2601,25
Jensen_Eisai_groupG,1,5,LL-global_detected_seizures,2778,2810,32
Jensen_Eisai_groupG,1,5,LL-global_detected_seizures,9474,9499,25
Jensen_Eisai_groupG,1,5,LL-global_detected_seizures,9509,9535,26
Jensen_Eisai_groupG,1,5,LL-global_detected_seizures,13708,13730,22
Jensen_Eisai_groupG,1,5,LL-global_detected_seizures,14001,14032,31
Jensen_Eisai_groupG,1,5,LL-global_detected_seizures,19518,19548,30
Jensen_Eisai_groupG,1,5,LL-global_detected_seizures,23180,23205,25
Jensen_Eisai_groupG,1,5,LL-global_detected_seizures,23218,23245,27
Jensen_Eisai_groupG,1,5,LL-global_detected_seizures,25597,25623,26
Jensen_Eisai_groupG,1,5,LL-global_detected_seizures,25634,25661,27
Jensen_Eisai_groupG,1,5,LL-global_detected_seizures,25769,25793,24
Jensen_Eisai_groupG,1,5,LL-global_detected_seizures,26372,26403,31
Jensen_Eisai_groupG,1,5,LL-global_detected_seizures,26493,26551,58
Jensen_Eisai_groupG,1,5,LL-global_detected_seizures,28538,28560,22
Jensen_Eisai_groupG,1,5,LL-global_detected_seizures,28954,28982,28
Jensen_Eisai_groupG,1,5,LL-global_detected_seizures,29027,29049,22
Jensen_Eisai_groupG,1,5,LL-global_detected_seizures,30098,30133,35
Jensen_Eisai_groupG,1,5,LL-global_detected_seizures,32161,32194,33
Jensen_Eisai_groupG,1,5,LL-global_detected_seizures,32196,32234,38
Jensen_Eisai_groupG,1,5,LL-global_detected_seizures,32649,32675,26
Jensen_Eisai_groupG,1,5,LL-global_detected_seizures,32905,32944,39
Jensen_Eisai_groupG,1,5,LL-global_detected_seizures,32945,32988,43
Jensen_Eisai_groupG,1,5,LL-global_detected_seizures,33392,33449,57
Jensen_Eisai_groupG,1,5,LL-global_detected_seizures,33450,33473,23
Jensen_Eisai_groupG,1,5,LL-global_detected_seizures,34618,34643,25
Jensen_Eisai_groupG,1,5,LL-global_detected_seizures,36507,36530,23
Jensen_Eisai_groupG,1,5,LL-global_detected_seizures,36785,36808,23
Jensen_Eisai_groupG,1,5,LL-global_detected_seizures,42945,42982,37
Jensen_Eisai_groupG,1,5,LL-global_detected_seizures,43113,43138,25
Jensen_Eisai_groupG,1,5,LL-global_detected_seizures,43165,43189,24
Jensen_Eisai_groupG,1,5,LL-global_detected_seizures,43793,43823,30
Jensen_Eisai_groupG,1,5,LL-global_detected_seizures,48204,48234,30
Jensen_Eisai_groupG,1,5,LL-global_detected_seizures,48576,48598,22
Jensen_Eisai_groupG,1,5,LL-global_detected_seizures,53553,53601,48
Jensen_Eisai_groupG,2,6,LL-global_detected_seizures,57227,57249,22
Jensen_Eisai_groupG,2,6,LL-global_detected_seizures,61999,62021,22
Jensen_Eisai_groupG,1,5,LL-global_detected_seizures,62685,62707,22
Jensen_Eisai_groupG,1,5,LL-global_detected_seizures,63119,63141,22
Jensen_Eisai_groupG,2,6,LL-global_detected_seizures,63442,63472,30
Jensen_Eisai_groupG,1,5,LL-global_detected_seizures,64666,64689,23
Jensen_Eisai_groupG,2,6,LL-global_detected_seizures,65730,65753,23
Jensen_Eisai_groupG,2,6,LL-global_detected_seizures,65825,65847,22
Jensen_Eisai_groupG,1,5,LL-global_detected_seizures,67026,67052,26
Jensen_Eisai_groupG,2,6,LL-global_detected_seizures,67164,67188,24
Jensen_Eisai_groupG,1,5,LL-global_detected_seizures,68045,68073,28
Jensen_Eisai_groupG,1,5,LL-global_detected_seizures,68137,68169,32
Jensen_Eisai_groupG,1,5,LL-global_detected_seizures,69081,69104,23
Jensen_Eisai_groupG,1,5,LL-global_detected_seizures,69903,69942,39
Jensen_Eisai_groupG,1,5,LL-global_detected_seizures,107030,107061,31
Jensen_Eisai_groupG,1,5,LL-global_detected_seizures,114135,114161,26
Jensen_Eisai_groupG,1,5,LL-global_detected_seizures,114339,114371,32
Jensen_Eisai_groupG,1,5,LL-global_detected_seizures,114372,114403,31
Jensen_Eisai_groupG,1,5,LL-global_detected_seizures,114678,114717,39
Jensen_Eisai_groupG,1,5,LL-global_detected_seizures,114884,114939,55
Jensen_Eisai_groupG,1,5,LL-global_detected_seizures,114944,114997,53
Jensen_Eisai_groupG,1,5,LL-global_detected_seizures,115248,115276,28
Jensen_Eisai_groupG,1,5,LL-global_detected_seizures,117949,117971,22
Jensen_Eisai_groupG,1,5,LL-global_detected_seizures,117997,118025,28
Jensen_Eisai_groupG,1,5,LL-global_detected_seizures,118080,118112,32
Jensen_Eisai_groupG,1,5,LL-global_detected_seizures,118242,118264,22
Jensen_Eisai_groupG,1,5,LL-global_detected_seizures,118293,118318,25
Jensen_Eisai_groupG,1,5,LL-global_detected_seizures,118322,118360,38
Jensen_Eisai_groupG,1,5,LL-global_detected_seizures,118363,118387,24
Jensen_Eisai_groupG,1,5,LL-global_detected_seizures,119161,119184,23
Jensen_Eisai_groupG,1,5,LL-global_detected_seizures,123382,123416,34
Jensen_Eisai_groupG,1,5,LL-global_detected_seizures,123429,123456,27
Jensen_Eisai_groupG,1,5,LL-global_detected_seizures,126082,126121,39
Jensen_Eisai_groupG,1,5,LL-global_detected_seizures,126224,126248,24
Jensen_Eisai_groupG,1,5,LL-global_detected_seizures,126410,126444,34
Jensen_Eisai_groupG,1,5,LL-global_detected_seizures,126504,126528,24
Jensen_Eisai_groupG,1,5,LL-global_detected_seizures,126986,127012,26
Jensen_Eisai_groupG,1,5,LL-global_detected_seizures,143919,143944,25
Jensen_Eisai_groupG,1,5,LL-global_detected_seizures,153128,153156,28
Jensen_Eisai_groupG,1,5,LL-global_detected_seizures,153656,153685,29
Jensen_Eisai_groupG,1,5,LL-global_detected_seizures,154560,154588,28
Jensen_Eisai_groupG,1,5,LL-global_detected_seizures,154994,155019,25
Jensen_Eisai_groupG,1,5,LL-global_detected_seizures,163698,163720,22
Jensen_Eisai_groupG,1,5,LL-global_detected_seizures,163956,163979,23
Jensen_Eisai_groupG,1,5,LL-global_detected_seizures,164197,164227,30
Jensen_Eisai_groupG,1,5,LL-global_detected_seizures,164620,164653,33
Jensen_Eisai_groupG,1,5,LL-global_detected_seizures,189317,189341,24
Jensen_Eisai_groupG,1,5,LL-global_detected_seizures,189408,189432,24
Jensen_Eisai_groupG,1,5,LL-global_detected_seizures,189459,189505,46
Jensen_Eisai_groupG,1,5,LL-global_detected_seizures,189610,189666,56
Jensen_Eisai_groupG,1,5,LL-global_detected_seizures,189697,189724,27
Jensen_Eisai_groupG,1,5,LL-global_detected_seizures,189798,189837,39
Jensen_Eisai_groupG,1,5,LL-global_detected_seizures,195339,195372,33
Jensen_Eisai_groupG,1,5,LL-global_detected_seizures,195430,195453,23
Jensen_Eisai_groupG,1,5,LL-global_detected_seizures,195456,195495,39
Jensen_Eisai_groupG,1,5,LL-global_detected_seizures,195497,195522,25
Jensen_Eisai_groupG,1,5,LL-global_detected_seizures,195570,195597,27
Jensen_Eisai_groupG,1,5,LL-global_detected_seizures,195598,195626,28
Jensen_Eisai_groupG,1,5,LL-global_detected_seizures,195628,195678,50
Jensen_Eisai_groupG,1,5,LL-global_detected_seizures,195682,195722,40
Jensen_Eisai_groupG,1,5,LL-global_detected_seizures,195803,195830,27
Jensen_Eisai_groupG,1,5,LL-global_detected_seizures,206438,206464,26
Jensen_Eisai_groupG,1,5,LL-global_detected_seizures,208939,208971,32
Jensen_Eisai_groupG,1,5,LL-global_detected_seizures,208988,209014,26
Jensen_Eisai_groupG,1,5,LL-global_detected_seizures,209033,209065,32
Jensen_Eisai_groupG,1,5,LL-global_detected_seizures,209066,209096,30
Jensen_Eisai_groupG,1,5,LL-global_detected_seizures,209121,209145,24
Jensen_Eisai_groupG,1,5,LL-global_detected_seizures,209146,209169,23
Jensen_Eisai_groupG,1,5,LL-global_detected_seizures,209181,209225,44
Jensen_Eisai_groupG,1,5,LL-global_detected_seizures,209573,209597,24
Jensen_Eisai_groupG,1,5,LL-global_detected_seizures,210719,210741,22
Jensen_Eisai_groupG,1,5,LL-global_detected_seizures,211330,211352,22
Jensen_Eisai_groupG,1,5,LL-global_detected_seizures,211509,211533,24
Jensen_Eisai_groupG,1,5,LL-global_detected_seizures,213868,213890,22
Jensen_Eisai_groupG,1,5,LL-global_detected_seizures,220561,220602,41
Jensen_Eisai_groupG,1,5,LL-global_detected_seizures,220663,220692,29
Jensen_Eisai_groupG,1,5,LL-global_detected_seizures,220700,220722,22
Jensen_Eisai_groupG,1,5,LL-global_detected_seizures,220730,220790,60
Jensen_Eisai_groupG,1,5,LL-global_detected_seizures,220872,220901,29
Jensen_Eisai_groupG,1,5,LL-global_detected_seizures,222369,222396,27
Jensen_Eisai_groupG,1,5,LL-global_detected_seizures,222397,222423,26
Jensen_Eisai_groupG,1,5,LL-global_detected_seizures,222904,222926,22
Jensen_Eisai_groupG,1,5,LL-global_detected_seizures,223908,223930,22
Jensen_Eisai_groupG,1,5,LL-global_detected_seizures,231842,231869,27
Jensen_Eisai_groupG,1,5,LL-global_detected_seizures,231950,231980,30
Jensen_Eisai_groupG,1,5,LL-global_detected_seizures,232001,232031,30
Jensen_Eisai_groupG,1,5,LL-global_detected_seizures,232061,232085,24
Jensen_Eisai_groupG,1,5,LL-global_detected_seizures,232136,232166,30
Jensen_Eisai_groupG,1,5,LL-global_detected_seizures,232187,232209,22
Jensen_Eisai_groupG,1,5,LL-global_detected_seizures,233144,233168,24
Jensen_Eisai_groupG,1,5,LL-global_detected_seizures,234289,234315,26
Jensen_Eisai_groupG,2,6,LL-global_detected_seizures,238058,238081,23
Jensen_Eisai_groupG,1,5,LL-global_detected_seizures,240236,240277,41
Jensen_Eisai_groupG,1,5,LL-global_detected_seizures,240537,240572,35
Jensen_Eisai_groupG,1,5,LL-global_detected_seizures,240601,240647,46
Jensen_Eisai_groupG,1,5,LL-global_detected_seizures,245816,245841,25
Jensen_Eisai_groupG,1,5,LL-global_detected_seizures,249018,249052,34
Jensen_Eisai_groupG,1,5,LL-global_detected_seizures,249055,249086,31
Jensen_Eisai_groupG,1,5,LL-global_detected_seizures,249232,249257,25
Jensen_Eisai_groupG,1,5,Non_Seizures,149,158.002,9.00200000000001
Jensen_Eisai_groupG,1,5,Non_Seizures,188,244.002,56.002
Jensen_Eisai_groupG,1,5,Non_Seizures,250,285.002,35.002
Jensen_Eisai_groupG,1,5,Non_Seizures,294,337.002,43.002
Jensen_Eisai_groupG,2,6,Non_Seizures,342,348.002,6.00200000000001
Jensen_Eisai_groupG,1,5,Non_Seizures,150099,150106.002,7.00200000000768
Jensen_Eisai_groupG,2,6,Non_Seizures,166747,166752.002,5.00200000000768
Jensen_Eisai_groupH,1,5,Non_Seizures,17055,17064.002,9.00200000000041
Jensen_Eisai_groupH,1,5,Non_Seizures,22277,22283.002,6.00200000000041
Jensen_Eisai_groupH,1,5,Non_Seizures,24148,24153.002,5.00200000000041
Jensen_Eisai_groupH,1,5,Non_Seizures,24299,24304.002,5.00200000000041
Jensen_Eisai_groupH,2,6,Non_Seizures,31912,31919.002,7.00200000000041
Jensen_Eisai_groupH,2,6,Non_Seizures,31975,31986.002,11.0020000000004
Jensen_Eisai_groupH,2,6,Non_Seizures,98944,98950.002,6.00199999999313
Jensen_Eisai_groupJ,1,5,LL-global_detected_seizures,17875,17909,34
Jensen_Eisai_groupJ,1,5,LL-global_detected_seizures,41239,41268,29
Jensen_Eisai_groupJ,1,5,LL-global_detected_seizures,41286,41312,26
